team,year,tournament,goals_for,goals_against,win,loss,draw,matches_played,goal_difference,won_tournament
Abkhazia,2012,Friendly,1,4,0,1,1,2,-3,0
Abkhazia,2014,CONIFA World Football Cup,6,6,1,1,3,5,0,0
Abkhazia,2015,Friendly,2,0,2,0,0,2,2,0
Abkhazia,2016,CONIFA World Football Cup,15,1,4,0,1,5,14,0
Abkhazia,2016,Friendly,0,0,0,0,1,1,0,0
Abkhazia,2017,CONIFA European Football Cup,5,6,1,1,3,5,-1,0
Abkhazia,2017,Friendly,1,2,0,1,0,1,-1,0
Abkhazia,2018,CONIFA World Football Cup,15,4,4,1,1,6,11,0
Abkhazia,2019,CONIFA European Football Cup,6,3,2,0,3,5,3,0
Afghanistan,1941,Friendly,1,3,0,1,0,1,-2,0
Afghanistan,1950,Friendly,0,4,0,1,0,1,-4,0
Afghanistan,1951,Asian Games,0,5,0,2,0,2,-5,0
Afghanistan,1954,Asian Games,4,12,0,2,0,2,-8,0
Afghanistan,1975,AFC Asian Cup qualification,3,18,0,5,1,6,-15,0
Afghanistan,1976,Friendly,2,2,1,1,1,3,0,0
Afghanistan,1977,Friendly,0,3,0,1,0,1,-3,0
Afghanistan,1979,AFC Asian Cup qualification,2,3,0,1,0,1,-1,0
Afghanistan,1984,AFC Asian Cup qualification,1,20,0,3,1,4,-19,0
Afghanistan,2003,AFC Asian Cup qualification,2,5,1,1,0,2,-3,0
Afghanistan,2003,FIFA World Cup qualification,0,13,0,2,0,2,-13,0
Afghanistan,2003,SAFF Cup,0,6,0,3,0,3,-6,0
Afghanistan,2005,Friendly,0,4,0,1,0,1,-4,0
Afghanistan,2005,SAFF Cup,3,11,1,2,0,3,-8,0
Afghanistan,2006,AFC Challenge Cup,3,3,0,0,2,2,0,0
Afghanistan,2007,FIFA World Cup qualification,1,5,0,2,0,2,-4,0
Afghanistan,2008,AFC Challenge Cup,0,10,0,3,0,3,-10,0
Afghanistan,2008,AFC Challenge Cup qualification,1,0,1,0,1,2,1,0
Afghanistan,2008,Merdeka Tournament,2,8,0,1,1,2,-6,0
Afghanistan,2008,SAFF Cup,5,7,0,1,2,3,-2,0
Afghanistan,2009,SAFF Cup,1,6,0,2,0,2,-5,0
Afghanistan,2010,Friendly,0,1,0,1,0,1,-1,0
Afghanistan,2011,AFC Challenge Cup qualification,6,3,3,2,0,5,3,0
Afghanistan,2011,FIFA World Cup qualification,1,3,0,1,1,2,-2,0
Afghanistan,2011,SAFF Cup,13,7,3,1,1,5,6,0
Afghanistan,2013,AFC Challenge Cup qualification,3,1,2,0,1,3,2,0
Afghanistan,2013,Friendly,5,3,1,1,0,2,2,0
Afghanistan,2013,SAFF Cup,7,1,3,0,1,4,6,0
Afghanistan,2014,AFC Challenge Cup,4,4,1,1,3,5,0,0
Afghanistan,2014,Friendly,3,3,1,1,1,3,0,0
Afghanistan,2015,FIFA World Cup qualification,6,18,2,4,0,6,-12,0
Afghanistan,2015,Friendly,4,5,1,2,1,4,-1,0
Afghanistan,2015,SAFF Cup,16,1,4,0,0,4,15,1
Afghanistan,2016,FIFA World Cup qualification,2,6,1,1,0,2,-4,0
Afghanistan,2016,Friendly,1,4,0,2,1,3,-3,0
Afghanistan,2016,SAFF Cup,1,2,0,1,0,1,-1,0
Afghanistan,2017,AFC Asian Cup qualification,5,9,0,2,3,5,-4,0
Afghanistan,2017,Friendly,4,4,2,1,0,3,0,0
Afghanistan,2018,AFC Asian Cup qualification,2,1,1,0,0,1,1,0
Afghanistan,2018,Friendly,0,2,0,1,0,1,-2,0
Afghanistan,2019,FIFA World Cup qualification,2,11,1,3,1,5,-9,0
Afghanistan,2019,Friendly,2,3,0,1,1,2,-1,0
Afghanistan,2021,FIFA World Cup qualification,3,4,0,1,2,3,-1,0
Afghanistan,2021,Friendly,5,3,2,0,1,3,2,0
Afghanistan,2022,AFC Asian Cup qualification,4,6,0,2,1,3,-2,0
Afghanistan,2022,Friendly,0,2,0,1,0,1,-2,0
Afghanistan,2023,CAFA Nations Cup,1,6,0,1,0,1,-5,0
Afghanistan,2023,FIFA World Cup qualification,3,12,2,2,0,4,-9,0
Afghanistan,2023,Friendly,2,3,0,1,2,3,-1,0
Afghanistan,2024,FIFA World Cup qualification,2,2,1,1,2,4,0,0
Afghanistan,2024,Friendly,1,5,0,2,0,2,-4,0
Afghanistan,2025,AFC Asian Cup qualification,1,2,0,1,0,1,-1,0
Afghanistan,2025,Friendly,0,2,0,1,0,1,-2,0
Albania,1946,Balkan Cup,6,4,2,1,0,3,2,1
Albania,1946,Friendly,5,0,1,0,0,1,5,0
Albania,1947,Balkan Cup,2,13,0,4,0,4,-11,0
Albania,1948,Balkan Cup,1,0,1,0,2,3,1,0
Albania,1949,Friendly,3,7,0,2,2,4,-4,0
Albania,1950,Friendly,2,19,1,2,1,4,-17,0
Albania,1952,Friendly,3,2,1,0,0,1,1,0
Albania,1953,Friendly,2,0,1,0,0,1,2,1
Albania,1957,Friendly,2,3,0,1,0,1,-1,0
Albania,1958,Friendly,1,1,0,0,1,1,0,0
Albania,1963,UEFA Euro qualification,1,4,1,1,0,2,-3,0
Albania,1964,FIFA World Cup qualification,0,4,0,2,0,2,-4,0
Albania,1965,FIFA World Cup qualification,2,8,0,3,1,4,-6,0
Albania,1967,UEFA Euro qualification,0,12,0,3,1,4,-12,0
Albania,1970,UEFA Euro qualification,1,5,0,2,0,2,-4,0
Albania,1971,UEFA Euro qualification,4,4,1,2,1,4,0,0
Albania,1972,FIFA World Cup qualification,0,3,0,2,0,2,-3,0
Albania,1973,FIFA World Cup qualification,3,10,1,3,0,4,-7,0
Albania,1973,Friendly,1,1,0,0,1,1,0,0
Albania,1976,Friendly,3,0,1,0,0,1,3,0
Albania,1980,FIFA World Cup qualification,3,8,1,3,0,4,-5,0
Albania,1981,FIFA World Cup qualification,1,14,0,4,0,4,-13,0
Albania,1982,UEFA Euro qualification,0,6,0,2,1,3,-6,0
Albania,1983,UEFA Euro qualification,4,8,0,4,1,5,-4,0
Albania,1984,FIFA World Cup qualification,5,5,1,1,1,3,0,0
Albania,1985,FIFA World Cup qualification,1,4,0,2,1,3,-3,0
Albania,1985,Friendly,0,0,0,0,1,1,0,0
Albania,1986,UEFA Euro qualification,1,5,0,2,0,2,-4,0
Albania,1987,UEFA Euro qualification,1,12,0,4,0,4,-11,0
Albania,1988,FIFA World Cup qualification,1,3,0,2,0,2,-2,0
Albania,1988,Friendly,0,3,0,1,1,2,-3,0
Albania,1989,FIFA World Cup qualification,2,12,0,4,0,4,-10,0
Albania,1989,Friendly,1,1,0,0,1,1,0,0
Albania,1990,Friendly,0,1,0,1,0,1,-1,0
Albania,1990,UEFA Euro qualification,0,12,0,3,0,3,-12,0
Albania,1991,Friendly,2,0,1,0,0,1,2,0
Albania,1991,UEFA Euro qualification,2,9,1,3,0,4,-7,0
Albania,1992,FIFA World Cup qualification,2,9,1,3,1,5,-7,0
Albania,1992,Friendly,1,0,1,0,0,1,1,0
Albania,1993,FIFA World Cup qualification,4,17,0,6,1,7,-13,0
Albania,1994,Friendly,1,5,0,1,0,1,-4,0
Albania,1994,UEFA Euro qualification,2,7,0,4,0,4,-5,0
Albania,1995,Friendly,3,2,1,1,0,2,1,0
Albania,1995,UEFA Euro qualification,8,9,2,2,2,6,-1,0
Albania,1996,FIFA World Cup qualification,1,6,0,2,1,3,-5,0
Albania,1996,Friendly,1,2,0,1,1,2,-1,0
Albania,1997,FIFA World Cup qualification,6,14,1,6,0,7,-8,0
Albania,1998,Friendly,6,4,1,1,0,2,2,0
Albania,1998,Malta International Tournament,3,6,0,1,2,3,-3,0
Albania,1998,UEFA Euro qualification,2,3,0,1,2,3,-1,0
Albania,1999,Friendly,2,0,1,0,0,1,2,0
Albania,1999,UEFA Euro qualification,6,11,1,4,2,7,-5,0
Albania,2000,FIFA World Cup qualification,3,2,1,1,0,2,1,0
Albania,2000,Friendly,3,1,1,1,1,3,2,0
Albania,2000,Malta International Tournament,5,0,3,0,0,3,5,1
Albania,2001,FIFA World Cup qualification,2,12,0,6,0,6,-10,0
Albania,2001,Friendly,2,0,1,0,0,1,2,0
Albania,2002,Friendly,1,6,1,2,1,4,-5,0
Albania,2002,Prime Minister's Cup,1,4,0,1,2,3,-3,0
Albania,2002,UEFA Euro qualification,2,5,0,1,1,2,-3,0
Albania,2003,Friendly,11,10,2,3,0,5,1,0
Albania,2003,UEFA Euro qualification,9,10,2,3,1,6,-1,0
Albania,2004,FIFA World Cup qualification,3,5,2,2,0,4,-2,0
Albania,2004,Friendly,6,5,2,1,1,4,1,0
Albania,2005,FIFA World Cup qualification,8,15,2,5,1,8,-7,0
Albania,2005,Friendly,2,2,1,1,0,2,0,0
Albania,2006,Friendly,4,2,1,1,1,3,2,0
Albania,2006,UEFA Euro qualification,3,6,0,2,1,3,-3,0
Albania,2007,Friendly,3,1,1,1,0,2,2,0
Albania,2007,UEFA Euro qualification,9,12,2,3,4,9,-3,0
Albania,2008,FIFA World Cup qualification,3,2,1,1,2,4,1,0
Albania,2008,Friendly,3,2,1,1,1,3,1,0
Albania,2009,FIFA World Cup qualification,3,11,0,4,2,6,-8,0
Albania,2009,Friendly,7,2,1,0,2,3,5,0
Albania,2010,Friendly,4,0,4,0,1,5,4,0
Albania,2010,UEFA Euro qualification,3,4,1,1,2,4,-1,0
Albania,2011,Friendly,4,9,1,3,1,5,-5,0
Albania,2011,UEFA Euro qualification,4,10,1,4,1,6,-6,0
Albania,2012,FIFA World Cup qualification,5,5,2,2,0,4,0,0
Albania,2012,Friendly,4,3,2,1,2,5,1,0
Albania,2013,FIFA World Cup qualification,4,6,1,3,2,6,-2,0
Albania,2013,Friendly,7,3,2,1,1,4,4,0
Albania,2014,Friendly,6,4,2,3,1,6,2,0
Albania,2014,UEFA Euro qualification,5,1,2,0,1,3,4,0
Albania,2015,Friendly,5,4,1,0,2,3,1,0
Albania,2015,UEFA Euro qualification,5,4,2,2,1,5,1,0
Albania,2016,FIFA World Cup qualification,4,6,2,2,0,4,-2,0
Albania,2016,Friendly,7,6,2,2,1,5,1,0
Albania,2016,UEFA Euro,1,3,1,2,0,3,-2,0
Albania,2017,FIFA World Cup qualification,6,7,2,3,1,6,-1,0
Albania,2017,Friendly,5,6,1,2,0,3,-1,0
Albania,2018,Friendly,2,8,1,3,1,5,-6,0
Albania,2018,UEFA Nations League,1,8,1,3,0,4,-7,0
Albania,2019,UEFA Euro qualification,16,14,4,5,1,10,2,0
Albania,2020,Friendly,2,1,1,0,0,1,1,0
Albania,2020,UEFA Nations League,8,4,3,1,2,6,4,0
Albania,2021,FIFA World Cup qualification,12,12,6,4,0,10,0,0
Albania,2021,Friendly,1,3,0,1,1,2,-2,0
Albania,2022,Friendly,5,7,1,3,3,7,-2,0
Albania,2022,UEFA Nations League,4,6,0,2,2,4,-2,0
Albania,2023,Friendly,2,0,1,0,0,1,2,0
Albania,2023,UEFA Euro qualification,12,4,4,1,3,8,8,0
Albania,2024,Friendly,6,5,2,2,0,4,1,0
Albania,2024,UEFA Euro,3,5,0,2,1,3,-2,0
Albania,2024,UEFA Nations League,4,6,2,3,1,6,-2,0
Albania,2025,FIFA World Cup qualification,3,2,1,1,0,2,1,0
Alderney,1905,Muratti Vase,0,6,0,1,0,1,-6,0
Alderney,1906,Muratti Vase,0,1,0,1,0,1,-1,0
Alderney,1907,Muratti Vase,1,2,0,1,0,1,-1,0
Alderney,1908,Muratti Vase,0,3,0,1,0,1,-3,0
Alderney,1909,Muratti Vase,0,2,0,1,0,1,-2,0
Alderney,1910,Muratti Vase,1,7,0,1,0,1,-6,0
Alderney,1911,Muratti Vase,1,2,0,1,0,1,-1,0
Alderney,1912,Muratti Vase,0,4,0,1,0,1,-4,0
Alderney,1913,Muratti Vase,2,5,0,1,0,1,-3,0
Alderney,1914,Muratti Vase,0,4,0,1,0,1,-4,0
Alderney,1920,Muratti Vase,1,0,1,0,0,1,1,1
Alderney,1921,Muratti Vase,0,2,0,1,0,1,-2,0
Alderney,1921,Peace Cup,0,3,0,1,0,1,-3,0
Alderney,1922,Muratti Vase,0,8,0,1,0,1,-8,0
Alderney,1922,Peace Cup,1,3,0,1,0,1,-2,0
Alderney,1923,Muratti Vase,2,3,0,1,0,1,-1,0
Alderney,1923,Peace Cup,1,2,0,1,0,1,-1,0
Alderney,1924,Muratti Vase,0,1,0,1,0,1,-1,0
Alderney,1924,Peace Cup,2,1,1,0,0,1,1,1
Alderney,1925,Muratti Vase,0,3,0,1,0,1,-3,0
Alderney,1925,Peace Cup,1,7,0,2,0,2,-6,0
Alderney,1926,Muratti Vase,1,7,0,1,0,1,-6,0
Alderney,1927,Muratti Vase,0,3,0,1,0,1,-3,0
Alderney,1928,Muratti Vase,0,4,0,1,0,1,-4,0
Alderney,1929,Muratti Vase,0,5,0,1,0,1,-5,0
Alderney,1930,Muratti Vase,2,3,0,1,0,1,-1,0
Alderney,1931,Muratti Vase,0,1,0,1,0,1,-1,0
Alderney,1932,Muratti Vase,2,4,0,1,0,1,-2,0
Alderney,1933,Muratti Vase,0,6,0,1,0,1,-6,0
Alderney,1934,Muratti Vase,0,3,0,1,0,1,-3,0
Alderney,1935,Muratti Vase,0,5,0,1,0,1,-5,0
Alderney,1936,Muratti Vase,0,9,0,1,0,1,-9,0
Alderney,1937,Muratti Vase,1,4,0,1,0,1,-3,0
Alderney,1938,Muratti Vase,1,3,0,1,0,1,-2,0
Alderney,1939,Muratti Vase,1,2,0,1,0,1,-1,0
Alderney,1948,Muratti Vase,0,3,0,1,0,1,-3,0
Alderney,1949,Muratti Vase,0,9,0,1,0,1,-9,0
Alderney,1950,Muratti Vase,1,3,0,1,0,1,-2,0
Alderney,1951,Muratti Vase,1,8,0,1,0,1,-7,0
Alderney,1952,Muratti Vase,2,7,0,1,0,1,-5,0
Alderney,1953,Muratti Vase,0,4,0,1,0,1,-4,0
Alderney,1954,Muratti Vase,1,2,0,1,0,1,-1,0
Alderney,1955,Muratti Vase,0,3,0,1,0,1,-3,0
Alderney,1956,Muratti Vase,0,4,0,1,0,1,-4,0
Alderney,1957,Muratti Vase,1,7,0,1,0,1,-6,0
Alderney,1958,Muratti Vase,2,8,0,1,0,1,-6,0
Alderney,1959,Muratti Vase,0,6,0,1,0,1,-6,0
Alderney,1960,Muratti Vase,1,5,0,1,0,1,-4,0
Alderney,1961,Muratti Vase,2,4,0,1,0,1,-2,0
Alderney,1962,Muratti Vase,1,6,0,1,0,1,-5,0
Alderney,1963,Muratti Vase,0,6,0,1,0,1,-6,0
Alderney,1964,Muratti Vase,0,3,0,1,0,1,-3,0
Alderney,1965,Muratti Vase,0,8,0,1,0,1,-8,0
Alderney,1966,Muratti Vase,0,10,0,1,0,1,-10,0
Alderney,1967,Muratti Vase,1,3,0,1,0,1,-2,0
Alderney,1968,Muratti Vase,0,2,0,1,0,1,-2,0
Alderney,1969,Muratti Vase,0,5,0,1,0,1,-5,0
Alderney,1970,Muratti Vase,0,5,0,1,0,1,-5,0
Alderney,1971,Muratti Vase,0,11,0,1,0,1,-11,0
Alderney,1972,Muratti Vase,0,5,0,1,0,1,-5,0
Alderney,1973,Muratti Vase,1,6,0,1,0,1,-5,0
Alderney,1974,Muratti Vase,0,6,0,1,0,1,-6,0
Alderney,1975,Muratti Vase,1,3,0,1,0,1,-2,0
Alderney,1976,Muratti Vase,0,5,0,1,0,1,-5,0
Alderney,1977,Muratti Vase,0,3,0,1,0,1,-3,0
Alderney,1978,Muratti Vase,0,12,0,1,0,1,-12,0
Alderney,1979,Muratti Vase,0,8,0,1,0,1,-8,0
Alderney,1980,Muratti Vase,0,5,0,1,0,1,-5,0
Alderney,1981,Muratti Vase,0,5,0,1,0,1,-5,0
Alderney,1982,Muratti Vase,1,5,0,1,0,1,-4,0
Alderney,1983,Muratti Vase,1,6,0,1,0,1,-5,0
Alderney,1984,Muratti Vase,0,6,0,1,0,1,-6,0
Alderney,1985,Muratti Vase,0,5,0,1,0,1,-5,0
Alderney,1986,Muratti Vase,0,7,0,1,0,1,-7,0
Alderney,1987,Muratti Vase,0,10,0,1,0,1,-10,0
Alderney,1988,Muratti Vase,1,5,0,1,0,1,-4,0
Alderney,1989,Muratti Vase,0,4,0,1,0,1,-4,0
Alderney,1990,Muratti Vase,0,4,0,1,0,1,-4,0
Alderney,1991,Muratti Vase,1,4,0,1,0,1,-3,0
Alderney,1992,Muratti Vase,1,9,0,1,0,1,-8,0
Alderney,1993,Muratti Vase,0,10,0,1,0,1,-10,0
Alderney,1994,Muratti Vase,0,18,0,1,0,1,-18,0
Alderney,1995,Muratti Vase,1,7,0,1,0,1,-6,0
Alderney,1996,Muratti Vase,0,2,0,1,0,1,-2,0
Alderney,1997,Muratti Vase,0,6,0,1,0,1,-6,0
Alderney,1998,Muratti Vase,0,2,0,1,0,1,-2,0
Alderney,1999,Muratti Vase,0,1,0,1,0,1,-1,0
Alderney,2000,Muratti Vase,0,10,0,1,0,1,-10,0
Alderney,2001,Muratti Vase,0,6,0,1,0,1,-6,0
Alderney,2002,Muratti Vase,1,2,0,1,0,1,-1,0
Alderney,2003,Island Games,3,13,1,3,0,4,-10,0
Alderney,2003,Muratti Vase,1,4,0,1,0,1,-3,0
Alderney,2004,Muratti Vase,0,4,0,1,0,1,-4,0
Alderney,2005,Muratti Vase,1,2,0,1,0,1,-1,0
Alderney,2006,Muratti Vase,1,4,0,1,0,1,-3,0
Alderney,2007,Muratti Vase,0,5,0,1,0,1,-5,0
Alderney,2008,Muratti Vase,0,7,0,1,0,1,-7,0
Alderney,2009,Muratti Vase,0,5,0,1,0,1,-5,0
Alderney,2010,Muratti Vase,0,3,0,1,0,1,-3,0
Alderney,2011,Island Games,1,18,0,4,0,4,-17,0
Alderney,2011,Muratti Vase,0,5,0,1,0,1,-5,0
Alderney,2012,Friendly,1,1,0,0,1,1,0,0
Alderney,2012,Muratti Vase,0,7,0,1,0,1,-7,0
Alderney,2013,Friendly,1,2,0,1,0,1,-1,0
Alderney,2013,Muratti Vase,2,9,0,1,0,1,-7,0
Alderney,2013,Tynwald Hill Tournament,4,5,0,1,1,2,-1,0
Alderney,2014,Muratti Vase,0,4,0,1,0,1,-4,0
Alderney,2015,Friendly,1,9,0,1,0,1,-8,0
Alderney,2015,Island Games,3,21,0,4,0,4,-18,0
Alderney,2015,Muratti Vase,0,5,0,1,0,1,-5,0
Alderney,2015,Niamh Challenge Cup,1,2,0,1,0,1,-1,0
Alderney,2016,Muratti Vase,0,1,0,1,0,1,-1,0
Alderney,2017,Island Games,3,12,1,3,0,4,-9,0
Alderney,2017,Muratti Vase,1,2,0,1,0,1,-1,0
Alderney,2018,Muratti Vase,0,2,0,1,0,1,-2,0
Alderney,2019,Inter Games Football Tournament,5,11,1,2,0,3,-6,0
Alderney,2019,Muratti Vase,0,2,0,1,0,1,-2,0
Alderney,2022,Muratti Vase,1,8,0,2,0,2,-7,0
Algeria,1963,Friendly,4,3,1,0,2,3,1,0
Algeria,1964,Friendly,4,3,1,1,1,3,1,0
Algeria,1965,All-African Games,6,6,2,3,0,5,0,0
Algeria,1965,Friendly,0,3,0,1,1,2,-3,0
Algeria,1966,Friendly,2,3,0,1,1,2,-1,0
Algeria,1967,African Cup of Nations qualification,9,2,4,0,0,4,7,0
Algeria,1967,Friendly,0,1,0,1,0,1,-1,0
Algeria,1968,African Cup of Nations,5,6,1,2,0,3,-1,0
Algeria,1968,FIFA World Cup qualification,1,2,0,1,1,2,-1,0
Algeria,1968,Friendly,0,0,0,0,1,1,0,0
Algeria,1969,African Cup of Nations qualification,3,4,1,2,1,4,-1,0
Algeria,1969,Friendly,4,3,2,1,0,3,1,0
Algeria,1970,African Cup of Nations qualification,3,4,1,1,0,2,-1,0
Algeria,1971,Friendly,1,1,0,0,2,2,0,0
Algeria,1972,FIFA World Cup qualification,2,5,1,1,0,2,-3,0
Algeria,1972,Friendly,5,4,3,1,0,4,1,0
Algeria,1972,Palestine Cup,13,6,4,2,0,6,7,0
Algeria,1973,African Cup of Nations qualification,2,3,0,1,1,2,-1,0
Algeria,1973,All-African Games,6,6,1,1,1,3,0,0
Algeria,1973,Friendly,2,6,1,2,0,3,-4,0
Algeria,1973,Palestine Cup,19,1,3,0,3,6,18,0
Algeria,1974,Friendly,1,5,0,2,1,3,-4,0
Algeria,1974,Kuneitra Cup,10,2,2,1,0,3,8,0
Algeria,1975,African Cup of Nations qualification,2,3,0,1,1,2,-1,0
Algeria,1975,Friendly,0,4,0,1,0,1,-4,0
Algeria,1976,FIFA World Cup qualification,1,0,1,0,1,2,1,0
Algeria,1976,Friendly,8,16,3,6,0,9,-8,0
Algeria,1977,African Cup of Nations qualification,7,5,2,2,0,4,2,0
Algeria,1977,FIFA World Cup qualification,1,3,0,1,1,2,-2,0
Algeria,1977,Friendly,3,1,1,0,1,2,2,0
Algeria,1978,All-African Games,9,2,4,0,1,5,7,1
Algeria,1978,Friendly,10,9,3,4,3,10,1,0
Algeria,1979,African Cup of Nations qualification,3,2,1,1,0,2,1,0
Algeria,1979,Friendly,1,1,1,1,0,2,0,0
Algeria,1980,African Cup of Nations,6,7,2,1,2,5,-1,0
Algeria,1980,FIFA World Cup qualification,8,4,2,0,2,4,4,0
Algeria,1980,Friendly,1,5,0,1,0,1,-4,0
Algeria,1981,African Cup of Nations qualification,13,5,2,1,1,4,8,0
Algeria,1981,FIFA World Cup qualification,8,2,3,1,0,4,6,0
Algeria,1981,Friendly,2,0,1,0,0,1,2,0
Algeria,1982,African Cup of Nations,5,6,2,2,1,5,-1,0
Algeria,1982,FIFA World Cup,5,5,2,1,0,3,0,0
Algeria,1982,Friendly,5,1,3,0,1,4,4,0
Algeria,1983,African Cup of Nations qualification,11,9,2,1,1,4,2,0
Algeria,1983,Friendly,6,5,1,2,0,3,1,0
Algeria,1984,African Cup of Nations,8,1,3,0,2,5,7,0
Algeria,1984,Friendly,10,13,2,3,1,6,-3,1
Algeria,1985,African Cup of Nations qualification,8,1,2,0,2,4,7,0
Algeria,1985,FIFA World Cup qualification,13,3,5,0,1,6,10,0
Algeria,1985,Friendly,3,10,0,4,2,6,-7,0
Algeria,1986,African Cup of Nations,2,3,0,1,2,3,-1,0
Algeria,1986,FIFA World Cup,1,5,0,2,1,3,-4,0
Algeria,1986,Friendly,11,8,3,1,3,7,3,1
Algeria,1986,Indonesia Tournament,1,0,1,0,0,1,1,1
Algeria,1986,Kirin Cup,1,2,0,1,0,1,-1,0
Algeria,1987,African Cup of Nations qualification,2,1,1,0,1,2,1,0
Algeria,1987,Arab Cup qualification,3,0,1,0,1,2,3,1
Algeria,1987,Friendly,0,2,0,1,0,1,-2,0
Algeria,1987,Indonesia Tournament,4,4,1,2,0,3,0,0
Algeria,1988,African Cup of Nations,4,4,1,1,3,5,0,0
Algeria,1988,Friendly,13,3,2,0,2,4,10,0
Algeria,1989,FIFA World Cup qualification,6,2,3,1,2,6,4,0
Algeria,1989,Friendly,4,6,1,3,4,8,-2,0
Algeria,1989,Malta International Tournament,3,0,2,0,1,3,3,0
Algeria,1990,African Cup of Nations,13,2,5,0,0,5,11,1
Algeria,1990,Friendly,10,2,3,0,2,5,8,0
Algeria,1991,Dakar Tournament,2,2,0,0,2,2,0,0
Algeria,1991,Friendly,12,6,4,0,4,8,6,0
Algeria,1992,African Cup of Nations,1,4,0,1,1,2,-3,0
Algeria,1992,African Cup of Nations qualification,3,2,1,1,0,2,1,0
Algeria,1992,FIFA World Cup qualification,3,3,1,1,0,2,0,0
Algeria,1992,Friendly,0,0,0,0,2,2,0,0
Algeria,1993,African Cup of Nations qualification,10,2,3,0,1,4,8,0
Algeria,1993,FIFA World Cup qualification,5,8,1,2,3,6,-3,0
Algeria,1994,African Cup of Nations qualification,2,2,0,0,3,3,0,0
Algeria,1994,Friendly,0,1,0,1,0,1,-1,0
Algeria,1995,African Cup of Nations qualification,10,5,4,1,2,7,5,1
Algeria,1995,Friendly,13,5,4,2,2,8,8,0
Algeria,1996,African Cup of Nations,5,3,2,1,1,4,2,0
Algeria,1996,African Cup of Nations qualification,4,1,1,0,0,1,3,1
Algeria,1996,FIFA World Cup qualification,2,3,1,1,0,2,-1,0
Algeria,1997,African Cup of Nations qualification,5,4,2,2,1,5,1,0
Algeria,1997,Friendly,8,7,4,3,3,10,1,0
Algeria,1998,African Cup of Nations,2,5,0,3,0,3,-3,0
Algeria,1998,African Cup of Nations qualification,5,0,2,0,0,2,5,0
Algeria,1998,Friendly,0,2,0,1,1,2,-2,0
Algeria,1999,African Cup of Nations qualification,7,4,2,1,1,4,3,0
Algeria,2000,African Cup of Nations,5,4,1,1,2,4,1,0
Algeria,2000,African Cup of Nations qualification,3,3,0,0,2,2,0,0
Algeria,2000,FIFA World Cup qualification,4,3,1,1,2,4,1,0
Algeria,2000,Friendly,14,10,3,3,1,7,4,0
Algeria,2001,African Cup of Nations qualification,6,4,3,1,0,4,2,0
Algeria,2001,FIFA World Cup qualification,9,11,2,3,1,6,-2,0
Algeria,2001,Friendly,5,7,1,2,2,5,-2,0
Algeria,2002,African Cup of Nations,2,5,0,2,1,3,-3,0
Algeria,2002,African Cup of Nations qualification,5,1,2,0,0,2,4,0
Algeria,2002,Friendly,6,2,1,0,3,4,4,0
Algeria,2003,African Cup of Nations qualification,1,0,1,0,1,2,1,0
Algeria,2003,FIFA World Cup qualification,7,0,2,0,0,2,7,0
Algeria,2003,Friendly,9,8,3,2,3,8,1,0
Algeria,2004,African Cup of Nations,5,7,1,2,1,4,-2,0
Algeria,2004,FIFA World Cup qualification,2,6,0,2,3,5,-4,0
Algeria,2004,Friendly,4,8,0,3,2,5,-4,0
Algeria,2005,FIFA World Cup qualification,6,9,1,2,2,5,-3,0
Algeria,2005,Friendly,3,3,1,1,0,2,0,0
Algeria,2006,African Cup of Nations qualification,1,0,1,0,1,2,1,0
Algeria,2006,Friendly,2,4,1,2,1,4,-2,0
Algeria,2007,African Cup of Nations qualification,5,6,1,2,1,4,-1,0
Algeria,2007,Friendly,8,9,2,2,0,4,-1,0
Algeria,2008,FIFA World Cup qualification,7,4,3,2,1,6,3,0
Algeria,2008,Friendly,3,2,1,0,2,3,1,0
Algeria,2009,FIFA World Cup qualification,10,4,5,1,1,7,6,0
Algeria,2009,Friendly,3,1,2,0,0,2,2,0
Algeria,2010,African Cup of Nations,4,10,2,3,1,6,-6,0
Algeria,2010,African Cup of Nations qualification,1,3,0,1,1,2,-2,0
Algeria,2010,FIFA World Cup,0,2,0,2,1,3,-2,0
Algeria,2010,Friendly,2,8,1,3,1,5,-6,0
Algeria,2011,African Cup of Nations qualification,4,5,2,1,1,4,-1,0
Algeria,2011,Friendly,1,0,1,0,0,1,1,0
Algeria,2012,African Cup of Nations qualification,9,2,4,0,0,4,7,0
Algeria,2012,FIFA World Cup qualification,5,2,1,1,0,2,3,0
Algeria,2012,Friendly,3,1,1,1,0,2,2,0
Algeria,2013,African Cup of Nations,2,5,0,2,1,3,-3,0
Algeria,2013,FIFA World Cup qualification,11,5,5,1,0,6,6,0
Algeria,2013,Friendly,5,2,2,0,2,4,3,0
Algeria,2014,African Cup of Nations qualification,11,4,5,1,0,6,7,0
Algeria,2014,FIFA World Cup,7,7,1,2,1,4,0,0
Algeria,2014,Friendly,7,2,3,0,0,3,5,0
Algeria,2015,African Cup of Nations,6,5,2,2,0,4,1,0
Algeria,2015,African Cup of Nations qualification,7,1,2,0,0,2,6,0
Algeria,2015,FIFA World Cup qualification,9,2,1,0,1,2,7,0
Algeria,2015,Friendly,7,5,2,2,1,5,2,0
Algeria,2016,African Cup of Nations qualification,18,4,3,0,1,4,14,0
Algeria,2016,FIFA World Cup qualification,2,4,0,1,1,2,-2,0
Algeria,2017,African Cup of Nations,5,6,0,1,2,3,-1,0
Algeria,2017,African Cup of Nations qualification,1,0,1,0,0,1,1,0
Algeria,2017,FIFA World Cup qualification,4,6,1,3,0,4,-2,0
Algeria,2017,Friendly,14,2,4,0,0,4,12,0
Algeria,2018,African Cup of Nations qualification,7,3,2,1,1,4,4,0
Algeria,2018,Friendly,8,11,2,4,0,6,-3,0
Algeria,2019,African Cup of Nations,13,2,6,0,1,7,11,1
Algeria,2019,African Cup of Nations qualification,7,1,2,0,1,3,6,0
Algeria,2019,Friendly,10,4,4,0,2,6,6,0
Algeria,2020,African Cup of Nations qualification,5,3,1,0,1,2,2,0
Algeria,2020,Friendly,3,2,1,0,1,2,1,0
Algeria,2021,African Cup of Nations qualification,8,3,1,0,1,2,5,0
Algeria,2021,Arab Cup,13,4,4,0,2,6,9,1
Algeria,2021,FIFA World Cup qualification,25,4,4,0,2,6,21,0
Algeria,2021,Friendly,12,2,4,0,0,4,10,0
Algeria,2022,African Cup of Nations,1,4,0,2,1,3,-3,0
Algeria,2022,African Cup of Nations qualification,4,0,2,0,0,2,4,0
Algeria,2022,FIFA World Cup qualification,2,2,1,1,0,2,0,0
Algeria,2022,Friendly,10,5,5,1,1,7,5,0
Algeria,2023,African Cup of Nations qualification,5,2,3,0,1,4,3,0
Algeria,2023,FIFA World Cup qualification,5,1,2,0,0,2,4,0
Algeria,2023,Friendly,8,3,2,0,2,4,5,0
Algeria,2024,African Cup of Nations,3,4,0,1,2,3,-1,0
Algeria,2024,African Cup of Nations qualification,11,1,4,0,0,4,10,0
Algeria,2024,FIFA Series,6,5,1,0,1,2,1,0
Algeria,2024,FIFA World Cup qualification,3,3,1,1,0,2,0,0
Algeria,2024,Friendly,7,0,2,0,0,2,7,0
Algeria,2025,FIFA World Cup qualification,8,2,2,0,0,2,6,0
Ambazonia,2005,Friendly,2,2,0,0,1,1,0,0
Ambazonia,2006,Viva World Cup,0,12,0,4,0,4,-12,0
Ambazonia,2007,Friendly,1,3,0,1,0,1,-2,0
American Samoa,1983,South Pacific Games,6,6,1,2,0,3,0,0
American Samoa,1987,South Pacific Games,1,42,0,4,0,4,-41,0
American Samoa,1994,Oceania Nations Cup qualification,3,7,0,3,0,3,-4,0
American Samoa,1998,Oceania Nations Cup qualification,3,23,0,4,0,4,-20,0
American Samoa,2000,Oceania Nations Cup qualification,1,2,0,1,0,1,-1,0
American Samoa,2001,FIFA World Cup qualification,0,57,0,4,0,4,-57,0
American Samoa,2002,Oceania Nations Cup qualification,2,29,0,4,0,4,-27,0
American Samoa,2004,FIFA World Cup qualification,1,34,0,4,0,4,-33,0
American Samoa,2007,South Pacific Games,1,38,0,4,0,4,-37,0
American Samoa,2011,FIFA World Cup qualification,3,3,1,1,1,3,0,0
American Samoa,2011,Pacific Games,0,26,0,5,0,5,-26,0
American Samoa,2015,FIFA World Cup qualification,6,4,2,1,0,3,2,0
American Samoa,2015,Friendly,0,6,0,1,0,1,-6,0
American Samoa,2019,Pacific Games,2,36,0,4,1,5,-34,0
American Samoa,2023,Pacific Games,2,31,0,4,0,4,-29,0
American Samoa,2024,FIFA World Cup qualification,0,2,0,1,0,1,-2,0
Andalusia,1923,Friendly,1,4,0,1,0,1,-3,0
Andalusia,1990,Friendly,1,1,0,0,2,2,0,0
Andalusia,1999,Friendly,1,0,1,0,0,1,1,0
Andalusia,2000,Friendly,2,0,1,0,0,1,2,0
Andalusia,2001,Friendly,6,4,1,0,1,2,2,0
Andalusia,2002,Friendly,3,2,1,0,0,1,1,0
Andalusia,2003,Friendly,1,0,1,0,0,1,1,0
Andalusia,2004,Friendly,0,0,0,0,1,1,0,0
Andalusia,2005,Friendly,4,1,1,0,0,1,3,0
Andalusia,2007,Friendly,4,1,1,0,0,1,3,0
Andalusia,2013,Friendly,2,1,1,0,0,1,1,0
Andorra,1996,Friendly,1,6,0,1,0,1,-5,0
Andorra,1997,Friendly,2,8,0,2,0,2,-6,0
Andorra,1998,Friendly,1,11,0,4,1,5,-10,0
Andorra,1998,UEFA Euro qualification,1,7,0,3,0,3,-6,0
Andorra,1999,Friendly,0,4,0,1,0,1,-4,0
Andorra,1999,UEFA Euro qualification,2,21,0,7,0,7,-19,0
Andorra,2000,FIFA World Cup qualification,3,11,0,4,0,4,-8,0
Andorra,2000,Friendly,2,0,1,0,0,1,2,0
Andorra,2000,Malta International Tournament,1,4,0,1,2,3,-3,0
Andorra,2001,FIFA World Cup qualification,2,25,0,6,0,6,-23,0
Andorra,2002,Friendly,3,6,1,2,1,4,-3,0
Andorra,2002,UEFA Euro qualification,1,3,0,2,0,2,-2,0
Andorra,2003,Friendly,0,2,0,1,0,1,-2,0
Andorra,2003,UEFA Euro qualification,0,15,0,6,0,6,-15,0
Andorra,2004,FIFA World Cup qualification,2,11,1,3,0,4,-9,0
Andorra,2004,Friendly,0,8,0,2,1,3,-8,0
Andorra,2005,FIFA World Cup qualification,2,23,0,6,2,8,-21,0
Andorra,2006,Friendly,0,3,0,1,0,1,-3,0
Andorra,2006,UEFA Euro qualification,1,19,0,4,0,4,-18,0
Andorra,2007,Friendly,0,0,0,0,1,1,0,0
Andorra,2007,UEFA Euro qualification,1,23,0,8,0,8,-22,0
Andorra,2008,FIFA World Cup qualification,1,12,0,4,0,4,-11,0
Andorra,2008,Friendly,1,5,0,2,0,2,-4,0
Andorra,2009,FIFA World Cup qualification,2,27,0,6,0,6,-25,0
Andorra,2009,Friendly,1,3,0,1,0,1,-2,0
Andorra,2010,Friendly,0,6,0,3,0,3,-6,0
Andorra,2010,UEFA Euro qualification,1,11,0,4,0,4,-10,0
Andorra,2011,Friendly,1,2,0,1,0,1,-1,0
Andorra,2011,UEFA Euro qualification,0,14,0,6,0,6,-14,0
Andorra,2012,FIFA World Cup qualification,0,13,0,4,0,4,-13,0
Andorra,2012,Friendly,0,7,0,3,1,4,-7,0
Andorra,2013,FIFA World Cup qualification,0,17,0,6,0,6,-17,0
Andorra,2013,Friendly,1,1,0,0,1,1,0,0
Andorra,2014,Friendly,0,4,0,2,0,2,-4,0
Andorra,2014,UEFA Euro qualification,2,17,0,4,0,4,-15,0
Andorra,2015,Friendly,0,2,0,2,0,2,-2,0
Andorra,2015,UEFA Euro qualification,2,19,0,6,0,6,-17,0
Andorra,2016,FIFA World Cup qualification,1,13,0,4,0,4,-12,0
Andorra,2016,Friendly,0,3,0,2,1,3,-3,0
Andorra,2017,FIFA World Cup qualification,1,10,1,4,1,6,-9,0
Andorra,2017,Friendly,0,1,0,1,0,1,-1,0
Andorra,2018,Friendly,1,0,1,0,2,3,1,0
Andorra,2018,UEFA Nations League,2,9,0,2,4,6,-7,0
Andorra,2019,UEFA Euro qualification,3,20,1,8,1,10,-17,0
Andorra,2020,Friendly,1,9,0,2,0,2,-8,0
Andorra,2020,UEFA Nations League,1,11,0,4,2,6,-10,0
Andorra,2021,FIFA World Cup qualification,8,24,2,8,0,10,-16,0
Andorra,2021,Friendly,1,4,0,1,1,2,-3,0
Andorra,2022,Friendly,2,2,2,2,0,4,0,0
Andorra,2022,UEFA Nations League,6,7,2,2,2,6,-1,0
Andorra,2023,UEFA Euro qualification,3,20,0,8,2,10,-17,0
Andorra,2024,FIFA Series,1,2,0,1,1,2,-1,0
Andorra,2024,Friendly,2,8,1,3,0,4,-6,0
Andorra,2024,UEFA Nations League,0,4,0,3,1,4,-4,0
Andorra,2025,FIFA World Cup qualification,0,4,0,2,0,2,-4,0
Angola,1976,Friendly,3,4,0,1,1,2,-1,0
Angola,1978,Friendly,3,3,0,0,1,1,0,0
Angola,1979,Friendly,3,3,2,2,0,4,0,0
Angola,1980,African Cup of Nations qualification,1,1,0,0,2,2,0,0
Angola,1980,Friendly,1,1,0,0,2,2,0,0
Angola,1981,Friendly,2,1,1,0,2,3,1,0
Angola,1982,African Cup of Nations qualification,6,2,1,0,1,2,4,0
Angola,1982,Friendly,2,5,0,2,0,2,-3,0
Angola,1983,African Cup of Nations qualification,1,2,1,1,0,2,-1,0
Angola,1983,Friendly,0,1,0,1,0,1,-1,0
Angola,1984,FIFA World Cup qualification,1,1,1,1,0,2,0,0
Angola,1984,Friendly,4,1,2,0,0,2,3,0
Angola,1985,FIFA World Cup qualification,2,3,0,1,1,2,-1,0
Angola,1985,Friendly,8,6,2,1,2,5,2,0
Angola,1986,African Cup of Nations qualification,1,1,1,1,0,2,0,0
Angola,1986,Friendly,1,1,1,1,0,2,0,0
Angola,1987,African Cup of Nations qualification,1,3,1,1,0,2,-2,0
Angola,1987,Friendly,4,5,1,1,4,6,-1,0
Angola,1988,African Cup of Nations qualification,0,1,0,1,1,2,-1,0
Angola,1988,FIFA World Cup qualification,2,1,1,0,1,2,1,0
Angola,1988,Friendly,9,11,2,2,2,6,-2,0
Angola,1989,African Cup of Nations qualification,1,6,0,2,0,2,-5,0
Angola,1989,FIFA World Cup qualification,6,7,1,3,2,6,-1,0
Angola,1989,Friendly,2,7,1,1,1,3,-5,0
Angola,1990,African Cup of Nations qualification,1,2,0,1,1,2,-1,0
Angola,1990,Friendly,11,7,4,2,0,6,4,0
Angola,1991,African Cup of Nations qualification,2,4,0,2,2,4,-2,0
Angola,1992,FIFA World Cup qualification,0,1,0,1,0,1,-1,0
Angola,1993,FIFA World Cup qualification,3,3,1,1,2,4,0,0
Angola,1994,African Cup of Nations qualification,3,3,1,1,1,3,0,0
Angola,1994,Friendly,2,1,1,0,0,1,1,0
Angola,1995,African Cup of Nations qualification,14,5,5,1,1,7,9,0
Angola,1996,African Cup of Nations,4,6,0,2,1,3,-2,0
Angola,1996,African Cup of Nations qualification,1,2,0,1,0,1,-1,0
Angola,1996,FIFA World Cup qualification,7,2,3,0,0,3,5,0
Angola,1997,African Cup of Nations qualification,3,2,2,1,0,3,1,0
Angola,1997,FIFA World Cup qualification,5,3,1,0,4,5,2,0
Angola,1998,African Cup of Nations,5,8,0,1,2,3,-3,0
Angola,1998,African Cup of Nations qualification,3,3,1,2,0,3,0,0
Angola,1998,COSAFA Cup,5,4,1,0,3,4,1,0
Angola,1998,COSAFA Cup qualification,1,0,1,0,0,1,1,1
Angola,1998,Friendly,1,3,0,2,0,2,-2,0
Angola,1999,African Cup of Nations qualification,7,9,1,2,2,5,-2,0
Angola,1999,COSAFA Cup,4,1,3,0,1,4,3,0
Angola,1999,COSAFA Cup qualification,2,1,1,0,0,1,1,0
Angola,2000,African Cup of Nations qualification,7,3,2,0,2,4,4,0
Angola,2000,COSAFA Cup,1,2,0,1,1,2,-1,0
Angola,2000,FIFA World Cup qualification,10,5,3,1,0,4,5,0
Angola,2000,Friendly,1,1,0,0,1,1,0,0
Angola,2001,African Cup of Nations qualification,6,5,2,2,0,4,1,0
Angola,2001,COSAFA Cup,3,1,2,0,2,4,2,1
Angola,2001,FIFA World Cup qualification,9,5,2,0,4,6,4,0
Angola,2001,Friendly,3,6,1,2,0,3,-3,0
Angola,2002,African Cup of Nations qualification,0,1,0,1,1,2,-1,0
Angola,2002,COSAFA Cup,1,2,0,1,0,1,-1,0
Angola,2002,Friendly,2,2,1,1,1,3,0,0
Angola,2003,African Cup of Nations qualification,7,3,1,0,1,2,4,0
Angola,2003,COSAFA Cup,0,1,0,1,0,1,-1,0
Angola,2003,FIFA World Cup qualification,3,3,1,1,0,2,0,0
Angola,2003,Friendly,7,5,2,1,2,5,2,0
Angola,2004,COSAFA Cup,4,2,2,0,2,4,2,0
Angola,2004,FIFA World Cup qualification,5,2,3,0,2,5,3,0
Angola,2004,Friendly,5,5,1,1,1,3,0,0
Angola,2005,COSAFA Cup,1,2,0,1,0,1,-1,0
Angola,2005,FIFA World Cup qualification,7,4,3,1,1,5,3,0
Angola,2005,Friendly,5,6,2,2,2,6,-1,0
Angola,2006,African Cup of Nations,4,5,1,1,1,3,-1,0
Angola,2006,African Cup of Nations qualification,5,1,2,0,0,2,4,1
Angola,2006,COSAFA Cup,10,5,3,1,0,4,5,0
Angola,2006,FIFA World Cup,1,2,0,1,2,3,-1,0
Angola,2006,Friendly,5,9,0,3,2,5,-4,0
Angola,2007,African Cup of Nations qualification,11,4,2,1,1,4,7,0
Angola,2007,COSAFA Cup,2,0,1,0,1,2,2,0
Angola,2007,Friendly,3,9,1,3,1,5,-6,0
Angola,2008,African Cup of Nations,5,4,1,1,2,4,1,0
Angola,2008,FIFA World Cup qualification,11,8,3,2,1,6,3,0
Angola,2008,Friendly,5,6,0,1,3,4,-1,0
Angola,2009,COSAFA Cup,0,2,0,1,0,1,-2,0
Angola,2009,Friendly,7,12,2,4,6,12,-5,0
Angola,2010,African Cup of Nations,6,5,1,1,2,4,1,0
Angola,2010,African Cup of Nations qualification,1,3,1,1,0,2,-2,0
Angola,2010,Friendly,4,5,1,2,2,5,-1,0
Angola,2011,African Cup of Nations qualification,6,2,3,1,0,4,4,0
Angola,2011,Friendly,3,4,1,2,4,7,-1,0
Angola,2012,African Cup of Nations,4,5,1,1,1,3,-1,0
Angola,2012,African Cup of Nations qualification,3,3,1,1,0,2,0,0
Angola,2012,FIFA World Cup qualification,1,1,0,0,2,2,0,0
Angola,2012,Friendly,8,3,3,0,5,8,5,0
Angola,2013,African Cup of Nations,1,4,0,2,1,3,-3,0
Angola,2013,COSAFA Cup,4,4,1,1,1,3,0,0
Angola,2013,FIFA World Cup qualification,7,5,1,1,2,4,2,0
Angola,2013,Friendly,4,0,2,0,0,2,4,0
Angola,2014,African Cup of Nations qualification,5,5,1,2,3,6,0,0
Angola,2014,Friendly,4,2,1,0,3,4,2,0
Angola,2015,African Cup of Nations qualification,4,0,1,0,1,2,4,0
Angola,2015,FIFA World Cup qualification,1,4,0,2,0,2,-3,0
Angola,2015,Friendly,3,4,2,2,0,4,-1,0
Angola,2016,African Cup of Nations qualification,2,8,0,3,1,4,-6,0
Angola,2016,COSAFA Cup,0,7,0,3,0,3,-7,0
Angola,2016,Friendly,1,1,0,0,1,1,0,0
Angola,2017,African Cup of Nations qualification,1,3,0,1,0,1,-2,0
Angola,2017,COSAFA Cup,1,0,1,0,2,3,1,0
Angola,2017,Friendly,0,2,0,1,1,2,-2,0
Angola,2018,African Cup of Nations qualification,7,3,3,1,0,4,4,0
Angola,2018,COSAFA Cup,2,2,1,1,1,3,0,0
Angola,2018,Friendly,3,3,0,0,2,2,0,0
Angola,2019,African Cup of Nations,1,2,0,1,2,3,-1,0
Angola,2019,African Cup of Nations qualification,3,5,1,2,0,3,-2,0
Angola,2019,FIFA World Cup qualification,3,1,2,0,0,2,2,0
Angola,2019,Friendly,2,0,1,0,0,1,2,0
Angola,2020,African Cup of Nations qualification,0,1,0,1,1,2,-1,0
Angola,2020,Friendly,3,0,1,0,0,1,3,0
Angola,2021,African Cup of Nations qualification,2,1,1,1,0,2,1,0
Angola,2021,FIFA World Cup qualification,6,8,1,3,2,6,-2,0
Angola,2022,African Cup of Nations qualification,3,2,1,0,1,2,1,0
Angola,2022,COSAFA Cup,6,2,2,1,0,3,4,0
Angola,2022,Friendly,5,3,2,0,2,4,2,0
Angola,2023,African Cup of Nations qualification,3,3,1,1,2,4,0,0
Angola,2023,COSAFA Cup,5,4,1,1,1,3,1,0
Angola,2023,FIFA World Cup qualification,0,0,0,0,2,2,0,0
Angola,2023,Friendly,1,5,0,1,2,3,-4,0
Angola,2024,African Cup of Nations,9,4,3,1,1,5,5,0
Angola,2024,African Cup of Nations qualification,6,1,4,0,0,4,5,0
Angola,2024,FIFA World Cup qualification,2,1,1,0,1,2,1,0
Angola,2024,Friendly,3,1,1,1,2,4,2,0
Angola,2025,FIFA World Cup qualification,2,3,0,1,1,2,-1,0
Anguilla,1985,Friendly,0,1,0,1,0,1,-1,0
Anguilla,1991,CFU Caribbean Cup qualification,1,7,0,1,1,2,-6,0
Anguilla,1992,CFU Caribbean Cup qualification,0,8,0,2,0,2,-8,0
Anguilla,1993,CFU Caribbean Cup qualification,0,5,0,2,0,2,-5,0
Anguilla,1994,CFU Caribbean Cup qualification,0,11,0,2,0,2,-11,0
Anguilla,1995,CFU Caribbean Cup qualification,2,4,0,2,0,2,-2,0
Anguilla,1996,CFU Caribbean Cup qualification,0,12,0,2,0,2,-12,0
Anguilla,1997,CFU Caribbean Cup qualification,2,12,0,3,0,3,-10,0
Anguilla,1998,CFU Caribbean Cup qualification,1,28,0,2,0,2,-27,0
Anguilla,2000,FIFA World Cup qualification,2,5,0,2,0,2,-3,0
Anguilla,2000,Friendly,4,8,1,1,0,2,-4,0
Anguilla,2001,CFU Caribbean Cup qualification,5,4,1,1,0,2,1,0
Anguilla,2002,Friendly,2,5,0,3,0,3,-3,0
Anguilla,2004,FIFA World Cup qualification,0,6,0,1,1,2,-6,0
Anguilla,2006,CFU Caribbean Cup qualification,5,18,0,3,0,3,-13,0
Anguilla,2008,CFU Caribbean Cup qualification,1,3,0,1,0,1,-2,0
Anguilla,2008,FIFA World Cup qualification,0,16,0,2,0,2,-16,0
Anguilla,2010,CFU Caribbean Cup qualification,4,8,1,2,0,3,-4,0
Anguilla,2010,Friendly,2,5,0,2,0,2,-3,0
Anguilla,2011,FIFA World Cup qualification,0,6,0,2,0,2,-6,0
Anguilla,2011,Friendly,0,0,0,0,1,1,0,0
Anguilla,2012,CFU Caribbean Cup qualification,1,14,0,2,0,2,-13,0
Anguilla,2012,Friendly,0,1,0,1,0,1,-1,0
Anguilla,2014,CFU Caribbean Cup qualification,0,4,0,1,0,1,-4,0
Anguilla,2015,FIFA World Cup qualification,0,8,0,2,0,2,-8,0
Anguilla,2016,CFU Caribbean Cup qualification,0,4,0,1,0,1,-4,0
Anguilla,2016,Friendly,0,2,0,1,0,1,-2,0
Anguilla,2018,CONCACAF Nations League qualification,1,12,0,2,1,3,-11,0
Anguilla,2018,Friendly,4,4,1,1,1,3,0,0
Anguilla,2019,CONCACAF Nations League,2,21,0,4,0,4,-19,0
Anguilla,2019,CONCACAF Nations League qualification,0,3,0,1,0,1,-3,0
Anguilla,2019,Friendly,0,15,0,1,0,1,-15,0
Anguilla,2021,FIFA World Cup qualification,0,23,0,4,0,4,-23,0
Anguilla,2022,CONCACAF Nations League,1,3,0,1,2,3,-2,0
Anguilla,2023,CONCACAF Nations League,1,21,0,5,0,5,-20,0
Anguilla,2024,CONCACAF Nations League,3,4,1,3,0,4,-1,0
Anguilla,2024,FIFA World Cup qualification,1,13,0,2,2,4,-12,0
Antigua and Barbuda,1972,CONCACAF Championship qualification,3,22,0,4,0,4,-19,0
Antigua and Barbuda,1975,Friendly,1,0,1,0,0,1,1,0
Antigua and Barbuda,1978,CFU Caribbean Cup,1,8,0,3,0,3,-7,0
Antigua and Barbuda,1978,Friendly,0,7,0,2,0,2,-7,0
Antigua and Barbuda,1979,CFU Caribbean Cup qualification,1,3,0,2,0,2,-2,0
Antigua and Barbuda,1983,CFU Caribbean Cup,1,5,0,3,0,3,-4,0
Antigua and Barbuda,1983,CFU Caribbean Cup qualification,10,5,2,0,2,4,5,1
Antigua and Barbuda,1984,CONCACAF Championship qualification,2,5,1,1,0,2,-3,0
Antigua and Barbuda,1985,CFU Caribbean Cup qualification,2,2,1,1,0,2,0,0
Antigua and Barbuda,1988,CFU Caribbean Cup,3,3,0,0,3,3,0,0
Antigua and Barbuda,1988,CFU Caribbean Cup qualification,2,1,1,0,1,2,1,0
Antigua and Barbuda,1988,CONCACAF Championship qualification,1,4,0,2,0,2,-3,0
Antigua and Barbuda,1989,CFU Caribbean Cup qualification,2,0,2,0,0,2,2,0
Antigua and Barbuda,1990,CFU Caribbean Cup qualification,2,5,0,2,1,3,-3,0
Antigua and Barbuda,1990,Friendly,1,6,0,2,0,2,-5,0
Antigua and Barbuda,1992,CFU Caribbean Cup,2,5,0,1,1,2,-3,0
Antigua and Barbuda,1992,CFU Caribbean Cup qualification,7,0,2,0,0,2,7,0
Antigua and Barbuda,1992,FIFA World Cup qualification,5,6,1,2,1,4,-1,0
Antigua and Barbuda,1993,CFU Caribbean Cup qualification,4,2,1,1,0,2,2,0
Antigua and Barbuda,1993,Friendly,3,0,1,0,0,1,3,0
Antigua and Barbuda,1994,CFU Caribbean Cup qualification,10,3,1,1,0,2,7,0
Antigua and Barbuda,1995,CFU Caribbean Cup,3,8,1,2,0,3,-5,0
Antigua and Barbuda,1995,CFU Caribbean Cup qualification,3,3,0,0,2,2,0,0
Antigua and Barbuda,1995,Friendly,1,2,0,1,0,1,-1,0
Antigua and Barbuda,1996,FIFA World Cup qualification,4,6,0,1,1,2,-2,0
Antigua and Barbuda,1997,CFU Caribbean Cup,1,5,0,2,0,2,-4,0
Antigua and Barbuda,1997,Friendly,2,4,1,1,1,3,-2,0
Antigua and Barbuda,1998,CFU Caribbean Cup,11,9,2,3,0,5,2,0
Antigua and Barbuda,1998,CFU Caribbean Cup qualification,2,1,1,0,0,1,1,0
Antigua and Barbuda,1998,Friendly,2,2,0,0,2,2,0,0
Antigua and Barbuda,1999,CFU Caribbean Cup qualification,2,5,0,2,1,3,-3,0
Antigua and Barbuda,1999,Friendly,4,5,2,2,1,5,-1,0
Antigua and Barbuda,2000,FIFA World Cup qualification,4,15,1,3,2,6,-11,0
Antigua and Barbuda,2000,Friendly,6,7,1,1,2,4,-1,0
Antigua and Barbuda,2001,CFU Caribbean Cup qualification,4,5,0,1,1,2,-1,0
Antigua and Barbuda,2001,Friendly,1,2,0,1,1,2,-1,0
Antigua and Barbuda,2002,Friendly,5,2,1,1,0,2,3,0
Antigua and Barbuda,2002,Gold Cup qualification,1,2,0,1,1,2,-1,0
Antigua and Barbuda,2003,Gold Cup qualification,0,6,0,3,0,3,-6,0
Antigua and Barbuda,2004,CFU Caribbean Cup qualification,6,8,1,2,0,3,-2,0
Antigua and Barbuda,2004,FIFA World Cup qualification,2,3,1,1,0,2,-1,0
Antigua and Barbuda,2004,Friendly,3,2,1,0,0,1,1,0
Antigua and Barbuda,2005,Friendly,4,7,1,2,0,3,-3,0
Antigua and Barbuda,2006,CFU Caribbean Cup qualification,8,17,2,4,0,6,-9,0
Antigua and Barbuda,2006,Friendly,4,7,1,2,1,4,-3,0
Antigua and Barbuda,2007,Friendly,2,3,1,1,0,2,-1,0
Antigua and Barbuda,2008,CFU Caribbean Cup,3,6,0,1,2,3,-3,0
Antigua and Barbuda,2008,CFU Caribbean Cup qualification,16,10,4,1,1,6,6,1
Antigua and Barbuda,2008,FIFA World Cup qualification,7,8,2,2,0,4,-1,0
Antigua and Barbuda,2008,Friendly,13,4,3,1,0,4,9,0
Antigua and Barbuda,2009,Friendly,5,5,1,1,1,3,0,0
Antigua and Barbuda,2010,CFU Caribbean Cup,2,4,1,2,0,3,-2,0
Antigua and Barbuda,2010,CFU Caribbean Cup qualification,2,1,1,0,2,3,1,0
Antigua and Barbuda,2010,Friendly,6,2,1,1,1,3,4,0
Antigua and Barbuda,2011,FIFA World Cup qualification,26,5,5,1,0,6,21,0
Antigua and Barbuda,2011,Friendly,6,6,1,1,3,5,0,0
Antigua and Barbuda,2012,CFU Caribbean Cup,3,3,1,2,0,3,0,0
Antigua and Barbuda,2012,FIFA World Cup qualification,4,13,0,5,1,6,-9,0
Antigua and Barbuda,2012,Friendly,0,5,0,2,0,2,-5,0
Antigua and Barbuda,2014,CFU Caribbean Cup,2,4,0,1,1,2,-2,0
Antigua and Barbuda,2014,CFU Caribbean Cup qualification,2,2,1,1,0,2,0,0
Antigua and Barbuda,2015,FIFA World Cup qualification,6,6,2,2,0,4,0,0
Antigua and Barbuda,2015,Friendly,4,0,3,0,0,3,4,0
Antigua and Barbuda,2016,CFU Caribbean Cup qualification,2,5,1,2,0,3,-3,0
Antigua and Barbuda,2016,Friendly,0,1,0,1,0,1,-1,0
Antigua and Barbuda,2018,CONCACAF Nations League qualification,8,7,1,2,0,3,1,0
Antigua and Barbuda,2018,Friendly,4,5,1,1,1,3,-1,0
Antigua and Barbuda,2019,CONCACAF Nations League,8,17,3,3,0,6,-9,0
Antigua and Barbuda,2019,CONCACAF Nations League qualification,2,1,1,0,0,1,1,0
Antigua and Barbuda,2019,Friendly,3,12,0,2,0,2,-9,0
Antigua and Barbuda,2021,FIFA World Cup qualification,6,5,2,1,1,4,1,0
Antigua and Barbuda,2022,CONCACAF Nations League,3,5,2,2,0,4,-2,0
Antigua and Barbuda,2023,CONCACAF Nations League,11,24,2,5,1,8,-13,0
Antigua and Barbuda,2023,Gold Cup qualification,0,5,0,1,0,1,-5,0
Antigua and Barbuda,2024,CONCACAF Nations League,2,15,0,5,1,6,-13,0
Antigua and Barbuda,2024,FIFA World Cup qualification,1,2,0,1,1,2,-1,0
Arameans Suryoye,2008,Viva World Cup,7,6,2,2,1,5,1,0
Arameans Suryoye,2014,CONIFA World Football Cup,9,6,3,1,1,5,3,0
Argentina,1902,Friendly,6,0,1,0,0,1,6,0
Argentina,1903,Friendly,2,3,0,1,0,1,-1,0
Argentina,1905,Copa Lipton,0,0,0,0,1,1,0,0
Argentina,1906,Copa Lipton,2,0,1,0,0,1,2,1
Argentina,1906,Copa Newton,2,1,1,0,0,1,1,1
Argentina,1908,Copa Lipton,2,2,0,0,1,1,0,0
Argentina,1908,Copa Newton,2,1,1,0,0,1,1,1
Argentina,1908,Copa Premio Honor Argentino,0,1,0,1,0,1,-1,0
Argentina,1909,Copa Lipton,2,1,1,0,0,1,1,1
Argentina,1909,Copa Newton,2,2,0,0,1,1,0,0
Argentina,1909,Copa Premio Honor Argentino,3,1,1,0,0,1,2,1
Argentina,1910,Copa Lipton,1,3,0,1,0,1,-2,0
Argentina,1910,Copa Premio Honor Argentino,3,7,0,1,1,2,-4,0
Argentina,1910,Friendly,15,3,4,0,0,4,12,0
Argentina,1911,Copa Lipton,0,2,0,1,0,1,-2,0
Argentina,1911,Copa Newton,3,2,1,0,0,1,1,1
Argentina,1911,Copa Premio Honor Argentino,2,0,1,0,0,1,2,1
Argentina,1911,Copa Premio Honor Uruguayo,1,4,0,1,1,2,-3,0
Argentina,1912,Copa Lipton,0,2,0,1,0,1,-2,0
Argentina,1912,Copa Newton,3,3,0,0,1,1,0,0
Argentina,1912,Copa Premio Honor Argentino,0,1,0,1,0,1,-1,0
Argentina,1912,Copa Premio Honor Uruguayo,0,3,0,1,0,1,-3,0
Argentina,1912,Friendly,3,1,1,0,0,1,2,0
Argentina,1913,Copa Lipton,4,0,1,0,0,1,4,1
Argentina,1913,Copa Newton,0,1,0,1,0,1,-1,0
Argentina,1913,Copa Premio Honor Argentino,2,0,1,0,0,1,2,1
Argentina,1913,Copa Premio Honor Uruguayo,0,1,0,1,0,1,-1,0
Argentina,1913,Friendly,5,2,2,0,1,3,3,0
Argentina,1914,Copa Premio Honor Argentino,2,1,1,0,0,1,1,1
Argentina,1914,Copa Premio Honor Uruguayo,2,3,0,1,0,1,-1,0
Argentina,1914,Copa Roca,0,1,0,1,0,1,-1,0
Argentina,1914,Friendly,3,0,1,0,0,1,3,0
Argentina,1915,Copa Lipton,2,1,1,0,0,1,1,1
Argentina,1915,Copa Newton,0,2,0,1,0,1,-2,0
Argentina,1915,Copa Premio Honor Uruguayo,3,2,1,0,0,1,1,1
Argentina,1916,Copa América,7,2,1,0,2,3,5,0
Argentina,1916,Copa Lipton,2,1,1,0,0,1,1,1
Argentina,1916,Copa Newton,3,1,1,0,0,1,2,1
Argentina,1916,Copa Premio Honor Uruguayo,1,0,1,0,0,1,1,1
Argentina,1916,Friendly,9,5,2,1,0,3,4,0
Argentina,1917,Copa América,5,3,2,1,0,3,2,0
Argentina,1917,Copa Lipton,1,0,1,0,0,1,1,1
Argentina,1917,Copa Newton,0,1,0,1,0,1,-1,0
Argentina,1917,Copa Premio Honor Uruguayo,2,0,1,0,0,1,2,1
Argentina,1918,Copa Lipton,1,1,0,0,1,1,0,0
Argentina,1918,Copa Newton,2,0,1,0,0,1,2,1
Argentina,1918,Copa Premio Honor Argentino,2,1,1,0,1,2,1,1
Argentina,1918,Copa Premio Honor Uruguayo,2,4,0,1,1,2,-2,0
Argentina,1919,Copa América,7,7,1,2,0,3,0,0
Argentina,1919,Copa Lipton,1,2,0,1,0,1,-1,0
Argentina,1919,Copa Newton,1,2,0,1,0,1,-1,0
Argentina,1919,Copa Premio Honor Argentino,6,1,1,0,0,1,5,1
Argentina,1919,Copa Premio Honor Uruguayo,1,4,0,1,0,1,-3,0
Argentina,1919,Friendly,17,10,4,1,1,6,7,0
Argentina,1920,Copa América,4,2,1,0,2,3,2,0
Argentina,1920,Copa Newton,1,3,0,1,0,1,-2,0
Argentina,1920,Copa Premio Honor Argentino,1,0,1,0,0,1,1,1
Argentina,1920,Copa Premio Honor Uruguayo,0,2,0,1,0,1,-2,0
Argentina,1921,Copa América,5,0,3,0,0,3,5,1
Argentina,1921,Friendly,3,5,0,1,1,2,-2,0
Argentina,1922,Copa América,6,3,2,2,0,4,3,0
Argentina,1922,Copa Lipton,0,1,0,1,0,1,-1,0
Argentina,1922,Copa Newton,2,2,0,0,1,1,0,0
Argentina,1922,Copa Premio Honor Uruguayo,0,1,0,1,0,1,-1,0
Argentina,1922,Copa Roca,1,2,0,1,0,1,-1,0
Argentina,1922,Friendly,1,0,1,0,0,1,1,0
Argentina,1923,Copa América,6,6,2,1,0,3,0,0
Argentina,1923,Copa Chevallier Boutell,1,2,1,1,0,2,-1,1
Argentina,1923,Copa Lipton,0,0,0,0,1,1,0,0
Argentina,1923,Copa Premio Honor Uruguayo,4,2,1,0,1,2,2,1
Argentina,1923,Copa Roca,2,0,1,0,0,1,2,1
Argentina,1923,Friendly,2,4,0,1,1,2,-2,0
Argentina,1924,Copa América,2,0,1,0,2,3,2,0
Argentina,1924,Copa Chevallier Boutell,4,3,1,1,0,2,1,0
Argentina,1924,Copa Lipton,0,2,0,1,0,1,-2,0
Argentina,1924,Copa Newton,4,0,1,0,0,1,4,1
Argentina,1924,Friendly,3,2,1,0,1,2,1,0
Argentina,1925,Copa América,11,4,3,0,1,4,7,0
Argentina,1925,Copa Chevallier Boutell,2,2,0,0,2,2,0,0
Argentina,1926,Copa América,14,3,2,1,1,4,11,0
Argentina,1926,Copa Chevallier Boutell,4,2,2,0,0,2,2,1
Argentina,1927,Copa América,15,4,3,0,0,3,11,1
Argentina,1927,Copa Lipton,0,1,0,1,0,1,-1,0
Argentina,1927,Copa Newton,1,0,1,0,0,1,1,1
Argentina,1928,Copa Lipton,2,2,0,0,1,1,0,0
Argentina,1928,Copa Newton,1,0,1,0,0,1,1,1
Argentina,1928,Friendly,0,0,0,0,1,1,0,0
Argentina,1928,Olympic Games,25,8,3,1,1,5,17,0
Argentina,1929,Copa América,9,1,3,0,0,3,8,1
Argentina,1929,Copa Lipton,0,0,0,0,1,1,0,0
Argentina,1929,Copa Newton,1,2,0,1,0,1,-1,0
Argentina,1929,Friendly,3,1,1,0,1,2,2,0
Argentina,1930,Copa Newton,1,1,0,0,1,1,0,0
Argentina,1930,FIFA World Cup,18,9,4,1,0,5,9,0
Argentina,1930,Friendly,3,1,1,0,0,1,2,0
Argentina,1931,Copa Chevallier Boutell,4,2,1,0,1,2,2,1
Argentina,1931,Friendly,2,1,1,0,1,2,1,0
Argentina,1932,Friendly,2,1,1,1,0,2,1,0
Argentina,1933,Friendly,6,3,2,1,0,3,3,1
Argentina,1934,FIFA World Cup,2,3,0,1,0,1,-1,0
Argentina,1934,Friendly,3,2,1,0,1,2,1,0
Argentina,1935,Copa América,8,5,2,1,0,3,3,0
Argentina,1935,Friendly,4,1,1,0,1,2,3,0
Argentina,1936,Copa América,2,1,1,0,0,1,1,1
Argentina,1936,Friendly,2,2,1,1,0,2,0,0
Argentina,1937,Copa América,12,4,4,1,0,5,8,1
Argentina,1937,Copa Lipton,5,1,1,0,0,1,4,1
Argentina,1937,Copa Newton,3,0,1,0,0,1,3,1
Argentina,1938,Friendly,4,2,2,0,0,2,2,0
Argentina,1939,Copa Chevallier Boutell,3,2,1,0,1,2,1,0
Argentina,1939,Copa Roca,7,4,1,1,0,2,3,0
Argentina,1940,Copa Chevallier Boutell,7,1,2,0,0,2,6,1
Argentina,1940,Copa Roca,18,7,3,1,1,5,11,1
Argentina,1940,Friendly,12,6,3,1,0,4,6,0
Argentina,1941,Copa América,10,2,4,0,0,4,8,1
Argentina,1941,Friendly,12,5,3,0,2,5,7,0
Argentina,1942,Copa América,21,6,4,1,1,6,15,0
Argentina,1942,Copa Lipton,1,1,0,0,1,1,0,0
Argentina,1942,Copa Newton,4,1,1,0,0,1,3,1
Argentina,1943,Copa Chevallier Boutell,6,4,1,1,0,2,2,0
Argentina,1943,Friendly,4,3,1,0,1,2,1,0
Argentina,1945,Copa América,22,5,5,0,1,6,17,0
Argentina,1945,Copa Chevallier Boutell,14,11,3,1,0,4,3,1
Argentina,1945,Copa Lipton,2,2,0,0,1,1,0,0
Argentina,1945,Copa Newton,6,2,1,0,0,1,4,1
Argentina,1945,Copa Roca,7,12,1,2,0,3,-5,0
Argentina,1946,Copa América,17,3,5,0,0,5,14,1
Argentina,1947,Copa América,28,4,6,0,1,7,24,0
Argentina,1950,Copa Chevallier Boutell,6,2,1,0,1,2,4,1
Argentina,1951,Friendly,2,2,1,1,0,2,0,0
Argentina,1952,Friendly,4,1,2,0,0,2,3,0
Argentina,1953,Friendly,4,1,2,0,1,3,3,0
Argentina,1954,Friendly,3,3,1,1,0,2,0,0
Argentina,1955,Copa América,18,6,4,0,1,5,12,0
Argentina,1956,Atlantic Cup,2,1,1,0,1,2,1,0
Argentina,1956,Copa América,5,3,3,2,0,5,2,0
Argentina,1956,Copa Chevallier Boutell,1,0,1,0,0,1,1,1
Argentina,1956,Friendly,6,3,3,0,1,4,3,0
Argentina,1956,Pan American Championship,9,5,2,0,3,5,4,0
Argentina,1957,Copa América,25,6,5,1,0,6,19,0
Argentina,1957,Copa Lipton,1,1,0,0,1,1,0,0
Argentina,1957,Copa Newton,0,0,0,0,1,1,0,0
Argentina,1957,Copa Roca,2,3,1,1,0,2,-1,0
Argentina,1957,FIFA World Cup qualification,10,2,3,1,0,4,8,0
Argentina,1957,Friendly,4,1,1,0,0,1,3,0
Argentina,1958,FIFA World Cup,5,10,1,2,0,3,-5,0
Argentina,1958,Friendly,4,2,2,2,0,4,2,0
Argentina,1959,Copa América,28,14,7,1,2,10,14,0
Argentina,1959,Friendly,2,4,0,1,0,1,-2,0
Argentina,1960,Atlantic Cup,6,5,2,1,0,3,1,1
Argentina,1960,Copa Roca,5,6,1,1,0,2,-1,0
Argentina,1960,FIFA World Cup qualification,11,3,2,0,0,2,8,1
Argentina,1960,Friendly,2,0,1,0,0,1,2,0
Argentina,1960,Pan American Championship,9,4,4,1,1,6,5,0
Argentina,1961,Friendly,12,12,2,3,3,8,0,0
Argentina,1962,Copa Carlos Dittborn,2,1,1,0,1,2,1,1
Argentina,1962,Copa Lipton,3,1,1,0,0,1,2,1
Argentina,1962,FIFA World Cup,2,3,1,1,1,3,-1,0
Argentina,1962,Friendly,2,1,1,0,1,2,1,0
Argentina,1963,Copa América,15,10,3,2,1,6,5,0
Argentina,1963,Copa Chevallier Boutell,6,3,1,1,0,2,3,0
Argentina,1963,Copa Roca,5,7,1,1,0,2,-2,0
Argentina,1964,Copa Carlos Dittborn,6,1,1,0,1,2,5,0
Argentina,1964,Copa Chevallier Boutell,8,4,1,1,0,2,4,1
Argentina,1964,Friendly,6,0,3,0,0,3,6,0
Argentina,1965,Copa Carlos Dittborn,2,1,1,0,1,2,1,0
Argentina,1965,FIFA World Cup qualification,9,2,3,0,1,4,7,0
Argentina,1965,Friendly,1,1,0,0,3,3,0,0
Argentina,1966,FIFA World Cup,4,2,2,1,1,4,2,0
Argentina,1966,Friendly,1,4,0,1,1,2,-3,0
Argentina,1967,Copa América,12,3,4,1,0,5,9,0
Argentina,1967,Friendly,3,7,0,3,1,4,-4,0
Argentina,1968,Copa Carlos Dittborn,5,2,1,1,0,2,3,0
Argentina,1968,Copa Lipton,2,0,1,0,0,1,2,1
Argentina,1968,Copa Newton,1,2,0,1,0,1,-1,0
Argentina,1968,Friendly,8,13,1,3,3,7,-5,0
Argentina,1969,FIFA World Cup qualification,4,6,1,2,1,4,-2,0
Argentina,1969,Friendly,4,3,1,0,3,4,1,0
Argentina,1970,Friendly,7,6,2,2,1,5,1,0
Argentina,1971,Copa Carlos Dittborn,3,2,1,0,1,2,1,1
Argentina,1971,Copa Chevallier Boutell,2,1,1,0,1,2,1,1
Argentina,1971,Copa Roca,3,3,0,0,2,2,0,0
Argentina,1971,Friendly,7,5,2,1,1,4,2,0
Argentina,1972,Brazil Independence Cup,9,8,3,2,1,6,1,0
Argentina,1972,Copa Carlos Dittborn,4,3,1,0,0,1,1,1
Argentina,1972,Copa Ramón Castilla,2,0,1,0,0,1,2,1
Argentina,1972,Friendly,0,1,0,1,1,2,-1,0
Argentina,1973,Copa Carlos Dittborn,6,7,1,1,0,2,-1,0
Argentina,1973,Copa Lipton,1,1,0,0,1,1,0,0
Argentina,1973,Copa Newton,1,1,0,0,1,1,0,0
Argentina,1973,Copa Ramón Castilla,3,1,1,0,0,1,2,1
Argentina,1973,FIFA World Cup qualification,9,2,3,0,1,4,7,0
Argentina,1973,Friendly,4,5,1,1,1,3,-1,0
Argentina,1974,Copa Carlos Dittborn,3,1,1,0,1,2,2,0
Argentina,1974,FIFA World Cup,9,12,1,3,2,6,-3,0
Argentina,1974,Friendly,7,8,2,1,2,5,-1,0
Argentina,1975,Copa América,17,4,2,2,0,4,13,0
Argentina,1975,Copa Newton,3,2,1,0,0,1,1,1
Argentina,1975,Friendly,9,2,2,0,1,3,7,0
Argentina,1976,Copa Carlos Dittborn,2,0,1,0,0,1,2,1
Argentina,1976,Copa Félix Bogado,5,4,1,0,1,2,1,0
Argentina,1976,Copa Lipton,4,1,1,0,0,1,3,1
Argentina,1976,Copa Newton,3,0,1,0,0,1,3,1
Argentina,1976,Copa Ramón Castilla,4,1,2,0,0,2,3,1
Argentina,1976,Copa Roca,1,4,0,2,0,2,-3,0
Argentina,1976,Friendly,3,3,2,1,1,4,0,0
Argentina,1977,Copa Félix Bogado,2,3,1,1,0,2,-1,0
Argentina,1977,Friendly,14,7,4,1,3,8,7,0
Argentina,1977,Real Madrid 75th Anniversary Cup,1,1,0,0,1,1,0,0
Argentina,1978,Copa Ramón Castilla,5,2,2,0,0,2,3,1
Argentina,1978,FIFA World Cup,15,4,5,1,1,7,11,1
Argentina,1978,Friendly,8,3,3,1,0,4,5,0
Argentina,1979,Copa América,7,6,1,2,1,4,1,0
Argentina,1979,FIFA 75th Anniversary Cup,0,0,0,0,1,1,0,0
Argentina,1979,Friendly,10,10,2,2,2,6,0,0
Argentina,1980,Friendly,20,8,6,1,2,9,12,0
Argentina,1981,Friendly,2,3,0,1,1,2,-1,0
Argentina,1981,Mundialito,3,2,1,0,1,2,1,0
Argentina,1982,FIFA World Cup,8,7,2,3,0,5,1,0
Argentina,1982,Friendly,5,3,2,0,3,5,2,0
Argentina,1983,Copa América,5,4,1,0,3,4,1,0
Argentina,1983,Copa Félix Bogado,0,1,0,1,1,2,-1,0
Argentina,1983,Friendly,3,2,1,0,1,2,1,0
Argentina,1984,Friendly,9,5,3,2,4,9,4,0
Argentina,1984,Nehru Cup,2,2,1,1,1,3,0,0
Argentina,1985,FIFA World Cup qualification,12,6,4,1,1,6,6,0
Argentina,1985,Friendly,6,6,1,2,3,6,0,0
Argentina,1986,FIFA World Cup,14,5,6,0,1,7,9,1
Argentina,1986,Friendly,0,3,0,2,0,2,-3,0
Argentina,1987,Copa América,5,4,1,2,1,4,1,0
Argentina,1987,Friendly,2,4,1,2,0,3,-2,0
Argentina,1988,Four Nations Tournament,2,5,0,2,0,2,-3,0
Argentina,1988,Friendly,6,7,1,1,3,5,-1,0
Argentina,1989,Copa América,2,4,2,2,3,7,-2,0
Argentina,1989,Friendly,3,4,0,1,3,4,-1,0
Argentina,1990,FIFA World Cup,5,4,2,2,3,7,1,0
Argentina,1990,Friendly,4,6,1,2,2,5,-2,0
Argentina,1991,Copa América,16,6,6,0,1,7,10,0
Argentina,1991,Friendly,10,7,2,0,5,7,3,0
Argentina,1992,Confederations Cup,7,1,2,0,0,2,6,1
Argentina,1992,Copa Lipton,0,0,0,0,1,1,0,0
Argentina,1992,Friendly,4,0,2,0,0,2,4,0
Argentina,1992,Kirin Cup,2,0,2,0,0,2,2,0
Argentina,1993,CONMEBOL–UEFA Cup of Champions,1,1,0,0,1,1,0,0
Argentina,1993,Copa América,6,4,2,0,4,6,2,1
Argentina,1993,FIFA World Cup qualification,9,10,4,2,2,8,-1,1
Argentina,1993,Friendly,3,2,1,0,1,2,1,0
Argentina,1994,FIFA World Cup,8,6,2,2,0,4,2,0
Argentina,1994,Friendly,13,7,4,2,2,8,6,0
Argentina,1995,Confederations Cup,5,3,1,1,1,3,2,0
Argentina,1995,Copa América,8,6,2,1,1,4,2,0
Argentina,1995,Friendly,17,6,5,2,2,9,11,0
Argentina,1996,FIFA World Cup qualification,10,7,2,1,3,6,3,0
Argentina,1996,Friendly,2,3,0,1,0,1,-1,0
Argentina,1997,Copa América,4,3,1,1,2,4,1,0
Argentina,1997,FIFA World Cup qualification,13,6,6,1,3,10,7,0
Argentina,1998,FIFA World Cup,10,4,3,1,1,5,6,0
Argentina,1998,Friendly,17,3,7,1,0,8,14,0
Argentina,1999,Copa América,6,6,2,2,0,4,0,0
Argentina,1999,Friendly,14,9,5,2,3,10,5,0
Argentina,2000,FIFA World Cup qualification,22,8,8,1,1,10,14,0
Argentina,2000,Friendly,2,0,1,0,1,2,2,0
Argentina,2001,FIFA World Cup qualification,20,7,5,0,3,8,13,0
Argentina,2001,Friendly,2,1,1,0,0,1,1,0
Argentina,2002,FIFA World Cup,2,2,1,1,1,3,0,0
Argentina,2002,Friendly,6,3,2,0,2,4,3,0
Argentina,2003,FIFA World Cup qualification,9,3,2,0,2,4,6,0
Argentina,2003,Friendly,14,7,6,1,1,8,7,0
Argentina,2003,Kirin Cup,4,1,1,0,0,1,3,0
Argentina,2004,Copa América,16,6,4,1,1,6,10,0
Argentina,2004,FIFA World Cup qualification,12,8,4,1,2,7,4,0
Argentina,2004,Friendly,8,4,4,1,0,5,4,0
Argentina,2005,Confederations Cup,10,10,2,1,2,5,0,0
Argentina,2005,FIFA World Cup qualification,8,6,4,3,0,7,2,0
Argentina,2005,Friendly,10,7,2,1,2,5,3,0
Argentina,2006,FIFA World Cup,11,3,3,0,2,5,8,0
Argentina,2006,Friendly,5,8,1,3,0,4,-3,0
Argentina,2007,Copa América,16,6,5,1,0,6,10,0
Argentina,2007,FIFA World Cup qualification,8,2,3,1,0,4,6,0
Argentina,2007,Friendly,8,6,3,1,2,6,2,0
Argentina,2008,FIFA World Cup qualification,5,5,1,1,4,6,0,0
Argentina,2008,Friendly,8,1,4,0,2,6,7,0
Argentina,2009,FIFA World Cup qualification,10,13,4,4,0,8,-3,0
Argentina,2009,Friendly,13,9,4,2,0,6,4,0
Argentina,2010,FIFA World Cup,10,6,4,1,0,5,4,0
Argentina,2010,Friendly,21,5,8,1,0,9,16,0
Argentina,2011,Copa América,5,2,1,0,3,4,3,0
Argentina,2011,FIFA World Cup qualification,7,4,2,1,1,4,3,0
Argentina,2011,Friendly,23,14,6,2,3,11,9,0
Argentina,2011,Superclásico de las Américas,0,2,0,1,1,2,-2,0
Argentina,2012,FIFA World Cup qualification,13,3,4,0,1,5,10,0
Argentina,2012,Friendly,10,5,3,0,1,4,5,0
Argentina,2012,Superclásico de las Américas,3,3,1,1,0,2,0,1
Argentina,2013,FIFA World Cup qualification,15,8,3,1,3,7,7,0
Argentina,2013,Friendly,11,3,4,0,1,5,8,0
Argentina,2014,FIFA World Cup,8,4,5,1,1,7,4,0
Argentina,2014,Friendly,18,4,5,1,1,7,14,0
Argentina,2014,Superclásico de las Américas,0,2,0,1,0,1,-2,0
Argentina,2015,Copa América,10,3,3,0,3,6,7,0
Argentina,2015,FIFA World Cup qualification,2,3,1,1,2,4,-1,0
Argentina,2015,Friendly,18,3,4,0,1,5,15,0
Argentina,2016,Copa América,18,2,5,0,1,6,16,0
Argentina,2016,FIFA World Cup qualification,12,9,4,2,2,8,3,0
Argentina,2017,FIFA World Cup qualification,5,4,2,1,3,6,1,0
Argentina,2017,Friendly,9,4,2,1,0,3,5,0
Argentina,2017,Superclásico de las Américas,1,0,1,0,0,1,1,1
Argentina,2018,FIFA World Cup,6,9,1,2,1,4,-3,0
Argentina,2018,Friendly,18,6,6,1,1,8,12,0
Argentina,2018,Superclásico de las Américas,0,1,0,1,0,1,-1,0
Argentina,2019,Copa América,7,6,3,2,1,6,1,0
Argentina,2019,Friendly,21,9,4,1,3,8,12,0
Argentina,2019,Superclásico de las Américas,1,0,1,0,0,1,1,1
Argentina,2020,FIFA World Cup qualification,6,2,3,0,1,4,4,0
Argentina,2021,Copa América,12,3,5,0,2,7,9,1
Argentina,2021,FIFA World Cup qualification,14,4,5,0,4,9,10,0
Argentina,2022,CONMEBOL–UEFA Cup of Champions,3,0,1,0,0,1,3,1
Argentina,2022,FIFA World Cup,15,8,4,1,2,7,7,0
Argentina,2022,FIFA World Cup qualification,7,2,3,0,1,4,5,0
Argentina,2022,Friendly,16,0,4,0,0,4,16,0
Argentina,2023,FIFA World Cup qualification,8,2,5,1,0,6,6,0
Argentina,2023,Friendly,13,0,4,0,0,4,13,0
Argentina,2024,Copa América,9,1,5,0,1,6,8,1
Argentina,2024,FIFA World Cup qualification,13,5,3,2,1,6,8,0
Argentina,2024,Friendly,11,2,4,0,0,4,9,0
Argentina,2025,FIFA World Cup qualification,5,1,2,0,0,2,4,0
Armenia,1979,Friendly,0,3,0,1,0,1,-3,0
Armenia,1992,Friendly,0,0,0,0,1,1,0,0
Armenia,1994,Friendly,1,1,1,1,0,2,0,0
Armenia,1994,UEFA Euro qualification,0,4,0,2,1,3,-4,0
Armenia,1995,UEFA Euro qualification,5,13,1,5,1,7,-8,0
Armenia,1996,FIFA World Cup qualification,3,7,0,1,3,4,-4,0
Armenia,1996,Friendly,2,16,1,4,0,5,-14,0
Armenia,1997,FIFA World Cup qualification,5,10,1,3,2,6,-5,0
Armenia,1997,Friendly,0,16,0,3,0,3,-16,0
Armenia,1998,Friendly,3,1,2,0,0,2,2,0
Armenia,1998,UEFA Euro qualification,3,3,1,1,1,3,0,0
Armenia,1999,Friendly,0,3,0,2,0,2,-3,0
Armenia,1999,UEFA Euro qualification,5,12,1,5,1,7,-7,0
Armenia,2000,Cyprus International Tournament,5,6,1,2,0,3,-1,0
Armenia,2000,FIFA World Cup qualification,3,5,0,2,1,3,-2,0
Armenia,2000,Friendly,1,1,0,0,2,2,0,0
Armenia,2001,FIFA World Cup qualification,4,14,0,3,4,7,-10,0
Armenia,2001,Friendly,2,0,1,0,0,1,2,0
Armenia,2002,Friendly,2,0,1,0,0,1,2,0
Armenia,2002,UEFA Euro qualification,2,4,0,1,1,2,-2,0
Armenia,2003,Friendly,0,2,0,1,0,1,-2,0
Armenia,2003,UEFA Euro qualification,5,12,2,4,0,6,-7,0
Armenia,2004,Cyprus International Tournament,5,5,1,1,1,3,0,0
Armenia,2004,FIFA World Cup qualification,2,12,0,4,1,5,-10,0
Armenia,2004,Friendly,1,0,1,0,0,1,1,0
Armenia,2005,FIFA World Cup qualification,7,13,2,5,0,7,-6,0
Armenia,2005,Friendly,1,3,0,1,1,2,-2,0
Armenia,2006,Cyprus International Tournament,0,4,0,2,0,2,-4,0
Armenia,2006,UEFA Euro qualification,0,5,0,3,1,4,-5,0
Armenia,2007,Friendly,3,4,1,1,2,4,-1,0
Armenia,2007,UEFA Euro qualification,4,8,2,4,2,8,-4,0
Armenia,2008,FIFA World Cup qualification,1,12,0,4,0,4,-11,0
Armenia,2008,Friendly,3,2,1,0,2,3,1,0
Armenia,2008,Malta International Tournament,3,3,2,1,0,3,0,0
Armenia,2009,FIFA World Cup qualification,5,10,1,4,1,6,-5,0
Armenia,2009,Friendly,1,4,0,1,1,2,-3,0
Armenia,2010,Friendly,5,7,1,2,0,3,-2,0
Armenia,2010,UEFA Euro qualification,9,4,2,1,1,4,5,0
Armenia,2011,Friendly,1,5,0,2,0,2,-4,0
Armenia,2011,UEFA Euro qualification,13,6,3,2,1,6,7,0
Armenia,2012,FIFA World Cup qualification,2,4,1,2,0,3,-2,0
Armenia,2012,Friendly,11,8,3,3,0,6,3,0
Armenia,2013,FIFA World Cup qualification,10,9,3,3,1,7,1,0
Armenia,2013,Friendly,1,3,0,1,1,2,-2,0
Armenia,2014,Friendly,6,19,1,5,0,6,-13,0
Armenia,2014,UEFA Euro qualification,2,4,0,2,1,3,-2,0
Armenia,2015,Friendly,0,4,0,1,0,1,-4,0
Armenia,2015,UEFA Euro qualification,3,10,0,4,1,5,-7,0
Armenia,2016,FIFA World Cup qualification,4,10,1,3,0,4,-6,0
Armenia,2016,Friendly,11,4,2,1,1,4,7,0
Armenia,2017,FIFA World Cup qualification,6,16,1,4,1,6,-10,0
Armenia,2017,Friendly,12,3,3,0,0,3,9,0
Armenia,2018,Friendly,1,2,0,1,3,4,-1,0
Armenia,2018,UEFA Nations League,14,8,3,2,1,6,6,0
Armenia,2019,UEFA Euro qualification,14,25,3,6,1,10,-11,0
Armenia,2020,UEFA Nations League,9,6,3,1,2,6,3,0
Armenia,2021,FIFA World Cup qualification,9,20,3,4,3,10,-11,0
Armenia,2021,Friendly,2,4,0,1,1,2,-2,0
Armenia,2022,Friendly,3,13,1,2,1,4,-10,0
Armenia,2022,UEFA Nations League,4,17,1,5,0,6,-13,0
Armenia,2023,Friendly,3,5,0,1,1,2,-2,0
Armenia,2023,UEFA Euro qualification,9,11,2,4,2,8,-2,0
Armenia,2024,Friendly,4,6,1,3,0,4,-2,0
Armenia,2024,UEFA Nations League,8,9,2,3,1,6,-1,0
Armenia,2025,UEFA Nations League,1,9,0,2,0,2,-8,0
Artsakh,2012,Friendly,4,1,1,0,1,2,3,0
Artsakh,2014,CONIFA World Football Cup,19,5,2,2,0,4,14,0
Artsakh,2019,CONIFA European Football Cup,9,8,3,1,1,5,1,0
Aruba,1924,Friendly,0,4,0,1,0,1,-4,0
Aruba,1930,Friendly,1,2,0,1,0,1,-1,0
Aruba,1931,Friendly,0,1,0,1,0,1,-1,0
Aruba,1933,Friendly,1,5,0,2,0,2,-4,0
Aruba,1934,Friendly,1,1,0,0,1,1,0,0
Aruba,1935,Friendly,0,7,0,3,0,3,-7,0
Aruba,1937,Friendly,2,2,0,0,2,2,0,0
Aruba,1938,Friendly,5,0,1,0,0,1,5,0
Aruba,1941,Friendly,3,8,0,2,2,4,-5,0
Aruba,1942,Friendly,2,2,0,0,1,1,0,0
Aruba,1943,Friendly,7,8,0,1,3,4,-1,0
Aruba,1944,Friendly,15,25,3,5,1,9,-10,0
Aruba,1945,Friendly,4,2,2,0,0,2,2,0
Aruba,1946,Friendly,12,8,2,2,0,4,4,0
Aruba,1947,Friendly,1,4,0,1,1,2,-3,0
Aruba,1949,Friendly,0,3,0,1,0,1,-3,0
Aruba,1952,Friendly,3,7,1,2,0,3,-4,0
Aruba,1953,Friendly,6,6,0,0,2,2,0,0
Aruba,1954,Friendly,2,2,0,0,1,1,0,0
Aruba,1955,CCCF Championship,8,9,1,3,1,5,-1,0
Aruba,1957,Friendly,2,2,0,0,1,1,0,0
Aruba,1989,CFU Caribbean Cup qualification,1,19,0,3,1,4,-18,0
Aruba,1989,Friendly,0,8,0,2,0,2,-8,0
Aruba,1990,Friendly,1,3,0,1,0,1,-2,0
Aruba,1991,CFU Caribbean Cup qualification,1,5,0,2,0,2,-4,0
Aruba,1992,CFU Caribbean Cup qualification,0,2,0,1,0,1,-2,0
Aruba,1995,CFU Caribbean Cup qualification,5,7,0,2,0,2,-2,0
Aruba,1996,FIFA World Cup qualification,3,6,0,2,0,2,-3,0
Aruba,1997,CFU Caribbean Cup qualification,2,7,1,1,0,2,-5,0
Aruba,1998,CFU Caribbean Cup qualification,4,4,1,1,1,3,0,0
Aruba,2000,FIFA World Cup qualification,7,11,1,2,1,4,-4,0
Aruba,2001,CFU Caribbean Cup qualification,4,14,0,3,0,3,-10,0
Aruba,2002,Gold Cup qualification,0,8,0,2,0,2,-8,0
Aruba,2004,FIFA World Cup qualification,2,10,0,2,0,2,-8,0
Aruba,2004,Friendly,1,6,0,1,0,1,-5,0
Aruba,2008,CFU Caribbean Cup qualification,1,3,0,1,1,2,-2,0
Aruba,2008,FIFA World Cup qualification,0,4,0,2,0,2,-4,0
Aruba,2010,ABCS Tournament,3,6,0,1,1,2,-3,0
Aruba,2010,Friendly,0,3,0,1,0,1,-3,0
Aruba,2011,ABCS Tournament,2,2,0,0,2,2,0,0
Aruba,2011,FIFA World Cup qualification,6,6,1,1,0,2,0,0
Aruba,2012,ABCS Tournament,4,2,2,0,0,2,2,0
Aruba,2012,CFU Caribbean Cup qualification,5,7,0,2,1,3,-2,0
Aruba,2013,ABCS Tournament,1,4,0,2,0,2,-3,0
Aruba,2014,CFU Caribbean Cup qualification,8,2,2,1,0,3,6,0
Aruba,2014,Friendly,4,2,1,0,1,2,2,0
Aruba,2015,ABCS Tournament,0,1,0,1,1,2,-1,0
Aruba,2015,FIFA World Cup qualification,5,5,2,2,0,4,0,0
Aruba,2016,CFU Caribbean Cup qualification,1,4,0,2,0,2,-3,0
Aruba,2018,CONCACAF Nations League qualification,3,3,1,1,1,3,0,0
Aruba,2019,CONCACAF Nations League,5,18,0,6,0,6,-13,0
Aruba,2019,CONCACAF Nations League qualification,2,3,0,1,0,1,-1,0
Aruba,2021,FIFA World Cup qualification,3,19,1,3,0,4,-16,0
Aruba,2022,CONCACAF Nations League,5,3,1,1,1,3,2,0
Aruba,2023,CONCACAF Nations League,14,6,4,1,0,5,8,0
Aruba,2024,CONCACAF Nations League,5,17,0,6,0,6,-12,0
Aruba,2024,FIFA World Cup qualification,2,4,0,1,1,2,-2,0
Aruba,2024,Friendly,0,2,0,1,0,1,-2,0
Aruba,2025,Friendly,2,1,1,0,0,1,1,0
Asturias,1923,Friendly,3,1,1,0,0,1,2,0
Australia,1922,Friendly,3,7,0,2,1,3,-4,0
Australia,1923,Friendly,5,8,1,2,0,3,-3,0
Australia,1924,Friendly,9,8,3,2,1,6,1,0
Australia,1933,Friendly,14,8,3,0,0,3,6,0
Australia,1936,Friendly,21,2,3,0,0,3,19,0
Australia,1938,Friendly,18,16,3,1,1,5,2,0
Australia,1947,Friendly,12,12,1,3,1,5,0,0
Australia,1948,Friendly,25,1,4,0,0,4,24,0
Australia,1950,Friendly,16,7,4,2,0,6,9,0
Australia,1954,Friendly,9,4,2,1,0,3,5,0
Australia,1955,Friendly,1,23,0,5,0,5,-22,0
Australia,1956,Friendly,1,7,0,1,0,1,-6,0
Australia,1958,Friendly,5,4,1,0,1,2,1,0
Australia,1965,FIFA World Cup qualification,2,9,0,2,0,2,-7,0
Australia,1965,Friendly,7,2,3,1,1,5,5,0
Australia,1967,Vietnam Independence Cup,15,6,5,0,0,5,9,0
Australia,1968,Friendly,6,6,1,1,1,3,0,0
Australia,1969,FIFA World Cup qualification,12,8,3,1,5,9,4,0
Australia,1969,Friendly,2,2,0,0,1,1,0,0
Australia,1970,Friendly,15,2,4,0,0,4,13,0
Australia,1971,Friendly,4,5,1,1,1,3,-1,0
Australia,1972,Friendly,17,3,5,0,1,6,14,0
Australia,1973,FIFA World Cup qualification,21,10,5,1,5,11,11,0
Australia,1973,Friendly,3,7,0,2,1,3,-4,0
Australia,1974,FIFA World Cup,0,5,0,2,1,3,-5,0
Australia,1974,Friendly,3,3,1,1,0,2,0,0
Australia,1975,Friendly,1,0,1,0,0,1,1,0
Australia,1976,Friendly,11,4,5,1,2,8,7,0
Australia,1977,FIFA World Cup qualification,20,11,6,4,2,12,9,0
Australia,1977,Friendly,4,3,1,1,2,4,1,0
Australia,1978,Friendly,1,3,0,2,0,2,-2,0
Australia,1979,Friendly,0,1,0,1,0,1,-1,0
Australia,1980,Friendly,13,24,1,5,6,12,-11,0
Australia,1980,Oceania Nations Cup,24,4,4,0,0,4,20,0
Australia,1981,FIFA World Cup qualification,22,9,4,2,1,7,13,0
Australia,1982,Merlion Cup,7,0,2,0,0,2,7,0
Australia,1983,Friendly,2,6,0,3,2,5,-4,0
Australia,1983,Merlion Cup,5,4,1,1,0,2,1,1
Australia,1984,Friendly,2,3,0,1,0,1,-1,0
Australia,1985,FIFA World Cup qualification,20,4,4,1,3,8,16,0
Australia,1985,Friendly,3,0,1,0,0,1,3,0
Australia,1986,Friendly,6,7,2,2,2,6,-1,0
Australia,1987,Friendly,1,2,0,1,1,2,-1,0
Australia,1987,Korea Cup,2,1,1,0,2,3,1,0
Australia,1988,FIFA World Cup qualification,5,2,1,1,0,2,3,0
Australia,1988,Friendly,11,5,4,2,0,6,6,0
Australia,1989,FIFA World Cup qualification,6,5,1,1,2,4,1,0
Australia,1990,Friendly,3,2,1,2,0,3,1,0
Australia,1991,Friendly,3,5,2,3,0,5,-2,0
Australia,1991,Korea Cup,0,0,0,0,1,1,0,0
Australia,1992,FIFA World Cup qualification,13,2,4,0,0,4,11,0
Australia,1992,Friendly,10,6,6,3,2,11,4,0
Australia,1993,FIFA World Cup qualification,8,5,3,2,1,6,3,0
Australia,1993,Friendly,3,5,1,2,1,4,-2,0
Australia,1994,Friendly,2,0,2,0,2,4,2,0
Australia,1994,Kirin Cup,1,2,0,1,1,2,-1,0
Australia,1995,Friendly,5,6,3,3,0,6,-1,0
Australia,1995,Oceania Nations Cup,3,0,1,0,1,2,3,0
Australia,1996,Friendly,4,7,1,3,2,6,-3,0
Australia,1996,Oceania Nations Cup,11,0,2,0,0,2,11,1
Australia,1996,Simba Tournament,6,2,2,1,0,3,4,0
Australia,1997,Confederations Cup,4,8,2,2,1,5,-4,0
Australia,1997,FIFA World Cup qualification,34,5,6,0,2,8,29,0
Australia,1997,Friendly,8,2,5,0,0,5,6,0
Australia,1998,Friendly,1,11,1,3,1,5,-10,0
Australia,1998,Oceania Nations Cup,23,3,3,1,0,4,20,0
Australia,2000,Friendly,10,7,3,2,4,9,3,0
Australia,2000,Oceania Nations Cup,26,0,4,0,0,4,26,0
Australia,2000,United Arab Emirates Friendship Tournament,3,4,1,1,0,2,-1,0
Australia,2001,Confederations Cup,4,2,3,2,0,5,2,0
Australia,2001,FIFA World Cup qualification,73,4,7,1,0,8,69,0
Australia,2001,Friendly,3,7,0,2,1,3,-4,0
Australia,2002,Oceania Nations Cup,23,2,4,1,0,5,21,0
Australia,2003,Friendly,6,4,2,1,0,3,2,0
Australia,2004,Friendly,5,7,1,2,2,5,-2,0
Australia,2004,Oceania Nations Cup,32,4,6,0,1,7,28,1
Australia,2005,Confederations Cup,5,10,0,3,0,3,-5,0
Australia,2005,FIFA World Cup qualification,10,2,3,1,0,4,8,1
Australia,2005,Friendly,12,2,4,0,1,5,10,0
Australia,2006,AFC Asian Cup qualification,7,3,3,1,0,4,4,0
Australia,2006,FIFA World Cup,5,6,1,2,1,4,-1,0
Australia,2006,Friendly,7,4,2,0,3,5,3,0
Australia,2007,AFC Asian Cup,7,5,1,1,2,4,2,0
Australia,2007,Friendly,8,6,3,3,0,6,2,0
Australia,2008,FIFA World Cup qualification,13,3,6,2,1,9,10,0
Australia,2008,Friendly,5,3,2,0,2,4,2,0
Australia,2009,AFC Asian Cup qualification,3,2,2,1,1,4,1,0
Australia,2009,FIFA World Cup qualification,6,1,3,0,2,5,5,0
Australia,2009,Friendly,4,3,1,1,1,3,1,0
Australia,2010,AFC Asian Cup qualification,3,2,1,0,1,2,1,0
Australia,2010,FIFA World Cup,3,6,1,1,1,3,-3,0
Australia,2010,Friendly,7,10,4,3,1,8,-3,0
Australia,2011,AFC Asian Cup,13,2,4,1,1,6,11,0
Australia,2011,FIFA World Cup qualification,9,3,4,1,0,5,6,0
Australia,2011,Friendly,12,2,4,0,2,6,10,0
Australia,2012,EAFF Championship,19,1,3,0,1,4,18,1
Australia,2012,FIFA World Cup qualification,8,6,2,1,2,5,2,0
Australia,2012,Friendly,6,6,2,2,0,4,0,0
Australia,2013,EAFF Championship,5,7,0,2,1,3,-2,0
Australia,2013,FIFA World Cup qualification,8,3,2,0,2,4,5,0
Australia,2013,Friendly,6,15,2,3,0,5,-9,0
Australia,2014,FIFA World Cup,3,9,0,3,0,3,-6,0
Australia,2014,Friendly,8,13,1,5,2,8,-5,0
Australia,2015,AFC Asian Cup,14,3,5,1,0,6,11,1
Australia,2015,FIFA World Cup qualification,17,3,5,1,0,6,14,0
Australia,2015,Friendly,2,2,0,0,2,2,0,0
Australia,2016,FIFA World Cup qualification,20,6,4,0,3,7,14,0
Australia,2016,Friendly,3,4,1,2,0,3,-1,0
Australia,2017,Confederations Cup,4,5,0,1,2,3,-1,0
Australia,2017,FIFA World Cup qualification,14,9,5,1,3,9,5,1
Australia,2017,Friendly,0,4,0,1,0,1,-4,0
Australia,2018,FIFA World Cup,2,5,0,2,1,3,-3,0
Australia,2018,Friendly,20,6,5,1,2,8,14,0
Australia,2019,AFC Asian Cup,6,4,2,2,1,5,2,0
Australia,2019,FIFA World Cup qualification,16,1,4,0,0,4,15,0
Australia,2019,Friendly,0,1,0,1,0,1,-1,0
Australia,2021,FIFA World Cup qualification,21,5,7,1,2,10,16,0
Australia,2022,FIFA World Cup,4,6,2,2,0,4,-2,0
Australia,2022,FIFA World Cup qualification,8,6,2,2,2,6,2,0
Australia,2022,Friendly,5,1,3,0,0,3,4,0
Australia,2023,FIFA World Cup qualification,8,0,2,0,0,2,8,0
Australia,2023,Friendly,8,8,2,3,1,6,0,0
Australia,2024,AFC Asian Cup,9,3,3,1,1,5,6,0
Australia,2024,FIFA World Cup qualification,20,5,5,1,4,10,15,0
Australia,2024,Friendly,2,0,1,0,0,1,2,0
Australia,2025,FIFA World Cup qualification,7,1,2,0,0,2,6,0
Austria,1902,Friendly,5,0,1,0,0,1,5,1
Austria,1903,Friendly,6,5,1,1,0,2,1,1
Austria,1904,Friendly,5,7,1,1,0,2,-2,1
Austria,1905,Friendly,0,0,0,0,1,1,0,0
Austria,1906,Friendly,1,3,0,1,0,1,-2,0
Austria,1907,Friendly,4,5,1,1,0,2,-1,0
Austria,1908,Friendly,12,24,2,3,0,5,-12,0
Austria,1909,Friendly,7,15,0,2,2,4,-8,0
Austria,1910,Friendly,2,4,1,1,0,2,-2,0
Austria,1911,Friendly,5,4,2,1,0,3,1,0
Austria,1912,Friendly,4,6,1,1,1,3,-2,1
Austria,1912,Olympic Games,12,8,3,2,0,5,4,0
Austria,1913,Friendly,6,8,1,2,0,3,-2,0
Austria,1914,Friendly,5,4,1,1,2,4,1,0
Austria,1915,Friendly,12,12,2,2,0,4,0,0
Austria,1916,Friendly,10,8,2,1,1,4,2,0
Austria,1917,Friendly,9,18,1,5,1,7,-9,0
Austria,1918,Friendly,5,8,1,3,0,4,-3,0
Austria,1919,Friendly,5,5,1,2,0,3,0,0
Austria,1920,Friendly,7,5,2,0,1,3,2,1
Austria,1921,Friendly,17,11,3,0,3,6,6,0
Austria,1922,Friendly,15,10,2,1,3,6,5,0
Austria,1923,Friendly,5,9,2,3,1,6,-4,0
Austria,1924,Friendly,30,13,6,2,2,10,17,0
Austria,1925,Friendly,21,14,6,3,1,10,7,0
Austria,1926,Friendly,23,7,6,1,0,7,16,0
Austria,1927,Central European International Cup,4,7,1,2,0,3,-3,1
Austria,1927,Friendly,15,4,3,1,0,4,11,0
Austria,1928,Central European International Cup,7,2,2,1,0,3,5,0
Austria,1928,Friendly,15,10,3,0,2,5,5,0
Austria,1929,Central European International Cup,6,1,2,0,0,2,5,1
Austria,1929,Friendly,8,8,1,1,2,4,0,0
Austria,1930,Friendly,9,8,1,2,2,5,1,0
Austria,1931,Central European International Cup,13,6,2,1,2,5,7,0
Austria,1931,Friendly,18,0,4,0,0,4,18,0
Austria,1932,Central European International Cup,6,3,2,0,1,3,3,0
Austria,1932,Friendly,24,12,4,1,0,5,12,1
Austria,1933,Friendly,18,11,3,1,4,8,7,0
Austria,1934,Central European International Cup,13,9,3,1,1,5,4,1
Austria,1934,FIFA World Cup,7,7,2,2,0,4,0,0
Austria,1934,FIFA World Cup qualification,6,1,1,0,0,1,5,0
Austria,1934,Friendly,5,2,1,0,0,1,3,0
Austria,1935,Central European International Cup,4,6,0,1,2,3,-2,0
Austria,1935,Friendly,8,9,1,2,0,3,-1,0
Austria,1936,Central European International Cup,7,7,1,1,1,3,0,1
Austria,1936,Friendly,15,14,3,1,1,5,1,0
Austria,1937,Central European International Cup,6,7,1,2,0,3,-1,0
Austria,1937,FIFA World Cup qualification,2,1,1,0,0,1,1,0
Austria,1937,Friendly,5,4,1,0,2,3,1,0
Austria,1939,Friendly,4,4,0,0,1,1,0,0
Austria,1945,Friendly,6,8,1,2,0,3,-2,0
Austria,1946,Friendly,9,15,1,5,0,6,-6,0
Austria,1947,Friendly,13,12,2,2,0,4,1,0
Austria,1948,Central European International Cup,4,5,1,1,0,2,-1,0
Austria,1948,Friendly,9,10,3,3,0,6,-1,0
Austria,1949,Central European International Cup,7,11,2,2,0,4,-4,1
Austria,1949,Friendly,9,6,2,1,0,3,3,0
Austria,1950,Central European International Cup,4,3,1,0,1,2,1,1
Austria,1950,Friendly,21,10,4,1,0,5,11,1
Austria,1951,Friendly,19,10,2,1,3,6,9,0
Austria,1952,Friendly,15,11,2,3,2,7,4,0
Austria,1953,FIFA World Cup qualification,9,1,1,0,1,2,8,0
Austria,1953,Friendly,3,8,0,2,2,4,-5,0
Austria,1954,FIFA World Cup,17,12,4,1,0,5,5,0
Austria,1954,Friendly,11,9,2,3,1,6,2,0
Austria,1955,Central European International Cup,10,14,2,2,1,5,-4,0
Austria,1955,Friendly,3,5,1,1,0,2,-2,0
Austria,1956,Central European International Cup,2,3,0,1,1,2,-1,0
Austria,1956,FIFA World Cup qualification,7,0,1,0,0,1,7,0
Austria,1956,Friendly,4,9,0,3,1,4,-5,0
Austria,1957,Central European International Cup,6,2,1,0,1,2,4,0
Austria,1957,FIFA World Cup qualification,7,3,2,0,1,3,4,0
Austria,1957,Friendly,9,8,2,1,1,4,1,0
Austria,1958,Central European International Cup,3,2,1,0,0,1,1,0
Austria,1958,FIFA World Cup,2,7,0,2,1,3,-5,0
Austria,1958,Friendly,9,9,1,2,1,4,0,0
Austria,1959,Friendly,9,8,2,1,0,3,1,0
Austria,1959,UEFA Euro qualification,8,7,2,1,0,3,1,0
Austria,1960,Friendly,14,10,5,2,0,7,4,0
Austria,1960,UEFA Euro qualification,2,4,0,1,0,1,-2,0
Austria,1961,Friendly,9,5,4,1,0,5,4,0
Austria,1962,Friendly,10,20,2,6,2,10,-10,0
Austria,1963,Friendly,5,9,1,4,0,5,-4,0
Austria,1963,UEFA Euro qualification,2,3,0,1,1,2,-1,0
Austria,1964,Friendly,6,5,3,1,1,5,1,0
Austria,1965,FIFA World Cup qualification,1,6,0,3,1,4,-5,0
Austria,1965,Friendly,6,7,2,1,1,4,-1,0
Austria,1966,Friendly,5,10,2,4,0,6,-5,0
Austria,1966,UEFA Euro qualification,0,0,0,0,1,1,0,0
Austria,1967,Friendly,1,4,0,2,0,2,-3,0
Austria,1967,UEFA Euro qualification,8,10,2,2,1,5,-2,0
Austria,1968,FIFA World Cup qualification,8,5,1,2,0,3,3,0
Austria,1968,Friendly,4,7,0,2,2,4,-3,0
Austria,1969,FIFA World Cup qualification,4,2,2,1,0,3,2,0
Austria,1969,Friendly,5,3,1,0,2,3,2,0
Austria,1970,Friendly,4,7,1,3,2,6,-3,0
Austria,1970,UEFA Euro qualification,1,2,0,1,0,1,-1,0
Austria,1971,Friendly,1,3,0,1,1,2,-2,0
Austria,1971,UEFA Euro qualification,13,4,3,1,1,5,9,0
Austria,1972,FIFA World Cup qualification,10,2,3,0,1,4,8,0
Austria,1972,Friendly,4,6,0,1,2,3,-2,0
Austria,1973,FIFA World Cup qualification,5,7,0,2,1,3,-2,0
Austria,1973,Friendly,2,12,1,2,1,4,-10,0
Austria,1974,Friendly,3,1,2,0,3,5,2,0
Austria,1974,UEFA Euro qualification,2,1,1,0,0,1,1,0
Austria,1975,Friendly,0,2,0,1,1,2,-2,0
Austria,1975,UEFA Euro qualification,9,6,2,2,1,5,3,0
Austria,1976,FIFA World Cup qualification,1,0,1,0,0,1,1,0
Austria,1976,Friendly,13,10,4,3,0,7,3,0
Austria,1977,FIFA World Cup qualification,13,2,3,0,2,5,11,0
Austria,1977,Friendly,4,1,2,0,1,3,3,0
Austria,1978,FIFA World Cup,7,10,3,3,0,6,-3,0
Austria,1978,Friendly,2,3,1,2,1,4,-1,0
Austria,1978,UEFA Euro qualification,6,4,2,1,0,3,2,0
Austria,1979,Friendly,8,4,3,0,0,3,4,0
Austria,1979,UEFA Euro qualification,8,3,2,0,3,5,5,0
Austria,1980,FIFA World Cup qualification,8,0,3,0,0,3,8,0
Austria,1980,Friendly,5,8,1,2,1,4,-3,0
Austria,1981,FIFA World Cup qualification,8,6,2,2,1,5,2,0
Austria,1981,Friendly,0,0,0,0,1,1,0,0
Austria,1982,FIFA World Cup,5,4,2,2,1,5,1,0
Austria,1982,Friendly,6,3,3,0,0,3,3,0
Austria,1982,UEFA Euro qualification,11,0,3,0,0,3,11,0
Austria,1983,Friendly,2,2,0,0,1,1,0,0
Austria,1983,UEFA Euro qualification,4,10,1,3,1,5,-6,0
Austria,1984,FIFA World Cup qualification,4,4,2,1,0,3,0,0
Austria,1984,Friendly,7,4,1,2,1,4,3,0
Austria,1985,FIFA World Cup qualification,5,4,1,1,1,3,1,0
Austria,1985,Friendly,0,5,0,2,1,3,-5,0
Austria,1986,Friendly,7,4,2,1,1,4,3,0
Austria,1986,UEFA Euro qualification,3,4,1,1,0,2,-1,0
Austria,1987,Friendly,5,7,1,1,1,3,-2,0
Austria,1987,UEFA Euro qualification,3,5,1,2,1,4,-2,0
Austria,1988,FIFA World Cup qualification,3,4,1,1,0,2,-1,0
Austria,1988,Friendly,9,8,2,2,2,6,1,0
Austria,1988,Tournoi de France,2,5,0,2,0,2,-3,0
Austria,1989,FIFA World Cup qualification,6,5,2,1,3,6,1,0
Austria,1989,Friendly,4,8,1,3,0,4,-4,0
Austria,1990,FIFA World Cup,2,3,1,2,0,3,-1,0
Austria,1990,Friendly,11,8,3,1,2,6,3,0
Austria,1990,UEFA Euro qualification,1,5,0,2,1,3,-4,0
Austria,1991,Friendly,1,7,0,1,2,3,-6,0
Austria,1991,UEFA Euro qualification,5,9,1,4,0,5,-4,0
Austria,1992,FIFA World Cup qualification,5,4,1,1,0,2,1,0
Austria,1992,Friendly,13,13,1,3,4,8,0,0
Austria,1993,FIFA World Cup qualification,10,12,2,4,2,8,-2,0
Austria,1993,Friendly,2,1,1,0,0,1,1,0
Austria,1994,Friendly,7,14,1,3,1,5,-7,0
Austria,1994,UEFA Euro qualification,5,3,1,2,0,3,2,0
Austria,1995,UEFA Euro qualification,24,11,4,2,1,7,13,0
Austria,1996,FIFA World Cup qualification,3,1,2,0,1,3,2,0
Austria,1996,Friendly,4,0,3,0,0,3,4,0
Austria,1997,FIFA World Cup qualification,14,3,6,1,0,7,11,0
Austria,1997,Friendly,0,2,0,1,0,1,-2,0
Austria,1998,FIFA World Cup,3,4,0,1,2,3,-1,0
Austria,1998,Friendly,12,9,2,2,1,5,3,0
Austria,1998,UEFA Euro qualification,8,2,2,0,1,3,6,0
Austria,1999,Friendly,4,2,1,0,1,2,2,0
Austria,1999,UEFA Euro qualification,11,18,2,3,0,5,-7,0
Austria,2000,FIFA World Cup qualification,2,1,1,0,1,2,1,0
Austria,2000,Friendly,9,9,1,2,2,5,0,0
Austria,2001,FIFA World Cup qualification,8,13,3,3,2,8,-5,0
Austria,2001,Friendly,1,3,0,2,0,2,-2,0
Austria,2002,Friendly,6,10,1,3,1,5,-4,0
Austria,2002,UEFA Euro qualification,4,3,2,1,0,3,1,0
Austria,2003,Friendly,6,2,2,0,1,3,4,0
Austria,2003,UEFA Euro qualification,8,11,1,4,0,5,-3,0
Austria,2004,FIFA World Cup qualification,8,8,1,1,2,4,0,0
Austria,2004,Friendly,6,5,1,1,2,4,1,0
Austria,2005,Cyprus International Tournament,2,2,0,0,2,2,0,0
Austria,2005,FIFA World Cup qualification,7,4,3,2,1,6,3,0
Austria,2005,Friendly,2,2,0,0,1,1,0,0
Austria,2006,Friendly,12,14,3,4,1,8,-2,0
Austria,2007,Friendly,7,13,1,5,6,12,-6,0
Austria,2008,FIFA World Cup qualification,5,7,1,2,1,4,-2,0
Austria,2008,Friendly,13,15,1,3,2,6,-2,0
Austria,2008,UEFA Euro,1,3,0,2,1,3,-2,0
Austria,2009,FIFA World Cup qualification,9,8,3,2,1,6,1,0
Austria,2009,Friendly,1,9,0,3,0,3,-8,0
Austria,2010,Friendly,3,5,1,3,0,4,-2,0
Austria,2010,UEFA Euro qualification,9,4,2,0,1,3,5,0
Austria,2011,Friendly,6,8,1,3,0,4,-2,0
Austria,2011,UEFA Euro qualification,7,13,1,4,2,7,-6,0
Austria,2012,FIFA World Cup qualification,5,2,1,1,1,3,3,0
Austria,2012,Friendly,8,6,3,1,1,5,2,0
Austria,2013,FIFA World Cup qualification,15,8,4,2,1,7,7,0
Austria,2013,Friendly,2,4,1,2,0,3,-2,0
Austria,2014,Friendly,5,5,1,1,2,4,0,0
Austria,2014,UEFA Euro qualification,5,2,3,0,1,4,3,0
Austria,2015,Friendly,2,3,0,1,1,2,-1,0
Austria,2015,UEFA Euro qualification,17,3,6,0,0,6,14,0
Austria,2016,FIFA World Cup qualification,6,7,1,2,1,4,-1,0
Austria,2016,Friendly,5,6,2,2,1,5,-1,0
Austria,2016,UEFA Euro,1,4,0,2,1,3,-3,0
Austria,2017,FIFA World Cup qualification,8,5,3,1,2,6,3,0
Austria,2017,Friendly,3,2,1,0,1,2,1,0
Austria,2018,Friendly,12,6,5,2,0,7,6,0
Austria,2018,UEFA Nations League,3,2,2,1,1,4,1,0
Austria,2019,UEFA Euro qualification,19,9,6,3,1,10,10,0
Austria,2020,Friendly,5,1,2,0,0,2,4,0
Austria,2020,UEFA Nations League,9,6,4,1,1,6,3,0
Austria,2021,FIFA World Cup qualification,19,17,5,4,1,10,2,0
Austria,2021,Friendly,0,1,0,1,1,2,-1,0
Austria,2021,UEFA Euro,5,5,2,2,0,4,0,0
Austria,2022,FIFA World Cup qualification,1,2,0,1,0,1,-1,0
Austria,2022,Friendly,5,2,2,0,1,3,3,0
Austria,2022,UEFA Nations League,6,10,1,4,1,6,-4,0
Austria,2023,Friendly,3,1,1,0,1,2,2,0
Austria,2023,UEFA Euro qualification,17,7,6,1,1,8,10,0
Austria,2024,Friendly,11,3,3,0,1,4,8,0
Austria,2024,UEFA Euro,7,6,2,2,0,4,1,0
Austria,2024,UEFA Nations League,14,5,3,1,2,6,9,0
Austria,2025,UEFA Nations League,1,3,0,1,1,2,-2,0
Aymara,2022,CONIFA South America Football Cup,1,4,0,2,0,2,-3,0
Azerbaijan,1979,Friendly,0,1,0,1,0,1,-1,0
Azerbaijan,1992,Friendly,3,6,0,1,0,1,-3,0
Azerbaijan,1993,Friendly,6,2,3,0,0,3,4,0
Azerbaijan,1994,Friendly,0,5,0,1,0,1,-5,0
Azerbaijan,1994,UEFA Euro qualification,0,8,0,4,0,4,-8,0
Azerbaijan,1995,UEFA Euro qualification,2,21,0,5,1,6,-19,0
Azerbaijan,1996,FIFA World Cup qualification,1,8,1,2,0,3,-7,0
Azerbaijan,1996,Friendly,5,5,1,2,2,5,0,0
Azerbaijan,1997,FIFA World Cup qualification,2,14,0,5,0,5,-12,0
Azerbaijan,1997,Friendly,3,5,1,3,1,5,-2,0
Azerbaijan,1998,Friendly,8,3,5,0,2,7,5,0
Azerbaijan,1998,UEFA Euro qualification,1,9,0,3,0,3,-8,0
Azerbaijan,1999,Friendly,3,7,0,1,1,2,-4,0
Azerbaijan,1999,UEFA Euro qualification,5,17,1,5,1,7,-12,0
Azerbaijan,2000,FIFA World Cup qualification,0,5,0,3,0,3,-5,0
Azerbaijan,2000,Friendly,2,4,0,2,1,3,-2,0
Azerbaijan,2000,Malta International Tournament,0,4,0,2,1,3,-4,0
Azerbaijan,2001,FIFA World Cup qualification,4,12,1,4,2,7,-8,0
Azerbaijan,2001,Friendly,1,3,0,2,0,2,-2,0
Azerbaijan,2002,Friendly,2,2,1,2,2,5,0,0
Azerbaijan,2002,UEFA Euro qualification,0,7,0,3,0,3,-7,0
Azerbaijan,2003,Friendly,3,4,0,1,1,2,-1,0
Azerbaijan,2003,UEFA Euro qualification,5,13,1,3,1,5,-8,0
Azerbaijan,2004,FIFA World Cup qualification,1,4,0,2,2,4,-3,0
Azerbaijan,2004,Friendly,10,8,2,1,3,6,2,0
Azerbaijan,2005,FIFA World Cup qualification,0,17,0,5,1,6,-17,0
Azerbaijan,2005,Friendly,2,7,0,4,1,5,-5,0
Azerbaijan,2006,Friendly,1,7,0,1,3,4,-6,0
Azerbaijan,2006,UEFA Euro qualification,1,8,0,3,1,4,-7,0
Azerbaijan,2007,Friendly,6,4,3,1,2,6,2,0
Azerbaijan,2007,UEFA Euro qualification,5,20,1,6,1,8,-15,0
Azerbaijan,2008,FIFA World Cup qualification,0,2,0,2,1,3,-2,0
Azerbaijan,2008,Friendly,6,7,2,3,3,8,-1,0
Azerbaijan,2009,FIFA World Cup qualification,4,12,1,5,1,7,-8,0
Azerbaijan,2009,Friendly,4,11,1,3,2,6,-7,0
Azerbaijan,2010,Friendly,7,8,2,2,3,7,-1,0
Azerbaijan,2010,UEFA Euro qualification,2,9,1,2,0,3,-7,0
Azerbaijan,2011,Friendly,1,3,1,2,0,3,-2,0
Azerbaijan,2011,UEFA Euro qualification,8,17,1,5,1,7,-9,0
Azerbaijan,2012,FIFA World Cup qualification,2,6,0,2,2,4,-4,0
Azerbaijan,2012,Friendly,8,6,2,2,2,6,2,0
Azerbaijan,2013,FIFA World Cup qualification,5,5,1,1,4,6,0,0
Azerbaijan,2013,Friendly,6,3,2,1,3,6,3,0
Azerbaijan,2014,Friendly,1,4,1,1,1,3,-3,0
Azerbaijan,2014,UEFA Euro qualification,2,11,0,4,0,4,-9,0
Azerbaijan,2015,Friendly,3,5,1,1,0,2,-2,0
Azerbaijan,2015,UEFA Euro qualification,5,7,1,2,3,6,-2,0
Azerbaijan,2016,FIFA World Cup qualification,2,4,2,1,1,4,-2,0
Azerbaijan,2016,Friendly,2,5,0,2,2,4,-3,0
Azerbaijan,2017,FIFA World Cup qualification,8,15,1,5,0,6,-7,0
Azerbaijan,2017,Friendly,2,1,1,0,0,1,1,0
Azerbaijan,2018,Friendly,7,6,2,2,2,6,1,0
Azerbaijan,2018,UEFA Nations League,7,6,2,1,3,6,1,0
Azerbaijan,2019,Friendly,3,2,1,0,1,2,1,0
Azerbaijan,2019,UEFA Euro qualification,5,18,0,7,1,8,-13,0
Azerbaijan,2020,Friendly,0,0,0,0,1,1,0,0
Azerbaijan,2020,UEFA Nations League,2,4,1,2,3,6,-2,0
Azerbaijan,2021,FIFA World Cup qualification,5,18,0,7,1,8,-13,0
Azerbaijan,2021,Friendly,6,8,1,3,1,5,-2,0
Azerbaijan,2022,Friendly,5,4,2,2,0,4,1,0
Azerbaijan,2022,UEFA Nations League,7,4,3,2,1,6,3,0
Azerbaijan,2023,Friendly,2,1,1,0,0,1,1,0
Azerbaijan,2023,UEFA Euro qualification,7,17,2,5,1,8,-10,0
Azerbaijan,2024,FIFA Series,2,1,1,0,1,2,1,0
Azerbaijan,2024,Friendly,4,5,1,1,0,2,-1,0
Azerbaijan,2024,UEFA Nations League,3,17,0,5,1,6,-14,0
Azerbaijan,2025,Friendly,0,5,0,2,0,2,-5,0
Bahamas,1971,Friendly,0,8,0,1,0,1,-8,0
Bahamas,1999,CFU Caribbean Cup qualification,4,17,1,3,1,5,-13,0
Bahamas,1999,Friendly,0,4,0,1,0,1,-4,0
Bahamas,2000,FIFA World Cup qualification,5,15,2,2,0,4,-10,0
Bahamas,2001,Friendly,0,2,0,1,0,1,-2,0
Bahamas,2003,Friendly,0,6,0,1,0,1,-6,0
Bahamas,2004,FIFA World Cup qualification,2,4,0,1,1,2,-2,0
Bahamas,2006,CFU Caribbean Cup qualification,7,15,2,3,0,5,-8,0
Bahamas,2008,FIFA World Cup qualification,3,16,0,2,2,4,-13,0
Bahamas,2011,FIFA World Cup qualification,10,0,2,0,0,2,10,0
Bahamas,2015,FIFA World Cup qualification,0,8,0,2,0,2,-8,0
Bahamas,2018,CONCACAF Nations League qualification,1,11,0,2,1,3,-10,0
Bahamas,2019,CONCACAF Nations League,10,2,3,0,1,4,8,0
Bahamas,2019,CONCACAF Nations League qualification,0,4,0,1,0,1,-4,0
Bahamas,2019,Friendly,6,1,1,0,0,1,5,0
Bahamas,2021,FIFA World Cup qualification,0,15,0,3,1,4,-15,0
Bahamas,2021,Gold Cup qualification,0,2,0,1,0,1,-2,0
Bahamas,2022,CONCACAF Nations League,1,7,1,3,0,4,-6,0
Bahamas,2022,Friendly,5,4,1,1,0,2,1,0
Bahamas,2023,CONCACAF Nations League,8,25,0,5,2,7,-17,0
Bahamas,2024,CONCACAF Nations League,10,13,1,2,1,4,-3,0
Bahamas,2024,FIFA World Cup qualification,1,8,0,2,0,2,-7,0
Bahrain,1966,Arab Cup,7,25,0,3,1,4,-18,0
Bahrain,1970,Gulf Cup,3,4,1,1,1,3,-1,0
Bahrain,1971,AFC Asian Cup qualification,8,4,2,2,0,4,4,0
Bahrain,1972,Gulf Cup,9,6,2,2,0,4,3,0
Bahrain,1974,Asian Games,1,15,0,3,0,3,-14,0
Bahrain,1974,Friendly,0,5,0,2,0,2,-5,0
Bahrain,1974,Gulf Cup,5,8,1,2,0,3,-3,0
Bahrain,1976,Gulf Cup,9,15,3,3,0,6,-6,0
Bahrain,1977,FIFA World Cup qualification,4,6,1,3,0,4,-2,0
Bahrain,1977,Friendly,2,5,0,1,1,2,-3,0
Bahrain,1977,Korea Cup,1,3,0,1,0,1,-2,0
Bahrain,1978,Asian Games,1,12,0,3,0,3,-11,0
Bahrain,1978,Korea Cup,2,5,0,2,0,2,-3,0
Bahrain,1979,Friendly,1,5,0,3,0,3,-4,0
Bahrain,1979,Gulf Cup,8,9,2,2,2,6,-1,0
Bahrain,1979,Korea Cup,1,5,0,1,0,1,-4,0
Bahrain,1980,Korea Cup,3,10,0,3,1,4,-7,0
Bahrain,1981,FIFA World Cup qualification,1,6,1,3,0,4,-5,0
Bahrain,1981,Friendly,1,3,1,1,0,2,-2,0
Bahrain,1982,Friendly,0,2,0,1,0,1,-2,0
Bahrain,1982,Gulf Cup,10,7,3,1,1,5,3,0
Bahrain,1982,Korea Cup,0,3,0,1,1,2,-3,0
Bahrain,1984,Gulf Cup,3,6,1,3,2,6,-3,0
Bahrain,1985,Arab Cup,4,3,1,1,2,4,1,0
Bahrain,1985,FIFA World Cup qualification,8,6,1,1,2,4,2,0
Bahrain,1985,Friendly,3,2,1,0,0,1,1,0
Bahrain,1985,Korea Cup,3,4,1,1,0,2,-1,0
Bahrain,1986,Asian Games,4,5,1,1,1,3,-1,0
Bahrain,1986,Friendly,9,14,3,5,1,9,-5,0
Bahrain,1986,Gulf Cup,4,5,1,1,4,6,-1,0
Bahrain,1987,Friendly,2,5,0,2,0,2,-3,0
Bahrain,1988,AFC Asian Cup,1,3,0,2,2,4,-2,0
Bahrain,1988,AFC Asian Cup qualification,4,0,2,0,1,3,4,1
Bahrain,1988,Arab Cup,1,2,0,1,1,2,-1,0
Bahrain,1988,Gulf Cup,4,4,3,3,0,6,0,0
Bahrain,1990,Gulf Cup,1,1,1,1,2,4,0,0
Bahrain,1992,Friendly,0,0,0,0,1,1,0,0
Bahrain,1992,Gulf Cup,6,4,3,2,0,5,2,0
Bahrain,1993,FIFA World Cup qualification,9,6,3,2,3,8,3,0
Bahrain,1994,Asian Games,6,5,1,1,2,4,1,0
Bahrain,1994,Gulf Cup,5,6,1,1,3,5,-1,0
Bahrain,1996,Friendly,3,5,1,1,0,2,-2,0
Bahrain,1996,Gulf Cup,4,8,0,3,2,5,-4,0
Bahrain,1997,FIFA World Cup qualification,3,9,1,3,0,4,-6,0
Bahrain,1997,Friendly,4,6,1,2,1,4,-2,0
Bahrain,1998,Friendly,8,6,2,1,1,4,2,0
Bahrain,1998,Gulf Cup,3,6,0,2,3,5,-3,0
Bahrain,2000,AFC Asian Cup qualification,6,6,3,3,0,6,0,0
Bahrain,2000,Friendly,3,7,1,4,1,6,-4,0
Bahrain,2001,FIFA World Cup qualification,17,13,7,3,4,14,4,0
Bahrain,2001,Friendly,5,5,1,1,3,5,0,0
Bahrain,2001,Merdeka Tournament,6,5,2,2,0,4,1,0
Bahrain,2001,Millennium Cup,0,7,0,2,0,2,-7,0
Bahrain,2002,Arab Cup,8,5,3,2,1,6,3,0
Bahrain,2002,Friendly,2,2,0,0,1,1,0,0
Bahrain,2002,Gulf Cup,4,6,1,2,2,5,-2,0
Bahrain,2002,Prime Minister's Cup,8,11,1,3,2,6,-3,0
Bahrain,2003,AFC Asian Cup qualification,14,9,4,1,1,6,5,0
Bahrain,2003,Friendly,4,4,1,1,0,2,0,0
Bahrain,2003,Gulf Cup,5,1,1,0,1,2,4,0
Bahrain,2003,Prime Minister's Cup,4,4,1,1,1,3,0,1
Bahrain,2004,AFC Asian Cup,13,14,1,2,3,6,-1,0
Bahrain,2004,FIFA World Cup qualification,15,4,4,0,2,6,11,0
Bahrain,2004,Friendly,9,12,3,4,3,10,-3,0
Bahrain,2004,Gulf Cup,18,8,5,2,2,9,10,0
Bahrain,2004,Prime Minister's Cup,3,4,0,1,1,2,-1,0
Bahrain,2005,FIFA World Cup qualification,6,10,1,5,4,10,-4,0
Bahrain,2005,Friendly,19,9,3,1,4,8,10,0
Bahrain,2006,AFC Asian Cup qualification,3,6,1,2,1,4,-3,0
Bahrain,2006,Friendly,2,7,0,3,2,5,-5,0
Bahrain,2007,AFC Asian Cup,3,7,1,2,0,3,-4,0
Bahrain,2007,FIFA World Cup qualification,4,1,1,0,1,2,3,0
Bahrain,2007,Friendly,11,11,2,2,1,5,0,0
Bahrain,2007,Gulf Cup,4,5,1,2,1,4,-1,0
Bahrain,2008,FIFA World Cup qualification,10,10,3,3,3,9,0,0
Bahrain,2008,Friendly,18,15,8,3,1,12,3,0
Bahrain,2009,AFC Asian Cup qualification,8,1,3,0,0,3,7,0
Bahrain,2009,FIFA World Cup qualification,5,6,3,3,3,9,-1,0
Bahrain,2009,Friendly,25,9,6,0,1,7,16,0
Bahrain,2009,Gulf Cup,3,4,1,2,0,3,-1,0
Bahrain,2010,AFC Asian Cup qualification,4,5,1,2,0,3,-1,0
Bahrain,2010,Friendly,14,17,3,4,4,11,-3,0
Bahrain,2010,Gulf Cup,4,7,0,2,1,3,-3,0
Bahrain,2010,WAFF Championship,2,3,1,1,0,2,-1,0
Bahrain,2011,AFC Asian Cup,6,5,1,2,0,3,1,0
Bahrain,2011,FIFA World Cup qualification,3,7,1,1,3,5,-4,0
Bahrain,2011,Friendly,3,3,2,2,2,6,0,0
Bahrain,2012,Arab Cup,1,4,0,2,0,2,-3,0
Bahrain,2012,FIFA World Cup qualification,10,0,1,0,0,1,10,0
Bahrain,2012,Friendly,12,14,3,4,4,11,-2,0
Bahrain,2012,WAFF Championship,3,2,2,1,2,5,1,0
Bahrain,2013,AFC Asian Cup qualification,7,1,4,0,1,5,6,0
Bahrain,2013,Friendly,3,4,1,2,2,5,-1,0
Bahrain,2013,Gulf Cup,4,9,1,2,2,5,-5,0
Bahrain,2013,WAFF Championship,0,0,0,0,2,2,0,0
Bahrain,2014,AFC Asian Cup qualification,0,0,0,0,1,1,0,0
Bahrain,2014,Friendly,9,3,3,0,3,6,6,0
Bahrain,2014,Gulf Cup,0,3,0,1,2,3,-3,0
Bahrain,2014,WAFF Championship,0,1,0,1,1,2,-1,0
Bahrain,2015,AFC Asian Cup,3,5,1,2,0,3,-2,0
Bahrain,2015,FIFA World Cup qualification,7,9,2,4,0,6,-2,0
Bahrain,2015,Friendly,4,8,2,1,2,5,-4,0
Bahrain,2016,FIFA World Cup qualification,3,1,1,1,0,2,2,0
Bahrain,2016,Friendly,10,6,3,1,3,7,4,0
Bahrain,2017,AFC Asian Cup qualification,11,3,3,1,1,5,8,0
Bahrain,2017,Friendly,3,3,1,1,3,5,0,0
Bahrain,2017,Gulf Cup,3,2,1,0,2,3,1,0
Bahrain,2018,AFC Asian Cup qualification,4,0,1,0,0,1,4,0
Bahrain,2018,Friendly,16,5,4,2,3,9,11,0
Bahrain,2018,Gulf Cup,0,1,0,1,0,1,-1,0
Bahrain,2019,AFC Asian Cup,3,4,1,2,1,4,-1,0
Bahrain,2019,FIFA World Cup qualification,3,1,2,0,3,5,2,0
Bahrain,2019,Friendly,2,3,0,1,0,1,-1,0
Bahrain,2019,Gulf Cup,7,6,2,1,2,5,1,1
Bahrain,2019,WAFF Championship,3,0,3,0,1,4,3,1
Bahrain,2020,Friendly,7,2,3,0,0,3,5,0
Bahrain,2021,Arab Cup,0,4,0,2,1,3,-4,0
Bahrain,2021,Arab Cup qualification,2,0,1,0,0,1,2,1
Bahrain,2021,FIFA World Cup qualification,12,3,2,1,0,3,9,0
Bahrain,2021,Friendly,22,10,5,3,1,9,12,0
Bahrain,2022,AFC Asian Cup qualification,5,1,3,0,0,3,4,0
Bahrain,2022,Friendly,16,18,6,5,1,12,-2,0
Bahrain,2023,FIFA World Cup qualification,2,2,1,1,0,2,0,0
Bahrain,2023,Friendly,7,6,3,2,1,6,1,0
Bahrain,2023,Gulf Cup,5,4,2,1,1,4,1,0
Bahrain,2024,AFC Asian Cup,4,6,2,2,0,4,-2,0
Bahrain,2024,FIFA World Cup qualification,14,11,3,2,5,10,3,0
Bahrain,2024,Friendly,0,5,0,2,0,2,-5,0
Bahrain,2024,Gulf Cup,7,4,3,1,0,4,3,0
Bahrain,2025,FIFA World Cup qualification,0,3,0,2,0,2,-3,0
Bahrain,2025,Gulf Cup,2,1,1,0,0,1,1,1
Bangladesh,1973,Friendly,1,0,1,0,0,1,1,0
Bangladesh,1973,Merdeka Tournament,5,14,0,3,3,6,-9,0
Bangladesh,1975,Merdeka Tournament,3,31,0,6,1,7,-28,0
Bangladesh,1976,King's Cup,0,6,0,1,0,1,-6,0
Bangladesh,1978,Asian Games,0,4,0,2,0,2,-4,0
Bangladesh,1979,AFC Asian Cup qualification,4,5,1,1,0,2,-1,0
Bangladesh,1979,Korea Cup,1,13,0,2,0,2,-12,0
Bangladesh,1980,AFC Asian Cup,2,17,0,4,0,4,-15,0
Bangladesh,1982,Asian Games,2,4,1,2,0,3,-2,0
Bangladesh,1982,Friendly,2,4,0,1,1,2,-2,0
Bangladesh,1983,Merdeka Tournament,1,1,1,1,0,2,0,0
Bangladesh,1984,AFC Asian Cup qualification,6,13,1,4,0,5,-7,0
Bangladesh,1984,South Asian Games,14,4,3,1,0,4,10,0
Bangladesh,1985,FIFA World Cup qualification,5,10,2,4,0,6,-5,0
Bangladesh,1985,Friendly,4,3,1,1,1,3,1,0
Bangladesh,1985,South Asian Games,11,2,2,0,1,3,9,0
Bangladesh,1986,Asian Games,1,12,1,3,0,4,-11,0
Bangladesh,1986,Friendly,0,1,0,1,0,1,-1,0
Bangladesh,1987,South Asian Games,3,2,1,2,0,3,1,0
Bangladesh,1988,AFC Asian Cup qualification,1,9,0,2,3,5,-8,0
Bangladesh,1989,FIFA World Cup qualification,4,9,1,5,0,6,-5,0
Bangladesh,1989,South Asian Games,4,2,1,1,1,3,2,0
Bangladesh,1990,Asian Games,0,7,0,2,0,2,-7,0
Bangladesh,1991,South Asian Games,4,2,2,1,0,3,2,0
Bangladesh,1992,AFC Asian Cup qualification,0,7,0,2,0,2,-7,0
Bangladesh,1993,FIFA World Cup qualification,7,28,2,6,0,8,-21,0
Bangladesh,1993,Friendly,3,1,1,0,0,1,2,0
Bangladesh,1993,South Asian Games,0,1,0,1,1,2,-1,0
Bangladesh,1994,Friendly,2,4,0,1,0,1,-2,0
Bangladesh,1995,Friendly,3,5,2,1,0,3,-2,0
Bangladesh,1995,SAFF Cup,2,1,1,1,1,3,1,0
Bangladesh,1995,South Asian Games,2,2,1,1,2,4,0,0
Bangladesh,1997,FIFA World Cup qualification,4,14,1,5,0,6,-10,0
Bangladesh,1997,SAFF Cup,1,4,0,1,1,2,-3,0
Bangladesh,1999,AFC Asian Cup qualification,5,12,1,2,1,4,-7,0
Bangladesh,1999,SAFF Cup,6,3,2,1,1,4,3,0
Bangladesh,1999,South Asian Games,4,2,3,1,0,4,2,1
Bangladesh,2000,Friendly,2,4,0,2,2,4,-2,0
Bangladesh,2001,FIFA World Cup qualification,5,15,1,3,2,6,-10,0
Bangladesh,2001,Friendly,3,1,1,0,0,1,2,0
Bangladesh,2001,Millennium Cup,1,6,0,2,0,2,-5,0
Bangladesh,2003,AFC Asian Cup qualification,3,4,0,1,1,2,-1,0
Bangladesh,2003,FIFA World Cup qualification,0,4,0,2,0,2,-4,0
Bangladesh,2003,SAFF Cup,8,2,4,0,1,5,6,0
Bangladesh,2005,AFC Asian Cup qualification,1,0,1,0,1,2,1,1
Bangladesh,2005,SAFF Cup,7,3,3,1,1,5,4,0
Bangladesh,2006,AFC Asian Cup qualification,1,19,0,6,0,6,-18,0
Bangladesh,2006,AFC Challenge Cup,7,8,2,1,1,4,-1,0
Bangladesh,2007,FIFA World Cup qualification,1,6,0,1,1,2,-5,0
Bangladesh,2007,Merdeka Tournament,3,6,0,2,0,2,-3,0
Bangladesh,2007,Nehru Cup,1,7,0,3,1,4,-6,0
Bangladesh,2008,AFC Challenge Cup qualification,1,2,0,1,1,2,-1,0
Bangladesh,2008,Friendly,0,2,0,1,1,2,-2,0
Bangladesh,2008,Merdeka Tournament,0,1,0,1,0,1,-1,0
Bangladesh,2008,SAFF Cup,3,4,0,1,2,3,-1,0
Bangladesh,2009,AFC Challenge Cup qualification,5,2,2,1,0,3,3,1
Bangladesh,2009,SAFF Cup,6,2,2,0,1,3,4,0
Bangladesh,2010,AFC Challenge Cup,3,6,1,2,0,3,-3,0
Bangladesh,2011,AFC Challenge Cup qualification,2,5,1,2,0,3,-3,0
Bangladesh,2011,FIFA World Cup qualification,5,4,2,1,1,4,1,0
Bangladesh,2011,SAFF Cup,1,4,0,2,1,3,-3,0
Bangladesh,2012,Friendly,2,7,0,1,2,3,-5,0
Bangladesh,2013,AFC Challenge Cup qualification,6,1,2,1,0,3,5,0
Bangladesh,2013,SAFF Cup,2,5,0,2,1,3,-3,0
Bangladesh,2014,Friendly,4,3,1,0,2,3,1,0
Bangladesh,2015,FIFA World Cup qualification,2,24,0,6,1,7,-22,0
Bangladesh,2015,Friendly,4,3,2,1,2,5,1,0
Bangladesh,2015,SAFF Cup,4,7,1,2,0,3,-3,0
Bangladesh,2016,AFC Asian Cup qualification,1,9,0,3,1,4,-8,0
Bangladesh,2016,FIFA World Cup qualification,0,8,0,1,0,1,-8,0
Bangladesh,2016,Friendly,5,13,1,2,1,4,-8,0
Bangladesh,2018,Friendly,2,3,0,1,1,2,-1,0
Bangladesh,2018,SAFF Cup,3,2,2,1,0,3,1,0
Bangladesh,2019,FIFA World Cup qualification,3,8,1,3,2,6,-5,0
Bangladesh,2019,Friendly,7,1,3,0,0,3,6,0
Bangladesh,2020,FIFA World Cup qualification,0,5,0,1,0,1,-5,0
Bangladesh,2020,Friendly,2,0,1,0,1,2,2,0
Bangladesh,2021,FIFA World Cup qualification,1,6,0,2,1,3,-5,0
Bangladesh,2021,Friendly,1,2,0,1,1,2,-1,0
Bangladesh,2021,Mahinda Rajapaksa Cup,4,4,1,1,1,3,0,0
Bangladesh,2021,SAFF Cup,3,4,1,1,2,4,-1,0
Bangladesh,2021,Three Nations Cup,1,6,0,2,0,2,-5,0
Bangladesh,2022,AFC Asian Cup qualification,2,8,0,3,0,3,-6,0
Bangladesh,2022,Friendly,2,5,1,2,2,5,-3,0
Bangladesh,2023,FIFA World Cup qualification,4,10,1,1,2,4,-6,0
Bangladesh,2023,Friendly,4,3,2,1,3,6,1,0
Bangladesh,2023,SAFF Cup,6,5,2,2,0,4,1,0
Bangladesh,2024,FIFA World Cup qualification,0,12,0,4,0,4,-12,0
Bangladesh,2024,Friendly,3,3,2,2,0,4,0,0
Bangladesh,2025,AFC Asian Cup qualification,0,0,0,0,1,1,0,0
Barawa,2016,World Unity Cup,2,8,0,2,0,2,-6,0
Barawa,2018,CONIFA World Football Cup,7,22,2,4,0,6,-15,0
Barawa,2018,Friendly,7,11,1,2,0,3,-4,0
Barawa,2019,Friendly,0,5,0,1,0,1,-5,0
Barbados,1929,Friendly,7,1,3,0,0,3,6,0
Barbados,1931,Friendly,6,32,1,5,1,7,-26,0
Barbados,1932,Friendly,4,6,1,2,1,4,-2,0
Barbados,1933,Friendly,7,24,0,5,0,5,-17,0
Barbados,1942,Friendly,3,3,0,0,1,1,0,0
Barbados,1944,Friendly,4,24,0,6,2,8,-20,0
Barbados,1951,Friendly,12,8,3,2,0,5,4,0
Barbados,1959,Friendly,3,6,1,2,0,3,-3,0
Barbados,1968,Friendly,0,2,0,1,1,2,-2,0
Barbados,1971,Friendly,1,3,0,1,0,1,-2,0
Barbados,1973,Friendly,3,4,1,1,0,2,-1,0
Barbados,1975,Friendly,1,1,1,1,0,2,0,0
Barbados,1976,CONCACAF Championship qualification,3,5,1,2,0,3,-2,0
Barbados,1977,Friendly,0,2,0,1,2,3,-2,0
Barbados,1978,CFU Caribbean Cup qualification,0,1,0,1,1,2,-1,0
Barbados,1978,Friendly,4,2,2,1,1,4,2,0
Barbados,1979,Friendly,3,4,0,1,1,2,-1,0
Barbados,1981,CFU Caribbean Cup qualification,2,2,0,0,2,2,0,0
Barbados,1981,Friendly,1,2,0,1,1,2,-1,0
Barbados,1982,Friendly,2,1,1,0,1,2,1,0
Barbados,1983,CFU Caribbean Cup qualification,2,3,1,1,2,4,-1,0
Barbados,1983,Friendly,0,4,0,1,0,1,-4,0
Barbados,1985,CFU Caribbean Cup,2,2,0,0,3,3,0,0
Barbados,1985,Friendly,6,3,1,0,1,2,3,0
Barbados,1986,Friendly,1,2,0,1,0,1,-1,0
Barbados,1987,CFU Caribbean Cup qualification,1,9,0,2,0,2,-8,0
Barbados,1987,Friendly,6,3,1,0,2,3,3,0
Barbados,1989,CFU Caribbean Cup,1,3,1,1,0,2,-2,0
Barbados,1989,Friendly,5,5,1,1,2,4,0,0
Barbados,1990,CFU Caribbean Cup,2,2,0,0,1,1,0,0
Barbados,1990,CFU Caribbean Cup qualification,3,1,2,0,1,3,2,0
Barbados,1990,Friendly,11,5,3,2,1,6,6,0
Barbados,1992,CFU Caribbean Cup qualification,1,0,1,0,0,1,1,0
Barbados,1992,FIFA World Cup qualification,1,5,0,2,0,2,-4,0
Barbados,1992,Friendly,2,0,1,0,0,1,2,0
Barbados,1993,CFU Caribbean Cup qualification,9,2,2,1,0,3,7,0
Barbados,1994,CFU Caribbean Cup qualification,3,3,1,1,0,2,0,0
Barbados,1994,Friendly,0,0,0,0,1,1,0,0
Barbados,1995,CFU Caribbean Cup qualification,9,3,2,1,1,4,6,0
Barbados,1995,Friendly,0,1,0,1,0,1,-1,0
Barbados,1995,Windward Islands Tournament,0,3,0,2,0,2,-3,0
Barbados,1996,CFU Caribbean Cup qualification,2,2,1,1,0,2,0,0
Barbados,1996,FIFA World Cup qualification,2,3,2,2,0,4,-1,0
Barbados,1996,Friendly,0,4,0,1,0,1,-4,0
Barbados,1997,CFU Caribbean Cup qualification,3,1,1,0,1,2,2,0
Barbados,1997,Friendly,2,1,1,0,1,2,1,0
Barbados,1998,CFU Caribbean Cup qualification,2,6,0,2,0,2,-4,0
Barbados,1998,Friendly,6,3,1,1,0,2,3,0
Barbados,1999,CFU Caribbean Cup qualification,9,4,3,1,1,5,5,0
Barbados,2000,FIFA World Cup qualification,17,27,4,5,3,12,-10,0
Barbados,2000,Friendly,3,8,1,2,2,5,-5,0
Barbados,2001,CFU Caribbean Cup,2,10,0,3,0,3,-8,0
Barbados,2001,CFU Caribbean Cup qualification,9,5,2,0,1,3,4,0
Barbados,2002,Friendly,3,2,1,0,0,1,1,0
Barbados,2002,Gold Cup qualification,3,2,1,1,1,3,1,0
Barbados,2002,SKN Football Festival,0,3,0,1,1,2,-3,0
Barbados,2003,Friendly,7,6,2,1,2,5,1,0
Barbados,2004,FIFA World Cup qualification,2,5,0,2,0,2,-3,0
Barbados,2004,Friendly,10,5,4,2,1,7,5,0
Barbados,2005,CFU Caribbean Cup,2,7,0,3,0,3,-5,0
Barbados,2005,Friendly,9,5,2,0,1,3,4,0
Barbados,2006,CFU Caribbean Cup qualification,14,5,3,0,2,5,9,0
Barbados,2006,Friendly,7,2,1,0,1,2,5,0
Barbados,2007,CFU Caribbean Cup,3,6,0,2,1,3,-3,0
Barbados,2007,Friendly,0,0,0,0,1,1,0,0
Barbados,2008,CFU Caribbean Cup,4,8,0,3,0,3,-4,0
Barbados,2008,CFU Caribbean Cup qualification,11,6,4,0,1,5,5,0
Barbados,2008,FIFA World Cup qualification,2,10,1,2,1,4,-8,0
Barbados,2008,Friendly,4,10,1,3,0,4,-6,0
Barbados,2009,Friendly,5,0,1,0,0,1,5,0
Barbados,2010,CFU Caribbean Cup qualification,6,1,1,0,1,2,5,0
Barbados,2010,Friendly,1,3,0,1,0,1,-2,0
Barbados,2011,FIFA World Cup qualification,2,14,0,6,0,6,-12,0
Barbados,2011,Friendly,7,5,1,2,1,4,2,0
Barbados,2012,CFU Caribbean Cup qualification,3,2,2,1,0,3,1,0
Barbados,2014,CFU Caribbean Cup qualification,7,5,2,1,0,3,2,0
Barbados,2015,FIFA World Cup qualification,6,4,2,2,0,4,2,0
Barbados,2015,Friendly,1,3,0,1,0,1,-2,0
Barbados,2016,CFU Caribbean Cup qualification,1,2,1,1,0,2,-1,0
Barbados,2017,Friendly,8,14,2,4,0,6,-6,0
Barbados,2017,Windward Islands Tournament,4,3,1,1,1,3,1,1
Barbados,2018,CONCACAF Nations League qualification,3,6,1,2,0,3,-3,0
Barbados,2018,Friendly,3,6,0,2,5,7,-3,0
Barbados,2019,CONCACAF Nations League,14,4,4,2,0,6,10,0
Barbados,2019,CONCACAF Nations League qualification,0,1,0,1,0,1,-1,0
Barbados,2019,Friendly,3,0,1,0,0,1,3,0
Barbados,2020,Friendly,2,8,0,2,0,2,-6,0
Barbados,2021,FIFA World Cup qualification,3,3,1,1,2,4,0,0
Barbados,2021,Gold Cup qualification,1,8,0,1,0,1,-7,0
Barbados,2022,CONCACAF Nations League,1,7,0,4,0,4,-6,0
Barbados,2022,Friendly,0,15,0,3,0,3,-15,0
Barbados,2023,CONCACAF Nations League,9,28,1,7,0,8,-19,0
Barbados,2023,Friendly,3,3,0,0,2,2,0,0
Barbados,2024,CONCACAF Nations League,21,13,4,2,0,6,8,0
Barbados,2024,FIFA World Cup qualification,2,7,0,2,0,2,-5,0
Basque Country,1915,Friendly,9,3,2,0,1,3,6,0
Basque Country,1916,Friendly,8,1,2,0,1,3,7,0
Basque Country,1924,Friendly,2,1,1,0,0,1,1,0
Basque Country,1930,Friendly,1,0,1,0,0,1,1,0
Basque Country,1931,Friendly,3,2,1,0,0,1,1,0
Basque Country,1937,Friendly,31,12,6,2,0,8,19,1
Basque Country,1938,Friendly,22,17,4,2,0,6,5,0
Basque Country,1971,Friendly,1,2,0,1,0,1,-1,0
Basque Country,1978,Friendly,0,0,0,0,1,1,0,0
Basque Country,1979,Friendly,4,0,1,0,0,1,4,0
Basque Country,1980,Friendly,1,5,0,1,0,1,-4,0
Basque Country,1990,Friendly,2,2,0,0,1,1,0,0
Basque Country,1993,Friendly,3,1,1,0,0,1,2,0
Basque Country,1994,Friendly,1,0,1,0,0,1,1,0
Basque Country,1995,Friendly,1,1,0,0,1,1,0,0
Basque Country,1996,Friendly,3,1,1,0,0,1,2,0
Basque Country,1997,Friendly,3,1,1,0,0,1,2,0
Basque Country,1998,Friendly,5,1,1,0,0,1,4,0
Basque Country,1999,Friendly,5,1,1,0,0,1,4,0
Basque Country,2000,Friendly,3,2,1,0,0,1,1,1
Basque Country,2001,Friendly,3,2,1,0,0,1,1,0
Basque Country,2002,Friendly,1,1,0,0,1,1,0,0
Basque Country,2003,Friendly,2,1,1,0,0,1,1,0
Basque Country,2004,Friendly,2,0,1,0,0,1,2,1
Basque Country,2005,Friendly,0,1,0,1,0,1,-1,0
Basque Country,2006,Friendly,6,3,1,1,1,3,3,0
Basque Country,2007,Friendly,5,4,1,0,1,2,1,0
Basque Country,2010,Friendly,3,1,1,0,0,1,2,0
Basque Country,2011,Friendly,2,3,1,1,0,2,-1,0
Basque Country,2012,Friendly,6,1,1,0,0,1,5,0
Basque Country,2013,Friendly,6,0,1,0,0,1,6,0
Basque Country,2014,Friendly,1,1,0,0,1,1,0,0
Basque Country,2015,Friendly,1,0,1,0,0,1,1,1
Basque Country,2016,Friendly,4,2,1,0,1,2,2,1
Basque Country,2018,Friendly,4,2,1,0,0,1,2,0
Basque Country,2019,Friendly,0,0,0,0,1,1,0,0
Basque Country,2020,Friendly,2,1,1,0,0,1,1,0
Belarus,1928,Friendly,9,11,1,2,0,3,-2,0
Belarus,1956,Friendly,4,9,1,2,0,3,-5,0
Belarus,1967,Friendly,2,1,1,0,0,1,1,0
Belarus,1979,Friendly,7,7,2,3,2,7,0,0
Belarus,1992,Friendly,1,1,0,0,1,1,0,0
Belarus,1993,Friendly,2,2,0,0,2,2,0,0
Belarus,1994,Friendly,2,4,0,1,1,2,-2,0
Belarus,1994,UEFA Euro qualification,2,5,1,2,0,3,-3,0
Belarus,1995,Friendly,1,1,0,0,1,1,0,0
Belarus,1995,UEFA Euro qualification,6,8,2,3,2,7,-2,0
Belarus,1996,FIFA World Cup qualification,3,7,1,2,1,4,-4,0
Belarus,1996,Friendly,7,13,0,3,3,6,-6,0
Belarus,1997,FIFA World Cup qualification,2,14,0,6,0,6,-12,0
Belarus,1997,Friendly,2,5,0,2,0,2,-3,0
Belarus,1998,Friendly,8,0,2,0,0,2,8,0
Belarus,1998,UEFA Euro qualification,2,3,0,1,1,2,-1,0
Belarus,1999,Friendly,2,5,0,2,1,3,-3,0
Belarus,1999,UEFA Euro qualification,2,7,0,4,2,6,-5,0
Belarus,2000,FIFA World Cup qualification,5,5,2,1,0,3,0,0
Belarus,2000,Friendly,2,8,1,3,0,4,-6,0
Belarus,2001,FIFA World Cup qualification,7,6,2,2,3,7,1,0
Belarus,2002,Friendly,12,5,3,0,1,4,7,0
Belarus,2002,UEFA Euro qualification,0,7,0,3,0,3,-7,0
Belarus,2003,Friendly,6,4,2,0,1,3,2,0
Belarus,2003,UEFA Euro qualification,4,13,1,4,0,5,-9,0
Belarus,2004,Cyprus International Tournament,6,1,2,0,0,2,5,0
Belarus,2004,FIFA World Cup qualification,8,5,1,1,1,3,3,0
Belarus,2004,Friendly,7,5,3,1,0,4,2,0
Belarus,2005,FIFA World Cup qualification,4,9,1,3,3,7,-5,0
Belarus,2005,Friendly,6,3,2,1,0,3,3,0
Belarus,2006,Cyprus International Tournament,2,3,0,1,1,2,-1,0
Belarus,2006,Friendly,5,6,1,2,1,4,-1,0
Belarus,2006,UEFA Euro qualification,7,10,1,2,1,4,-3,0
Belarus,2007,Friendly,5,5,1,1,1,3,0,0
Belarus,2007,UEFA Euro qualification,10,13,3,5,0,8,-3,0
Belarus,2008,FIFA World Cup qualification,4,5,1,2,0,3,-1,0
Belarus,2008,Friendly,6,7,0,1,4,5,-1,0
Belarus,2008,Malta International Tournament,4,2,2,1,0,3,2,0
Belarus,2009,FIFA World Cup qualification,15,9,3,3,1,7,6,0
Belarus,2009,Friendly,3,4,0,1,2,3,-1,0
Belarus,2010,Friendly,12,4,4,1,1,6,8,0
Belarus,2010,UEFA Euro qualification,3,0,2,0,2,4,3,0
Belarus,2011,Friendly,3,5,1,2,2,5,-2,0
Belarus,2011,UEFA Euro qualification,5,7,1,3,2,6,-2,0
Belarus,2012,FIFA World Cup qualification,3,8,1,3,0,4,-5,0
Belarus,2012,Friendly,5,3,2,0,2,4,2,0
Belarus,2013,FIFA World Cup qualification,4,8,0,3,1,4,-4,0
Belarus,2013,Friendly,11,6,4,2,3,9,5,0
Belarus,2014,Friendly,15,6,3,1,1,5,9,0
Belarus,2014,UEFA Euro qualification,2,9,0,3,1,4,-7,0
Belarus,2015,Friendly,2,4,0,1,1,2,-2,0
Belarus,2015,UEFA Euro qualification,6,5,3,2,1,6,1,0
Belarus,2016,FIFA World Cup qualification,2,6,0,2,2,4,-4,0
Belarus,2016,Friendly,4,4,3,1,2,6,0,0
Belarus,2017,FIFA World Cup qualification,4,15,1,5,0,6,-11,0
Belarus,2017,Friendly,4,10,1,3,1,5,-6,0
Belarus,2017,King's Cup,0,0,0,0,1,1,0,0
Belarus,2018,Friendly,4,3,2,1,1,4,1,0
Belarus,2018,UEFA Nations League,10,0,4,0,2,6,10,0
Belarus,2019,Friendly,0,3,0,2,0,2,-3,0
Belarus,2019,UEFA Euro qualification,4,16,1,6,1,8,-12,0
Belarus,2020,Friendly,3,5,0,1,0,1,-2,0
Belarus,2020,UEFA Euro qualification,0,1,0,1,0,1,-1,0
Belarus,2020,UEFA Nations League,10,8,3,2,1,6,2,0
Belarus,2021,FIFA World Cup qualification,7,24,1,7,0,8,-17,0
Belarus,2021,Friendly,3,3,1,1,1,3,0,0
Belarus,2022,Friendly,5,2,3,1,0,4,3,0
Belarus,2022,UEFA Nations League,3,7,0,3,3,6,-4,0
Belarus,2023,UEFA Euro qualification,9,14,3,4,3,10,-5,0
Belarus,2024,Friendly,0,10,0,3,1,4,-10,0
Belarus,2024,UEFA Nations League,3,4,1,1,4,6,-1,0
Belarus,2025,Friendly,7,0,2,0,0,2,7,0
Belgium,1904,Évence Coppée Trophy,3,3,0,0,1,1,0,0
Belgium,1905,Friendly,8,8,1,2,0,3,0,0
Belgium,1906,Friendly,13,2,3,0,0,3,11,0
Belgium,1907,Friendly,4,6,1,2,0,3,-2,0
Belgium,1908,Friendly,6,9,2,2,0,4,-3,0
Belgium,1909,Friendly,7,10,1,2,0,3,-3,0
Belgium,1910,Friendly,10,9,3,1,0,4,1,0
Belgium,1911,Friendly,11,10,2,2,0,4,1,0
Belgium,1912,Friendly,14,9,1,2,1,4,5,0
Belgium,1913,Friendly,20,9,5,1,1,7,11,1
Belgium,1914,Friendly,7,12,0,3,0,3,-5,0
Belgium,1919,Friendly,2,2,0,0,1,1,0,0
Belgium,1919,Inter-Allied Games,13,6,2,1,0,3,7,0
Belgium,1920,Friendly,1,2,0,1,0,1,-1,0
Belgium,1920,Olympic Games,8,1,3,0,0,3,7,0
Belgium,1921,Friendly,6,7,1,2,1,4,-1,0
Belgium,1922,Friendly,9,7,2,2,1,5,2,0
Belgium,1923,Friendly,9,10,2,1,2,5,-1,0
Belgium,1924,Friendly,6,10,1,3,2,6,-4,0
Belgium,1924,Olympic Games,1,8,0,1,0,1,-7,0
Belgium,1925,Friendly,6,11,1,3,1,5,-5,0
Belgium,1926,Friendly,14,15,1,3,2,6,-1,0
Belgium,1927,Friendly,10,31,2,6,0,8,-21,0
Belgium,1928,Friendly,10,13,2,3,2,7,-3,0
Belgium,1928,Olympic Games,9,12,1,2,0,3,-3,0
Belgium,1929,Friendly,8,11,2,2,0,4,-3,0
Belgium,1930,FIFA World Cup,0,4,0,2,0,2,-4,0
Belgium,1930,Friendly,21,17,3,3,3,9,4,0
Belgium,1931,Friendly,13,14,3,3,0,6,-1,0
Belgium,1932,Friendly,13,20,2,4,0,6,-7,0
Belgium,1933,Friendly,13,27,2,5,2,9,-14,0
Belgium,1934,FIFA World Cup,2,5,0,1,0,1,-3,0
Belgium,1934,FIFA World Cup qualification,6,8,0,1,1,2,-2,0
Belgium,1934,Friendly,5,12,0,2,0,2,-7,0
Belgium,1935,Friendly,11,16,1,3,2,6,-5,0
Belgium,1936,Friendly,5,17,1,3,2,6,-12,0
Belgium,1937,Friendly,8,9,2,4,1,7,-1,0
Belgium,1938,FIFA World Cup,1,3,0,1,0,1,-2,0
Belgium,1938,FIFA World Cup qualification,4,3,1,0,1,2,1,0
Belgium,1938,Friendly,11,20,1,3,1,5,-9,0
Belgium,1939,Friendly,13,19,1,4,1,6,-6,0
Belgium,1940,Friendly,9,5,1,1,0,2,4,0
Belgium,1944,Friendly,1,3,0,1,0,1,-2,0
Belgium,1945,Friendly,3,5,1,1,0,2,-2,1
Belgium,1946,Friendly,14,12,1,2,2,5,2,0
Belgium,1947,Friendly,8,18,1,5,0,6,-10,0
Belgium,1948,Friendly,11,11,1,1,4,6,0,0
Belgium,1949,Friendly,14,10,4,1,2,7,4,0
Belgium,1950,Friendly,23,14,4,2,1,7,9,0
Belgium,1951,Friendly,16,28,1,3,2,6,-12,0
Belgium,1952,Friendly,10,12,4,3,0,7,-2,0
Belgium,1953,FIFA World Cup qualification,11,6,3,0,1,4,5,0
Belgium,1953,Friendly,6,9,1,3,1,5,-3,0
Belgium,1954,FIFA World Cup,5,8,0,1,1,2,-3,0
Belgium,1954,Friendly,17,8,4,0,3,7,9,0
Belgium,1955,Friendly,7,14,1,5,1,7,-7,0
Belgium,1956,FIFA World Cup qualification,3,6,0,1,0,1,-3,0
Belgium,1956,Friendly,9,15,1,4,0,5,-6,0
Belgium,1957,FIFA World Cup qualification,13,5,2,0,1,3,8,0
Belgium,1957,Friendly,5,12,1,2,2,5,-7,0
Belgium,1958,Friendly,8,16,1,4,1,6,-8,0
Belgium,1959,Friendly,7,19,0,3,2,5,-12,0
Belgium,1960,FIFA World Cup qualification,2,6,0,2,0,2,-4,0
Belgium,1960,Friendly,11,12,4,2,1,7,-1,0
Belgium,1961,FIFA World Cup qualification,1,4,0,2,0,2,-3,0
Belgium,1961,Friendly,14,8,3,2,1,6,6,0
Belgium,1962,Friendly,9,8,3,2,1,6,1,0
Belgium,1962,UEFA Euro qualification,2,3,0,1,0,1,-1,0
Belgium,1963,Friendly,11,4,4,0,1,5,7,0
Belgium,1963,UEFA Euro qualification,0,1,0,1,0,1,-1,0
Belgium,1964,Friendly,7,6,2,2,2,6,1,0
Belgium,1965,FIFA World Cup qualification,12,5,3,2,0,5,7,0
Belgium,1965,Friendly,2,5,1,1,1,3,-3,0
Belgium,1966,Friendly,7,7,2,3,0,5,0,0
Belgium,1966,UEFA Euro qualification,2,1,1,0,0,1,1,0
Belgium,1967,Friendly,1,0,1,0,0,1,1,0
Belgium,1967,UEFA Euro qualification,12,8,2,2,1,5,4,0
Belgium,1968,FIFA World Cup qualification,12,3,3,0,1,4,9,0
Belgium,1968,Friendly,5,5,2,2,0,4,0,0
Belgium,1969,FIFA World Cup qualification,2,5,1,1,0,2,-3,0
Belgium,1969,Friendly,2,1,1,1,0,2,1,0
Belgium,1970,FIFA World Cup,4,5,1,2,0,3,-1,0
Belgium,1970,Friendly,2,5,0,2,0,2,-3,0
Belgium,1970,UEFA Euro qualification,2,0,1,0,0,1,2,0
Belgium,1971,Friendly,5,0,2,0,0,2,5,0
Belgium,1971,UEFA Euro qualification,9,3,3,1,1,5,6,0
Belgium,1972,FIFA World Cup qualification,10,0,3,0,1,4,10,0
Belgium,1972,UEFA Euro,3,3,1,1,0,2,0,0
Belgium,1972,UEFA Euro qualification,2,1,1,0,1,2,1,0
Belgium,1973,FIFA World Cup qualification,2,0,1,0,1,2,2,0
Belgium,1973,Friendly,3,0,1,0,0,1,3,0
Belgium,1974,Friendly,4,3,2,1,1,4,1,0
Belgium,1974,UEFA Euro qualification,4,1,2,0,1,3,3,0
Belgium,1975,Friendly,1,0,1,0,0,1,1,0
Belgium,1975,UEFA Euro qualification,2,2,1,1,1,3,0,0
Belgium,1976,FIFA World Cup qualification,3,0,2,0,0,2,3,0
Belgium,1976,UEFA Euro qualification,1,7,0,2,0,2,-6,0
Belgium,1977,FIFA World Cup qualification,4,6,1,3,0,4,-2,0
Belgium,1977,Friendly,1,3,0,2,0,2,-2,0
Belgium,1978,Friendly,1,1,1,1,1,3,0,0
Belgium,1978,UEFA Euro qualification,2,2,0,0,2,2,0,0
Belgium,1979,Friendly,0,1,0,1,0,1,-1,0
Belgium,1979,UEFA Euro qualification,10,3,4,0,2,6,7,0
Belgium,1980,FIFA World Cup qualification,4,1,2,0,1,3,3,0
Belgium,1980,Friendly,11,2,4,0,0,4,9,0
Belgium,1980,UEFA Euro,4,4,1,1,2,4,0,0
Belgium,1981,FIFA World Cup qualification,8,8,3,2,0,5,0,0
Belgium,1981,Friendly,0,2,0,1,0,1,-2,0
Belgium,1982,FIFA World Cup,3,5,2,2,1,5,-2,0
Belgium,1982,Friendly,6,3,2,1,1,4,3,0
Belgium,1982,UEFA Euro qualification,6,2,2,0,0,2,4,0
Belgium,1983,Friendly,2,2,0,0,2,2,0,0
Belgium,1983,UEFA Euro qualification,6,6,2,1,1,4,0,0
Belgium,1984,FIFA World Cup qualification,3,3,1,1,1,3,0,0
Belgium,1984,Friendly,3,5,1,2,1,4,-2,0
Belgium,1984,UEFA Euro,4,8,1,2,0,3,-4,0
Belgium,1985,FIFA World Cup qualification,6,2,3,1,1,5,4,0
Belgium,1986,FIFA World Cup,12,15,2,3,2,7,-3,0
Belgium,1986,Friendly,3,6,1,2,0,3,-3,0
Belgium,1986,UEFA Euro qualification,9,3,1,0,2,3,6,0
Belgium,1987,Friendly,0,1,0,1,1,2,-1,0
Belgium,1987,UEFA Euro qualification,7,5,2,2,1,5,2,0
Belgium,1988,FIFA World Cup qualification,1,0,1,0,1,2,1,0
Belgium,1988,Friendly,8,7,2,2,0,4,1,0
Belgium,1989,FIFA World Cup qualification,14,5,3,0,3,6,9,0
Belgium,1989,Friendly,6,0,3,0,0,3,6,0
Belgium,1990,FIFA World Cup,6,4,2,2,0,4,2,0
Belgium,1990,Friendly,6,7,1,2,3,6,-1,0
Belgium,1990,UEFA Euro qualification,1,3,0,1,0,1,-2,0
Belgium,1991,Friendly,2,0,1,0,1,2,2,0
Belgium,1991,UEFA Euro qualification,6,3,2,2,1,5,3,0
Belgium,1992,FIFA World Cup qualification,9,1,5,0,0,5,8,0
Belgium,1992,Friendly,4,5,0,1,1,2,-1,0
Belgium,1993,FIFA World Cup qualification,7,4,2,2,1,5,3,0
Belgium,1993,Friendly,2,1,1,0,0,1,1,0
Belgium,1994,FIFA World Cup,4,4,2,2,0,4,0,0
Belgium,1994,Friendly,3,2,1,1,0,2,1,0
Belgium,1994,UEFA Euro qualification,5,8,1,2,1,4,-3,0
Belgium,1995,Friendly,2,2,1,1,0,2,0,0
Belgium,1995,UEFA Euro qualification,12,5,3,1,2,6,7,0
Belgium,1996,FIFA World Cup qualification,5,4,2,1,0,3,1,0
Belgium,1996,Friendly,2,4,0,1,2,3,-2,0
Belgium,1997,FIFA World Cup qualification,18,9,5,1,1,7,9,0
Belgium,1997,Friendly,0,3,0,1,0,1,-3,0
Belgium,1998,FIFA World Cup,3,3,0,0,3,3,0,0
Belgium,1998,Friendly,8,3,3,0,3,6,5,0
Belgium,1998,King Hassan II Tournament,0,1,0,1,1,2,-1,0
Belgium,1999,Cyprus International Tournament,1,1,1,1,0,2,0,0
Belgium,1999,Friendly,18,17,3,6,1,10,1,0
Belgium,1999,Kirin Cup,1,1,0,0,2,2,0,0
Belgium,2000,FIFA World Cup qualification,4,0,1,0,1,2,4,0
Belgium,2000,Friendly,10,6,2,0,3,5,4,0
Belgium,2000,UEFA Euro,2,5,1,2,0,3,-3,0
Belgium,2001,FIFA World Cup qualification,23,6,6,1,1,8,17,0
Belgium,2001,Friendly,2,5,0,1,1,2,-3,0
Belgium,2002,FIFA World Cup,6,7,1,1,2,4,-1,0
Belgium,2002,Friendly,6,3,3,0,3,6,3,0
Belgium,2002,UEFA Euro qualification,2,2,2,1,0,3,0,0
Belgium,2003,Friendly,7,3,2,0,1,3,4,0
Belgium,2003,UEFA Euro qualification,9,7,3,1,1,5,2,0
Belgium,2004,FIFA World Cup qualification,1,5,0,2,1,3,-4,0
Belgium,2004,Friendly,5,10,1,3,1,5,-5,0
Belgium,2005,FIFA World Cup qualification,15,6,3,2,2,7,9,0
Belgium,2005,Friendly,2,4,1,1,0,2,-2,0
Belgium,2006,Friendly,8,5,2,0,2,4,3,0
Belgium,2006,UEFA Euro qualification,4,2,2,2,1,5,2,0
Belgium,2007,Friendly,0,2,0,1,0,1,-2,0
Belgium,2007,UEFA Euro qualification,10,14,3,4,2,9,-4,0
Belgium,2008,FIFA World Cup qualification,7,5,2,1,1,4,2,0
Belgium,2008,Friendly,3,10,0,3,1,4,-7,0
Belgium,2009,FIFA World Cup qualification,6,15,1,5,0,6,-9,0
Belgium,2009,Friendly,8,3,3,1,0,4,5,0
Belgium,2009,Kirin Cup,1,5,0,1,1,2,-4,0
Belgium,2010,Friendly,4,3,2,2,0,4,1,0
Belgium,2010,UEFA Euro qualification,8,8,1,2,1,4,0,0
Belgium,2011,Friendly,4,2,2,0,3,5,2,0
Belgium,2011,UEFA Euro qualification,13,7,3,1,2,6,6,0
Belgium,2012,FIFA World Cup qualification,8,1,3,0,1,4,7,0
Belgium,2012,Friendly,8,8,1,2,2,5,0,0
Belgium,2013,FIFA World Cup qualification,10,3,5,0,1,6,7,0
Belgium,2013,Friendly,8,8,2,2,1,5,0,0
Belgium,2014,FIFA World Cup,6,3,4,1,0,5,3,0
Belgium,2014,Friendly,15,4,5,0,1,6,11,0
Belgium,2014,UEFA Euro qualification,7,1,1,0,2,3,6,0
Belgium,2015,Friendly,7,4,2,0,0,2,3,0
Belgium,2015,UEFA Euro qualification,17,4,6,1,0,7,13,0
Belgium,2016,FIFA World Cup qualification,21,1,4,0,0,4,20,0
Belgium,2016,Friendly,8,9,2,2,2,6,-1,0
Belgium,2016,UEFA Euro,9,5,3,2,0,5,4,0
Belgium,2017,FIFA World Cup qualification,22,5,5,0,1,6,17,0
Belgium,2017,Friendly,9,7,2,0,2,4,2,0
Belgium,2018,FIFA World Cup,16,6,6,1,0,7,10,0
Belgium,2018,Friendly,16,2,4,0,2,6,14,0
Belgium,2018,UEFA Nations League,9,6,3,1,0,4,3,0
Belgium,2019,UEFA Euro qualification,40,3,10,0,0,10,37,0
Belgium,2020,Friendly,3,2,1,0,1,2,1,0
Belgium,2020,UEFA Nations League,16,6,5,1,0,6,10,0
Belgium,2021,FIFA World Cup qualification,25,6,6,0,2,8,19,0
Belgium,2021,Friendly,2,1,1,0,1,2,1,0
Belgium,2021,UEFA Euro,9,3,4,1,0,5,6,0
Belgium,2021,UEFA Nations League,3,5,0,2,0,2,-2,0
Belgium,2022,FIFA World Cup,1,2,1,1,1,3,-1,0
Belgium,2022,Friendly,6,4,1,1,1,3,2,0
Belgium,2022,UEFA Nations League,11,8,3,2,1,6,3,0
Belgium,2023,Friendly,4,2,2,0,0,2,2,0
Belgium,2023,UEFA Euro qualification,22,4,6,0,2,8,18,0
Belgium,2024,Friendly,7,2,2,0,2,4,5,0
Belgium,2024,UEFA Euro,2,2,1,2,1,4,0,0
Belgium,2024,UEFA Nations League,6,9,1,4,1,6,-3,0
Belgium,2025,UEFA Nations League,4,3,1,1,0,2,1,0
Belize,1983,Friendly,0,2,0,1,0,1,-2,0
Belize,1995,UNCAF Cup,1,5,0,2,0,2,-4,0
Belize,1996,FIFA World Cup qualification,2,6,0,2,0,2,-4,0
Belize,1997,UNCAF Cup,1,2,0,1,1,2,-1,0
Belize,1999,UNCAF Cup,1,12,0,2,0,2,-11,0
Belize,2000,FIFA World Cup qualification,2,10,0,3,1,4,-8,0
Belize,2001,Friendly,7,3,3,0,0,3,4,0
Belize,2001,UNCAF Cup,3,7,0,1,1,2,-4,0
Belize,2002,Friendly,10,2,2,0,0,2,8,0
Belize,2004,FIFA World Cup qualification,0,8,0,2,0,2,-8,0
Belize,2005,UNCAF Cup,0,7,0,3,0,3,-7,0
Belize,2007,UNCAF Cup,3,7,0,3,0,3,-4,0
Belize,2008,FIFA World Cup qualification,4,11,1,2,1,4,-7,0
Belize,2008,Friendly,0,3,0,2,0,2,-3,0
Belize,2009,UNCAF Cup,3,7,0,2,1,3,-4,0
Belize,2010,Friendly,2,4,0,1,1,2,-2,0
Belize,2011,FIFA World Cup qualification,17,13,4,3,1,8,4,0
Belize,2011,UNCAF Cup,3,8,0,2,1,3,-5,0
Belize,2013,Friendly,0,0,0,0,2,2,0,0
Belize,2013,Gold Cup,1,11,0,3,0,3,-10,0
Belize,2013,UNCAF Cup,2,4,1,3,1,5,-2,0
Belize,2015,FIFA World Cup qualification,7,6,2,1,2,5,1,0
Belize,2016,Friendly,1,2,0,1,0,1,-1,0
Belize,2017,UNCAF Cup,2,10,0,4,0,4,-8,0
Belize,2018,CONCACAF Nations League qualification,5,1,2,1,0,3,4,0
Belize,2018,Friendly,5,2,2,0,1,3,3,0
Belize,2019,CONCACAF Nations League,6,12,2,4,0,6,-6,0
Belize,2019,CONCACAF Nations League qualification,1,2,0,1,0,1,-1,0
Belize,2019,Friendly,2,1,1,0,1,2,1,0
Belize,2021,FIFA World Cup qualification,5,5,1,2,0,3,0,0
Belize,2022,CONCACAF Nations League,1,6,0,3,1,4,-5,0
Belize,2022,Friendly,1,8,0,2,1,3,-7,0
Belize,2023,CONCACAF Nations League,6,11,2,5,1,8,-5,0
Belize,2024,CONCACAF Nations League,13,3,5,0,1,6,10,0
Belize,2024,FIFA World Cup qualification,1,7,0,2,0,2,-6,0
Belize,2024,Friendly,4,1,1,0,1,2,3,0
Belize,2025,Gold Cup qualification,1,13,0,2,0,2,-12,0
Benin,1959,Friendly,1,11,0,2,0,2,-10,0
Benin,1960,African Friendship Games,2,3,0,1,0,1,-1,0
Benin,1960,Friendly,2,3,0,1,0,1,-1,0
Benin,1961,African Friendship Games,14,4,3,0,0,3,10,1
Benin,1963,African Friendship Games,7,3,2,1,0,3,4,0
Benin,1963,Friendly,2,5,0,1,1,2,-3,0
Benin,1964,Friendly,4,2,1,0,0,1,2,0
Benin,1965,Friendly,7,1,2,0,0,2,6,0
Benin,1966,Friendly,5,10,0,3,1,4,-5,0
Benin,1967,Friendly,5,7,1,1,1,3,-2,0
Benin,1968,Friendly,2,8,0,2,0,2,-6,0
Benin,1969,Friendly,2,1,1,0,1,2,1,0
Benin,1970,African Cup of Nations qualification,1,2,0,1,1,2,-1,0
Benin,1970,Friendly,3,2,1,0,0,1,1,0
Benin,1972,FIFA World Cup qualification,1,10,0,2,0,2,-9,0
Benin,1972,Friendly,7,12,1,2,1,4,-5,0
Benin,1974,Friendly,2,0,1,0,0,1,2,0
Benin,1977,Friendly,0,7,0,1,0,1,-7,0
Benin,1978,Friendly,0,5,0,2,0,2,-5,0
Benin,1979,African Cup of Nations qualification,2,4,1,1,0,2,-2,0
Benin,1979,Friendly,5,17,1,6,1,8,-12,0
Benin,1980,Friendly,1,0,1,0,0,1,1,0
Benin,1981,Friendly,2,4,0,2,0,2,-2,0
Benin,1982,Friendly,4,6,0,2,1,3,-2,0
Benin,1982,West African Cup,5,7,1,1,1,3,-2,0
Benin,1983,African Cup of Nations qualification,8,8,1,1,0,2,0,0
Benin,1983,Friendly,1,7,0,3,1,4,-6,0
Benin,1984,African Cup of Nations qualification,2,3,0,1,1,2,-1,0
Benin,1984,FIFA World Cup qualification,0,6,0,2,0,2,-6,0
Benin,1984,Friendly,5,3,2,1,0,3,2,0
Benin,1984,West African Cup,3,9,0,4,0,4,-6,0
Benin,1987,Friendly,1,1,0,0,2,2,0,0
Benin,1987,West African Cup,2,3,0,1,1,2,-1,0
Benin,1988,Friendly,1,2,0,1,0,1,-1,0
Benin,1988,Tournament Burkina Faso,1,8,0,3,1,4,-7,0
Benin,1990,African Cup of Nations qualification,1,4,0,2,1,3,-3,0
Benin,1991,African Cup of Nations qualification,1,11,0,4,1,5,-10,0
Benin,1991,Friendly,2,5,1,2,0,3,-3,0
Benin,1992,African Cup of Nations qualification,1,4,0,2,0,2,-3,0
Benin,1992,FIFA World Cup qualification,2,9,0,3,0,3,-7,0
Benin,1993,African Cup of Nations qualification,2,11,0,4,0,4,-9,0
Benin,1993,FIFA World Cup qualification,1,10,1,2,0,3,-9,0
Benin,1993,Friendly,2,2,0,0,1,1,0,0
Benin,1995,Friendly,0,10,0,2,0,2,-10,0
Benin,1996,African Cup of Nations qualification,5,3,1,1,1,3,2,0
Benin,1996,Friendly,5,7,0,1,4,5,-2,0
Benin,1997,African Cup of Nations qualification,2,7,0,3,2,5,-5,0
Benin,1997,Friendly,1,1,0,0,1,1,0,0
Benin,1998,African Cup of Nations qualification,2,3,1,1,0,2,-1,0
Benin,1998,Friendly,2,2,1,1,1,3,0,0
Benin,2000,African Cup of Nations qualification,4,8,1,1,0,2,-4,0
Benin,2000,FIFA World Cup qualification,1,2,0,1,1,2,-1,0
Benin,2000,Friendly,1,2,0,1,0,1,-1,0
Benin,2001,Amílcar Cabral Cup,4,7,1,1,1,3,-3,0
Benin,2001,Friendly,2,4,0,1,1,2,-2,0
Benin,2002,African Cup of Nations qualification,5,1,1,0,1,2,4,0
Benin,2002,Friendly,0,4,0,1,0,1,-4,0
Benin,2003,African Cup of Nations qualification,7,3,3,1,0,4,4,0
Benin,2003,FIFA World Cup qualification,4,3,1,0,1,2,1,0
Benin,2003,Friendly,4,12,2,4,0,6,-8,0
Benin,2003,TIFOCO Tournament,1,1,0,0,1,1,0,0
Benin,2004,African Cup of Nations,1,8,0,3,0,3,-7,0
Benin,2004,FIFA World Cup qualification,6,11,0,3,2,5,-5,0
Benin,2004,Friendly,5,12,1,5,1,7,-7,0
Benin,2005,FIFA World Cup qualification,3,12,1,4,0,5,-9,0
Benin,2005,Friendly,0,0,0,0,1,1,0,0
Benin,2006,African Cup of Nations qualification,3,2,1,1,0,2,1,0
Benin,2006,Friendly,0,2,0,1,0,1,-2,0
Benin,2007,African Cup of Nations qualification,7,2,2,0,2,4,5,0
Benin,2007,Friendly,6,9,1,3,1,5,-3,0
Benin,2008,African Cup of Nations,1,7,0,3,0,3,-6,0
Benin,2008,FIFA World Cup qualification,12,8,4,2,0,6,4,0
Benin,2008,Friendly,3,10,0,3,0,3,-7,0
Benin,2009,FIFA World Cup qualification,6,6,3,2,1,6,0,0
Benin,2009,Friendly,2,3,0,1,1,2,-1,0
Benin,2010,African Cup of Nations,2,5,0,2,1,3,-3,0
Benin,2010,African Cup of Nations qualification,4,1,1,0,1,2,3,0
Benin,2010,Friendly,1,2,1,1,1,3,-1,0
Benin,2011,African Cup of Nations qualification,4,10,0,3,1,4,-6,0
Benin,2011,Friendly,2,3,0,1,0,1,-1,0
Benin,2012,African Cup of Nations qualification,1,1,0,0,2,2,0,0
Benin,2012,FIFA World Cup qualification,2,1,1,0,1,2,1,0
Benin,2012,Friendly,2,4,0,1,1,2,-2,0
Benin,2013,FIFA World Cup qualification,6,8,1,2,1,4,-2,0
Benin,2014,African Cup of Nations qualification,5,1,3,1,0,4,4,0
Benin,2014,Friendly,2,10,0,2,0,2,-8,0
Benin,2015,African Cup of Nations qualification,2,2,0,0,2,2,0,0
Benin,2015,FIFA World Cup qualification,2,3,1,1,0,2,-1,0
Benin,2015,Friendly,1,2,0,1,0,1,-1,0
Benin,2016,African Cup of Nations qualification,10,8,3,1,0,4,2,0
Benin,2017,African Cup of Nations qualification,1,0,1,0,0,1,1,0
Benin,2017,Friendly,10,9,2,1,6,9,1,0
Benin,2018,African Cup of Nations qualification,2,5,1,2,1,4,-3,0
Benin,2019,African Cup of Nations,3,4,0,1,4,5,-1,0
Benin,2019,African Cup of Nations qualification,4,3,2,1,0,3,1,0
Benin,2019,Friendly,8,5,3,1,1,5,3,0
Benin,2020,African Cup of Nations qualification,1,0,1,0,1,2,1,0
Benin,2020,Friendly,2,0,1,0,0,1,2,0
Benin,2021,African Cup of Nations qualification,0,2,0,2,0,2,-2,0
Benin,2021,FIFA World Cup qualification,5,4,3,2,1,6,1,0
Benin,2021,Friendly,2,2,0,0,1,1,0,0
Benin,2022,African Cup of Nations qualification,1,4,0,2,0,2,-3,0
Benin,2022,Friendly,8,6,2,2,1,5,2,0
Benin,2023,African Cup of Nations qualification,5,6,0,1,3,4,-1,0
Benin,2023,FIFA World Cup qualification,1,2,0,1,1,2,-1,0
Benin,2023,Friendly,2,3,0,1,1,2,-1,0
Benin,2024,African Cup of Nations qualification,6,6,2,2,0,4,0,0
Benin,2024,FIFA World Cup qualification,3,1,2,0,0,2,2,0
Benin,2024,Friendly,2,3,0,1,1,2,-1,0
Benin,2025,FIFA World Cup qualification,2,4,0,1,1,2,-2,0
Bermuda,1964,Friendly,3,4,0,1,0,1,-1,0
Bermuda,1965,Friendly,0,3,0,1,0,1,-3,0
Bermuda,1968,FIFA World Cup qualification,2,12,0,3,1,4,-10,0
Bermuda,1969,CONCACAF Championship qualification,2,4,1,1,0,2,-2,0
Bermuda,1969,Friendly,5,18,1,4,0,5,-13,0
Bermuda,1970,Friendly,1,1,0,0,1,1,0,0
Bermuda,1971,CONCACAF Championship qualification,0,6,0,2,0,2,-6,0
Bermuda,1972,Friendly,0,3,0,1,1,2,-3,0
Bermuda,1973,Friendly,4,1,1,1,0,2,3,0
Bermuda,1974,Friendly,3,4,1,1,1,3,-1,0
Bermuda,1975,Friendly,3,10,0,2,0,2,-7,0
Bermuda,1979,Friendly,1,5,0,2,0,2,-4,0
Bermuda,1982,Friendly,9,12,0,2,4,6,-3,0
Bermuda,1988,Friendly,0,0,0,0,1,1,0,0
Bermuda,1989,Friendly,6,6,2,2,1,5,0,0
Bermuda,1990,CFU Caribbean Cup qualification,5,3,1,0,2,3,2,0
Bermuda,1990,Friendly,6,5,2,2,0,4,1,0
Bermuda,1991,Friendly,2,1,1,0,1,2,1,0
Bermuda,1992,FIFA World Cup qualification,14,15,4,4,2,10,-1,0
Bermuda,1992,Friendly,1,3,0,1,1,2,-2,0
Bermuda,1997,CFU Caribbean Cup qualification,2,4,0,2,0,2,-2,0
Bermuda,1997,Friendly,2,1,1,0,0,1,1,0
Bermuda,1998,CFU Caribbean Cup qualification,1,4,0,2,0,2,-3,0
Bermuda,1999,CFU Caribbean Cup qualification,11,3,2,1,0,3,8,0
Bermuda,1999,Friendly,5,2,3,1,0,4,3,0
Bermuda,2000,FIFA World Cup qualification,15,2,2,0,2,4,13,0
Bermuda,2000,Friendly,0,2,0,1,0,1,-2,0
Bermuda,2001,Friendly,0,5,0,1,0,1,-5,0
Bermuda,2003,Friendly,1,2,0,1,0,1,-1,0
Bermuda,2004,CFU Caribbean Cup qualification,2,3,1,1,0,2,-1,0
Bermuda,2004,FIFA World Cup qualification,23,4,2,1,1,4,19,0
Bermuda,2004,Friendly,8,16,2,5,1,8,-8,0
Bermuda,2005,Friendly,0,5,0,2,0,2,-5,0
Bermuda,2006,CFU Caribbean Cup qualification,14,2,3,0,1,4,12,0
Bermuda,2007,CFU Caribbean Cup qualification,0,5,0,2,0,2,-5,0
Bermuda,2007,Friendly,5,7,1,2,0,3,-2,0
Bermuda,2007,Island Games,3,5,1,3,0,4,-2,0
Bermuda,2008,CFU Caribbean Cup qualification,7,4,1,1,1,3,3,0
Bermuda,2008,FIFA World Cup qualification,6,5,2,1,1,4,1,0
Bermuda,2008,Friendly,5,4,2,2,0,4,1,0
Bermuda,2011,FIFA World Cup qualification,8,7,3,2,1,6,1,0
Bermuda,2012,CFU Caribbean Cup qualification,10,5,1,2,0,3,5,0
Bermuda,2013,Island Games,20,0,4,0,0,4,20,1
Bermuda,2015,FIFA World Cup qualification,8,1,2,1,1,4,7,0
Bermuda,2015,Friendly,2,0,1,0,0,1,2,0
Bermuda,2016,CFU Caribbean Cup qualification,3,6,1,2,0,3,-3,0
Bermuda,2017,Friendly,6,8,1,2,0,3,-2,0
Bermuda,2018,CONCACAF Nations League qualification,14,3,2,1,0,3,11,0
Bermuda,2018,Friendly,2,3,0,1,1,2,-1,0
Bermuda,2019,CONCACAF Nations League,5,11,1,3,0,4,-6,0
Bermuda,2019,CONCACAF Nations League qualification,3,1,1,0,0,1,2,1
Bermuda,2019,Friendly,1,5,1,1,1,3,-4,0
Bermuda,2019,Gold Cup,4,4,1,2,0,3,0,0
Bermuda,2021,FIFA World Cup qualification,7,12,1,2,1,4,-5,0
Bermuda,2021,Gold Cup qualification,9,5,1,1,0,2,4,0
Bermuda,2022,CONCACAF Nations League,3,5,0,2,1,3,-2,0
Bermuda,2023,CONCACAF Nations League,9,14,2,4,2,8,-5,0
Bermuda,2024,CONCACAF Nations League,15,13,4,2,0,6,2,0
Bermuda,2024,FIFA Series,3,5,1,1,0,2,-2,0
Bermuda,2024,FIFA World Cup qualification,2,7,0,1,1,2,-5,0
Bermuda,2025,Gold Cup qualification,3,7,0,2,0,2,-4,0
Bhutan,1982,Friendly,1,3,0,1,0,1,-2,0
Bhutan,1984,South Asian Games,0,8,0,3,0,3,-8,0
Bhutan,1985,South Asian Games,0,4,0,2,0,2,-4,0
Bhutan,1986,Friendly,0,4,0,1,0,1,-4,0
Bhutan,1987,South Asian Games,2,9,0,2,0,2,-7,0
Bhutan,1999,South Asian Games,1,12,0,3,0,3,-11,0
Bhutan,2000,AFC Asian Cup qualification,2,42,0,4,0,4,-40,0
Bhutan,2001,Friendly,1,3,0,1,0,1,-2,0
Bhutan,2002,The Other Final,4,0,1,0,0,1,4,1
Bhutan,2003,AFC Asian Cup qualification,6,26,1,6,1,8,-20,0
Bhutan,2003,SAFF Cup,0,11,0,3,0,3,-11,0
Bhutan,2005,SAFF Cup,1,9,0,3,0,3,-8,0
Bhutan,2006,AFC Challenge Cup,0,3,0,2,1,3,-3,0
Bhutan,2007,Friendly,3,0,1,0,0,1,3,0
Bhutan,2008,AFC Challenge Cup qualification,2,7,0,2,1,3,-5,0
Bhutan,2008,SAFF Cup,5,6,1,2,1,4,-1,0
Bhutan,2009,AFC Challenge Cup qualification,0,13,0,3,0,3,-13,0
Bhutan,2009,SAFF Cup,1,17,0,3,0,3,-16,0
Bhutan,2011,AFC Challenge Cup qualification,0,5,0,2,0,2,-5,0
Bhutan,2011,Friendly,1,3,0,2,0,2,-2,0
Bhutan,2011,SAFF Cup,1,16,0,3,0,3,-15,0
Bhutan,2012,Friendly,0,5,0,1,0,1,-5,0
Bhutan,2013,SAFF Cup,4,16,0,3,0,3,-12,0
Bhutan,2015,FIFA World Cup qualification,6,49,2,7,0,9,-43,0
Bhutan,2015,Friendly,0,2,0,1,0,1,-2,0
Bhutan,2015,SAFF Cup,1,9,0,3,0,3,-8,0
Bhutan,2016,AFC Asian Cup qualification,3,1,1,0,1,2,2,0
Bhutan,2016,FIFA World Cup qualification,2,4,0,1,0,1,-2,0
Bhutan,2016,Friendly,0,3,0,1,0,1,-3,0
Bhutan,2017,AFC Asian Cup qualification,2,32,0,5,0,5,-30,0
Bhutan,2018,AFC Asian Cup qualification,0,7,0,1,0,1,-7,0
Bhutan,2018,Friendly,0,7,0,1,0,1,-7,0
Bhutan,2018,SAFF Cup,0,9,0,3,0,3,-9,0
Bhutan,2019,FIFA World Cup qualification,1,5,1,1,0,2,-4,0
Bhutan,2019,Friendly,1,6,0,2,0,2,-5,0
Bhutan,2023,FIFA World Cup qualification,2,4,1,1,0,2,-2,0
Bhutan,2023,Friendly,1,0,1,0,0,1,1,0
Bhutan,2023,SAFF Cup,2,9,0,3,0,3,-7,0
Bhutan,2023,Tri Nation Tournament,2,3,0,1,1,2,-1,0
Bhutan,2024,FIFA Series,0,8,0,2,0,2,-8,0
Bhutan,2024,Friendly,1,1,1,1,0,2,0,0
Bhutan,2025,AFC Asian Cup qualification,0,0,0,0,1,1,0,0
Biafra,2022,CONIFA Africa Football Cup,2,1,2,1,0,3,1,1
Bolivia,1926,Copa América,2,24,0,4,0,4,-22,0
Bolivia,1927,Copa América,3,19,0,3,0,3,-16,0
Bolivia,1930,FIFA World Cup,0,8,0,2,0,2,-8,0
Bolivia,1938,Bolivarian Games,8,7,3,1,1,5,1,1
Bolivia,1945,Copa América,3,16,0,4,2,6,-13,0
Bolivia,1946,Copa América,4,23,0,5,0,5,-19,0
Bolivia,1947,Bolivarian Games,2,2,0,0,1,1,0,0
Bolivia,1947,Copa América,6,21,0,5,2,7,-15,0
Bolivia,1949,Copa América,13,24,4,3,0,7,-11,0
Bolivia,1950,FIFA World Cup,0,8,0,1,0,1,-8,0
Bolivia,1950,Friendly,2,5,1,1,0,2,-3,0
Bolivia,1953,Copa América,6,15,1,3,2,6,-9,0
Bolivia,1957,Copa Paz del Chaco,8,9,2,1,1,4,-1,1
Bolivia,1957,FIFA World Cup qualification,6,6,2,2,0,4,0,0
Bolivia,1959,Copa América,4,23,0,5,1,6,-19,0
Bolivia,1961,FIFA World Cup qualification,2,3,0,1,1,2,-1,0
Bolivia,1962,Copa Paz del Chaco,6,3,2,0,0,2,3,1
Bolivia,1963,Copa América,19,13,5,0,1,6,6,0
Bolivia,1963,Copa Paz del Chaco,1,8,0,2,0,2,-7,0
Bolivia,1965,FIFA World Cup qualification,4,9,1,3,0,4,-5,0
Bolivia,1967,Copa América,0,9,0,4,1,5,-9,0
Bolivia,1969,FIFA World Cup qualification,5,6,2,2,0,4,-1,0
Bolivia,1971,Friendly,3,4,0,1,0,1,-1,0
Bolivia,1972,Brazil Independence Cup,4,12,0,2,2,4,-8,0
Bolivia,1973,FIFA World Cup qualification,1,11,0,4,0,4,-10,0
Bolivia,1973,Friendly,6,14,1,3,3,7,-8,0
Bolivia,1975,Copa América,3,9,1,3,0,4,-6,0
Bolivia,1975,Friendly,3,4,1,2,0,3,-1,0
Bolivia,1977,Copa Paz del Chaco,2,3,0,1,1,2,-1,0
Bolivia,1977,FIFA World Cup qualification,10,25,3,4,1,8,-15,0
Bolivia,1977,Friendly,1,2,0,1,0,1,-1,0
Bolivia,1979,Copa América,4,7,2,2,0,4,-3,0
Bolivia,1979,Copa Paz del Chaco,3,3,1,1,0,2,0,0
Bolivia,1979,Friendly,1,1,0,0,1,1,0,0
Bolivia,1980,Copa Paz del Chaco,2,3,0,1,1,2,-1,0
Bolivia,1980,Friendly,7,14,1,4,1,6,-7,0
Bolivia,1981,FIFA World Cup qualification,5,6,1,3,0,4,-1,0
Bolivia,1981,Friendly,1,3,0,1,0,1,-2,0
Bolivia,1983,Copa América,4,6,0,2,2,4,-2,0
Bolivia,1983,Friendly,6,10,1,3,0,4,-4,0
Bolivia,1985,FIFA World Cup qualification,2,7,0,2,2,4,-5,0
Bolivia,1985,Friendly,6,8,2,3,1,6,-2,0
Bolivia,1987,Copa América,0,2,0,1,1,2,-2,0
Bolivia,1987,Friendly,1,4,0,2,0,2,-3,0
Bolivia,1989,Copa América,0,8,0,2,2,4,-8,0
Bolivia,1989,FIFA World Cup qualification,6,5,3,1,0,4,1,0
Bolivia,1989,Friendly,4,8,1,4,1,6,-4,0
Bolivia,1991,Copa América,2,7,0,2,2,4,-5,0
Bolivia,1991,Copa Paz del Chaco,0,1,0,1,1,2,-1,0
Bolivia,1993,Copa América,1,2,0,1,2,3,-1,0
Bolivia,1993,Copa Paz del Chaco,2,2,1,1,0,2,0,1
Bolivia,1993,FIFA World Cup qualification,22,11,5,2,1,8,11,0
Bolivia,1993,Friendly,8,12,1,4,4,9,-4,0
Bolivia,1993,Nehru Cup,2,4,0,2,0,2,-2,0
Bolivia,1994,FIFA World Cup,1,4,0,2,1,3,-3,0
Bolivia,1994,Friendly,7,9,3,3,5,11,-2,0
Bolivia,1994,Joe Robbie Cup,1,3,0,1,1,2,-2,0
Bolivia,1995,Copa América,5,6,1,2,1,4,-1,0
Bolivia,1995,Copa Paz del Chaco,1,1,0,0,2,2,0,0
Bolivia,1995,Friendly,6,7,1,1,2,4,-1,0
Bolivia,1996,FIFA World Cup qualification,9,7,1,2,3,6,2,0
Bolivia,1996,Friendly,12,12,3,3,2,8,0,0
Bolivia,1996,USA Cup,2,4,1,2,0,3,-2,0
Bolivia,1997,Copa América,10,5,5,1,0,6,5,0
Bolivia,1997,FIFA World Cup qualification,9,14,3,5,2,10,-5,0
Bolivia,1997,Friendly,6,1,1,1,0,2,5,0
Bolivia,1999,Confederations Cup,2,3,0,1,2,3,-1,0
Bolivia,1999,Copa América,1,2,0,1,2,3,-1,0
Bolivia,1999,Copa Paz del Chaco,0,0,0,0,1,1,0,0
Bolivia,1999,Friendly,4,5,1,2,4,7,-1,0
Bolivia,1999,USA Cup,2,4,0,2,0,2,-2,0
Bolivia,2000,FIFA World Cup qualification,5,14,2,5,3,10,-9,0
Bolivia,2000,Friendly,9,3,1,1,1,3,6,0
Bolivia,2000,Kirin Cup,0,4,0,2,0,2,-4,0
Bolivia,2001,Copa América,0,7,0,3,0,3,-7,0
Bolivia,2001,FIFA World Cup qualification,16,19,2,3,3,8,-3,0
Bolivia,2002,Friendly,3,13,0,4,1,5,-10,0
Bolivia,2003,FIFA World Cup qualification,5,10,1,3,0,4,-5,0
Bolivia,2003,Friendly,4,6,2,2,0,4,-2,0
Bolivia,2004,Copa América,3,4,0,1,2,3,-1,0
Bolivia,2004,FIFA World Cup qualification,6,10,2,4,1,7,-4,0
Bolivia,2004,Friendly,0,1,0,1,0,1,-1,0
Bolivia,2005,FIFA World Cup qualification,9,17,1,5,1,7,-8,0
Bolivia,2006,Friendly,5,1,1,0,0,1,4,0
Bolivia,2007,Copa América,4,5,0,1,2,3,-1,0
Bolivia,2007,FIFA World Cup qualification,3,13,0,3,1,4,-10,0
Bolivia,2007,Friendly,2,4,1,2,2,5,-2,0
Bolivia,2008,FIFA World Cup qualification,10,9,2,2,2,6,1,0
Bolivia,2008,Friendly,4,6,3,2,0,5,-2,0
Bolivia,2009,FIFA World Cup qualification,9,14,2,6,0,8,-5,0
Bolivia,2009,Friendly,1,5,0,1,0,1,-4,0
Bolivia,2010,Friendly,1,6,0,1,1,2,-5,0
Bolivia,2011,Copa América,1,5,0,2,1,3,-4,0
Bolivia,2011,Copa Paz del Chaco,0,2,0,1,1,2,-2,0
Bolivia,2011,FIFA World Cup qualification,4,8,0,3,1,4,-4,0
Bolivia,2011,Friendly,5,11,0,4,3,7,-6,0
Bolivia,2012,FIFA World Cup qualification,8,6,2,2,1,5,2,0
Bolivia,2012,Friendly,5,7,2,1,1,4,-2,0
Bolivia,2013,FIFA World Cup qualification,5,16,0,3,4,7,-11,0
Bolivia,2013,Friendly,2,6,0,1,1,2,-4,0
Bolivia,2014,Friendly,4,7,1,3,0,4,-3,0
Bolivia,2015,Copa América,4,10,1,2,1,4,-6,0
Bolivia,2015,FIFA World Cup qualification,5,8,1,3,0,4,-3,0
Bolivia,2015,Friendly,0,12,0,2,0,2,-12,0
Bolivia,2016,Copa América,2,7,0,3,0,3,-5,0
Bolivia,2016,FIFA World Cup qualification,5,23,1,6,1,8,-18,0
Bolivia,2017,FIFA World Cup qualification,6,7,2,3,1,6,-1,0
Bolivia,2017,Friendly,4,2,2,0,0,2,2,0
Bolivia,2018,Friendly,8,14,1,4,5,10,-6,0
Bolivia,2019,Copa América,2,9,0,3,0,3,-7,0
Bolivia,2019,Friendly,6,13,1,4,1,6,-7,0
Bolivia,2019,Kirin Challenge Cup,0,1,0,1,0,1,-1,0
Bolivia,2020,FIFA World Cup qualification,5,12,0,3,1,4,-7,0
Bolivia,2021,Copa América,2,10,0,4,0,4,-8,0
Bolivia,2021,FIFA World Cup qualification,15,16,4,4,2,10,-1,0
Bolivia,2021,Friendly,3,4,1,2,0,3,-1,0
Bolivia,2022,FIFA World Cup qualification,3,14,0,4,0,4,-11,0
Bolivia,2022,Friendly,5,3,1,2,0,3,2,0
Bolivia,2023,FIFA World Cup qualification,4,14,1,5,0,6,-10,0
Bolivia,2023,Friendly,3,5,1,3,1,5,-2,0
Bolivia,2024,Copa América,1,9,0,3,0,3,-8,0
Bolivia,2024,FIFA Series,3,3,1,1,0,2,0,0
Bolivia,2024,FIFA World Cup qualification,9,13,3,2,1,6,-4,0
Bolivia,2024,Friendly,1,7,0,3,0,3,-6,0
Bolivia,2025,FIFA World Cup qualification,1,3,0,1,1,2,-2,0
Bonaire,2010,ABCS Tournament,5,7,0,1,1,2,-2,0
Bonaire,2011,ABCS Tournament,5,3,1,0,1,2,2,0
Bonaire,2012,ABCS Tournament,2,17,0,2,0,2,-15,0
Bonaire,2013,ABCS Tournament,2,3,1,1,0,2,-1,1
Bonaire,2014,CFU Caribbean Cup qualification,6,7,2,1,0,3,-1,0
Bonaire,2015,ABCS Tournament,1,7,0,2,0,2,-6,0
Bonaire,2018,CONCACAF Nations League qualification,0,11,0,2,0,2,-11,0
Bonaire,2019,CONCACAF Nations League,10,8,2,1,1,4,2,0
Bonaire,2019,CONCACAF Nations League qualification,3,3,1,1,0,2,0,0
Bonaire,2022,CONCACAF Nations League,10,3,3,0,1,4,7,0
Bonaire,2023,CONCACAF Nations League,8,14,2,4,0,6,-6,0
Bonaire,2024,CONCACAF Nations League,4,8,1,4,1,6,-4,0
Bonaire,2024,Friendly,1,1,0,0,1,1,0,0
Bonaire,2025,Friendly,0,6,0,1,0,1,-6,0
Bosnia and Herzegovina,1995,Friendly,0,2,0,1,0,1,-2,0
Bosnia and Herzegovina,1996,FIFA World Cup qualification,3,8,1,2,0,3,-5,0
Bosnia and Herzegovina,1996,Friendly,2,5,1,2,1,4,-3,0
Bosnia and Herzegovina,1997,Dunhill Cup,9,5,3,1,1,5,4,0
Bosnia and Herzegovina,1997,FIFA World Cup qualification,6,6,2,3,0,5,0,0
Bosnia and Herzegovina,1997,Friendly,1,2,0,1,0,1,-1,0
Bosnia and Herzegovina,1998,Friendly,1,6,0,1,1,2,-5,0
Bosnia and Herzegovina,1998,UEFA Euro qualification,5,8,1,2,1,4,-3,0
Bosnia and Herzegovina,1999,Friendly,2,3,0,1,2,3,-1,0
Bosnia and Herzegovina,1999,UEFA Euro qualification,9,9,2,3,1,6,0,0
Bosnia and Herzegovina,2000,FIFA World Cup qualification,2,5,0,2,0,2,-3,0
Bosnia and Herzegovina,2000,Friendly,5,3,3,1,1,5,2,0
Bosnia and Herzegovina,2001,FIFA World Cup qualification,10,7,2,2,2,6,3,0
Bosnia and Herzegovina,2001,Friendly,5,7,1,1,2,4,-2,0
Bosnia and Herzegovina,2001,Merdeka Tournament,5,4,2,1,1,4,1,0
Bosnia and Herzegovina,2001,Millennium Cup,4,3,2,1,1,4,1,0
Bosnia and Herzegovina,2002,Friendly,5,9,0,2,2,4,-4,0
Bosnia and Herzegovina,2002,UEFA Euro qualification,0,5,0,2,0,2,-5,0
Bosnia and Herzegovina,2003,Friendly,2,2,0,0,1,1,0,0
Bosnia and Herzegovina,2003,UEFA Euro qualification,7,3,4,1,1,6,4,0
Bosnia and Herzegovina,2004,FIFA World Cup qualification,1,1,0,0,2,2,0,0
Bosnia and Herzegovina,2004,Friendly,4,3,2,1,1,4,1,0
Bosnia and Herzegovina,2005,FIFA World Cup qualification,11,8,4,2,2,8,3,0
Bosnia and Herzegovina,2005,Friendly,1,3,0,2,0,2,-2,0
Bosnia and Herzegovina,2006,Friendly,5,11,0,3,1,4,-6,0
Bosnia and Herzegovina,2006,UEFA Euro qualification,8,11,1,2,1,4,-3,0
Bosnia and Herzegovina,2007,Friendly,3,5,0,1,0,1,-2,0
Bosnia and Herzegovina,2007,UEFA Euro qualification,8,11,3,5,0,8,-3,0
Bosnia and Herzegovina,2008,FIFA World Cup qualification,12,4,2,2,0,4,8,0
Bosnia and Herzegovina,2008,Friendly,8,10,2,2,1,5,-2,0
Bosnia and Herzegovina,2009,FIFA World Cup qualification,13,11,4,3,1,8,2,0
Bosnia and Herzegovina,2009,Friendly,4,4,1,1,1,3,0,0
Bosnia and Herzegovina,2010,Friendly,11,13,2,2,2,6,-2,0
Bosnia and Herzegovina,2010,UEFA Euro qualification,4,3,1,1,1,3,1,0
Bosnia and Herzegovina,2011,Friendly,0,2,0,1,1,2,-2,0
Bosnia and Herzegovina,2011,UEFA Euro qualification,15,11,5,2,2,9,4,0
Bosnia and Herzegovina,2012,FIFA World Cup qualification,15,2,3,0,1,4,13,0
Bosnia and Herzegovina,2012,Friendly,5,5,2,3,0,5,0,0
Bosnia and Herzegovina,2013,FIFA World Cup qualification,15,4,5,1,0,6,11,0
Bosnia and Herzegovina,2013,Friendly,6,6,1,2,0,3,0,0
Bosnia and Herzegovina,2014,FIFA World Cup,4,4,1,2,0,3,0,0
Bosnia and Herzegovina,2014,Friendly,6,3,3,1,0,4,3,0
Bosnia and Herzegovina,2014,UEFA Euro qualification,2,6,0,2,2,4,-4,0
Bosnia and Herzegovina,2015,Friendly,1,1,0,0,1,1,0,0
Bosnia and Herzegovina,2015,UEFA Euro qualification,16,9,5,2,1,8,7,0
Bosnia and Herzegovina,2016,FIFA World Cup qualification,8,5,2,1,1,4,3,0
Bosnia and Herzegovina,2016,Friendly,6,3,2,1,0,3,3,0
Bosnia and Herzegovina,2016,Kirin Cup,4,3,1,0,1,2,1,0
Bosnia and Herzegovina,2017,FIFA World Cup qualification,16,8,3,2,1,6,8,0
Bosnia and Herzegovina,2017,Friendly,2,1,1,0,0,1,1,0
Bosnia and Herzegovina,2018,Friendly,4,3,2,2,4,8,1,0
Bosnia and Herzegovina,2018,UEFA Nations League,5,1,3,0,1,4,4,0
Bosnia and Herzegovina,2019,UEFA Euro qualification,20,17,4,5,1,10,3,0
Bosnia and Herzegovina,2020,Friendly,0,2,0,1,0,1,-2,0
Bosnia and Herzegovina,2020,UEFA Euro qualification,1,1,0,0,1,1,0,0
Bosnia and Herzegovina,2020,UEFA Nations League,3,11,0,4,2,6,-8,0
Bosnia and Herzegovina,2021,FIFA World Cup qualification,9,12,1,3,4,8,-3,0
Bosnia and Herzegovina,2021,Friendly,1,3,1,2,2,5,-2,0
Bosnia and Herzegovina,2022,Friendly,1,1,1,1,0,2,0,0
Bosnia and Herzegovina,2022,UEFA Nations League,8,8,3,1,2,6,0,0
Bosnia and Herzegovina,2023,UEFA Euro qualification,9,20,3,7,0,10,-11,0
Bosnia and Herzegovina,2024,Friendly,0,4,0,2,0,2,-4,0
Bosnia and Herzegovina,2024,UEFA Euro qualification,1,2,0,1,0,1,-1,0
Bosnia and Herzegovina,2024,UEFA Nations League,4,17,0,4,2,6,-13,0
Bosnia and Herzegovina,2025,FIFA World Cup qualification,3,1,2,0,0,2,2,0
Botswana,1968,Friendly,1,8,0,1,0,1,-7,0
Botswana,1976,Friendly,3,13,0,3,0,3,-10,0
Botswana,1977,Friendly,1,9,0,3,0,3,-8,0
Botswana,1978,Friendly,1,6,0,2,0,2,-5,0
Botswana,1981,Friendly,2,6,0,2,0,2,-4,0
Botswana,1982,Friendly,0,2,0,1,0,1,-2,0
Botswana,1984,Friendly,1,3,0,1,0,1,-2,0
Botswana,1986,Friendly,3,9,2,2,0,4,-6,0
Botswana,1987,Friendly,0,0,0,0,1,1,0,0
Botswana,1989,Friendly,2,1,1,0,0,1,1,0
Botswana,1990,Friendly,6,15,1,3,3,7,-9,0
Botswana,1991,Friendly,3,4,1,1,2,4,-1,0
Botswana,1992,African Cup of Nations qualification,0,4,0,1,1,2,-4,0
Botswana,1992,FIFA World Cup qualification,0,7,0,2,0,2,-7,0
Botswana,1992,Friendly,1,4,0,2,0,2,-3,0
Botswana,1993,FIFA World Cup qualification,1,2,0,1,1,2,-1,0
Botswana,1993,Friendly,0,2,0,1,0,1,-2,0
Botswana,1994,African Cup of Nations qualification,2,5,0,2,1,3,-3,0
Botswana,1994,Friendly,3,3,1,1,0,2,0,0
Botswana,1995,African Cup of Nations qualification,3,22,0,6,1,7,-19,0
Botswana,1996,African Cup of Nations qualification,0,6,0,1,1,2,-6,0
Botswana,1997,COSAFA Cup qualification,1,4,0,1,0,1,-3,0
Botswana,1997,Friendly,1,4,0,1,2,3,-3,0
Botswana,1998,African Cup of Nations qualification,1,2,0,1,1,2,-1,0
Botswana,1998,COSAFA Cup qualification,1,2,0,1,0,1,-1,0
Botswana,1998,Friendly,1,1,0,0,2,2,0,0
Botswana,1999,COSAFA Cup qualification,1,4,0,2,0,2,-3,0
Botswana,1999,Friendly,1,2,0,1,0,1,-1,0
Botswana,2000,African Cup of Nations qualification,1,2,1,1,0,2,-1,0
Botswana,2000,COSAFA Cup,0,3,0,1,0,1,-3,0
Botswana,2000,FIFA World Cup qualification,0,2,0,2,0,2,-2,0
Botswana,2000,Friendly,7,1,3,0,2,5,6,0
Botswana,2001,COSAFA Cup,0,1,0,1,0,1,-1,0
Botswana,2001,Friendly,9,8,4,2,0,6,1,0
Botswana,2002,African Cup of Nations qualification,0,2,0,1,1,2,-2,0
Botswana,2002,COSAFA Cup,0,0,0,0,1,1,0,0
Botswana,2002,Friendly,10,7,3,3,0,6,3,0
Botswana,2003,African Cup of Nations qualification,2,4,0,2,2,4,-2,0
Botswana,2003,COSAFA Cup,2,1,1,0,1,2,1,0
Botswana,2003,FIFA World Cup qualification,4,1,1,0,1,2,3,0
Botswana,2003,Friendly,5,4,2,2,1,5,1,0
Botswana,2004,COSAFA Cup,1,1,0,0,2,2,0,0
Botswana,2004,FIFA World Cup qualification,5,10,2,3,0,5,-5,0
Botswana,2004,Friendly,2,3,1,1,3,5,-1,0
Botswana,2005,COSAFA Cup,1,3,0,1,1,2,-2,0
Botswana,2005,FIFA World Cup qualification,5,8,1,4,0,5,-3,0
Botswana,2005,Friendly,1,1,0,0,5,5,0,0
Botswana,2006,African Cup of Nations qualification,0,0,0,0,1,1,0,0
Botswana,2006,COSAFA Cup,2,1,1,1,1,3,1,0
Botswana,2006,Friendly,3,2,2,1,3,6,1,0
Botswana,2007,African Cup of Nations qualification,3,3,2,2,0,4,0,0
Botswana,2007,COSAFA Cup,1,1,1,1,1,3,0,0
Botswana,2007,Friendly,1,0,1,0,2,3,1,0
Botswana,2008,COSAFA Cup,0,2,0,1,0,1,-2,0
Botswana,2008,FIFA World Cup qualification,3,8,1,3,2,6,-5,0
Botswana,2008,Friendly,6,5,2,3,0,5,1,0
Botswana,2009,COSAFA Cup,3,1,2,1,1,4,2,0
Botswana,2009,Friendly,2,5,0,1,4,5,-3,0
Botswana,2010,African Cup of Nations qualification,6,2,4,0,1,5,4,1
Botswana,2010,Friendly,7,0,4,0,1,5,7,0
Botswana,2011,African Cup of Nations qualification,1,1,1,1,1,3,0,0
Botswana,2011,Friendly,7,5,2,1,5,8,2,0
Botswana,2012,African Cup of Nations,2,9,0,3,0,3,-7,0
Botswana,2012,African Cup of Nations qualification,1,7,0,2,0,2,-6,0
Botswana,2012,FIFA World Cup qualification,1,3,0,1,1,2,-2,0
Botswana,2012,Friendly,9,7,2,1,5,8,2,0
Botswana,2013,COSAFA Cup,5,4,1,0,2,3,1,0
Botswana,2013,FIFA World Cup qualification,7,7,2,2,0,4,0,0
Botswana,2013,Friendly,6,8,3,3,1,7,-2,0
Botswana,2014,African Cup of Nations qualification,5,12,2,5,3,10,-7,0
Botswana,2014,Friendly,6,0,3,0,1,4,6,0
Botswana,2015,African Cup of Nations qualification,1,2,1,1,0,2,-1,0
Botswana,2015,COSAFA Cup,2,4,0,2,1,3,-2,0
Botswana,2015,FIFA World Cup qualification,7,4,3,1,0,4,3,0
Botswana,2015,Friendly,5,7,1,3,0,4,-2,0
Botswana,2016,African Cup of Nations qualification,4,6,1,3,0,4,-2,0
Botswana,2016,COSAFA Cup,3,4,0,1,2,3,-1,0
Botswana,2016,Friendly,3,2,1,0,1,2,1,0
Botswana,2017,African Cup of Nations qualification,0,1,0,1,0,1,-1,0
Botswana,2017,COSAFA Cup,1,4,0,2,0,2,-3,0
Botswana,2017,Friendly,0,4,0,2,1,3,-4,0
Botswana,2018,African Cup of Nations qualification,1,6,0,3,1,4,-5,0
Botswana,2018,COSAFA Cup,12,6,3,1,2,6,6,0
Botswana,2018,Friendly,3,0,3,0,0,3,3,0
Botswana,2019,African Cup of Nations qualification,0,2,0,2,1,3,-2,0
Botswana,2019,COSAFA Cup,4,4,1,1,1,3,0,0
Botswana,2019,FIFA World Cup qualification,0,1,0,1,1,2,-1,0
Botswana,2019,Friendly,0,1,0,1,1,2,-1,0
Botswana,2020,African Cup of Nations qualification,2,2,1,1,0,2,0,0
Botswana,2021,African Cup of Nations qualification,0,6,0,2,0,2,-6,0
Botswana,2021,COSAFA Cup,6,4,1,2,1,4,2,0
Botswana,2022,African Cup of Nations qualification,0,1,0,1,1,2,-1,0
Botswana,2022,COSAFA Cup,7,3,4,1,1,6,4,0
Botswana,2022,Friendly,0,2,0,2,0,2,-2,0
Botswana,2023,African Cup of Nations qualification,3,8,1,3,0,4,-5,0
Botswana,2023,COSAFA Cup,2,2,1,1,1,3,0,0
Botswana,2023,FIFA World Cup qualification,3,3,1,1,0,2,0,0
Botswana,2023,Friendly,2,1,1,0,0,1,1,0
Botswana,2024,African Cup of Nations qualification,2,5,2,2,0,4,-3,0
Botswana,2024,FIFA World Cup qualification,3,2,1,1,0,2,1,0
Botswana,2024,Friendly,1,1,0,0,1,1,0,0
Botswana,2025,FIFA World Cup qualification,3,3,1,1,0,2,0,0
Brazil,1914,Copa Roca,1,0,1,0,0,1,1,1
Brazil,1914,Friendly,0,3,0,1,0,1,-3,0
Brazil,1916,Copa América,3,4,0,1,2,3,-1,0
Brazil,1916,Friendly,1,0,1,0,0,1,1,0
Brazil,1917,Copa América,7,8,1,2,0,3,-1,0
Brazil,1917,Friendly,1,3,0,1,0,1,-2,0
Brazil,1919,Copa América,12,3,3,0,1,4,9,1
Brazil,1919,Friendly,3,3,0,0,1,1,0,0
Brazil,1920,Copa América,1,8,1,2,0,3,-7,0
Brazil,1921,Copa América,4,3,1,2,0,3,1,0
Brazil,1922,Copa América,7,2,2,0,3,5,5,1
Brazil,1922,Copa Roca,2,1,1,0,0,1,1,1
Brazil,1922,Friendly,3,1,1,0,0,1,2,0
Brazil,1923,Copa América,2,5,0,3,0,3,-3,0
Brazil,1923,Copa Roca,0,2,0,1,0,1,-2,0
Brazil,1923,Friendly,4,0,2,0,0,2,4,0
Brazil,1925,Copa América,11,9,2,1,1,4,2,0
Brazil,1930,FIFA World Cup,5,2,1,1,0,2,3,0
Brazil,1930,Friendly,11,6,3,0,0,3,5,0
Brazil,1931,Copa Rio Branco,2,0,1,0,0,1,2,1
Brazil,1932,Copa Rio Branco,2,1,1,0,0,1,1,1
Brazil,1934,FIFA World Cup,1,3,0,1,0,1,-2,0
Brazil,1934,Friendly,7,12,0,2,1,3,-5,0
Brazil,1936,Copa América,3,2,1,0,0,1,1,0
Brazil,1937,Copa América,14,9,3,2,0,5,5,0
Brazil,1938,FIFA World Cup,14,11,3,1,1,5,3,0
Brazil,1939,Copa Roca,4,7,1,1,0,2,-3,1
Brazil,1940,Copa Rio Branco,4,5,0,1,1,2,-1,0
Brazil,1940,Copa Roca,7,18,1,3,1,5,-11,0
Brazil,1942,Copa América,15,7,3,2,1,6,8,0
Brazil,1944,Friendly,10,1,2,0,0,2,9,0
Brazil,1945,Copa América,19,5,5,1,0,6,14,1
Brazil,1945,Copa Roca,12,7,2,1,0,3,5,1
Brazil,1946,Copa América,13,7,3,1,1,5,6,0
Brazil,1946,Copa Rio Branco,3,4,0,1,0,1,-1,0
Brazil,1947,Copa Rio Branco,3,2,1,0,1,2,1,1
Brazil,1948,Copa Rio Branco,3,5,0,1,1,2,-2,0
Brazil,1949,Copa América,46,7,7,1,0,8,39,1
Brazil,1950,Copa Oswaldo Cruz,5,3,1,0,1,2,2,0
Brazil,1950,Copa Rio Branco,6,6,1,1,0,2,0,1
Brazil,1950,FIFA World Cup,22,6,4,1,1,6,16,0
Brazil,1952,Pan American Championship,14,2,4,0,1,5,12,1
Brazil,1953,Copa América,17,9,4,3,0,7,8,0
Brazil,1954,FIFA World Cup,8,5,1,1,1,3,3,0
Brazil,1954,FIFA World Cup qualification,8,1,4,0,0,4,7,0
Brazil,1955,Copa Bernardo O'Higgins,3,2,1,0,1,2,1,1
Brazil,1955,Copa Oswaldo Cruz,6,3,1,0,1,2,3,0
Brazil,1956,Atlantic Cup,2,0,1,0,1,2,2,0
Brazil,1956,Copa América,4,5,2,1,2,5,-1,0
Brazil,1956,Copa Oswaldo Cruz,7,2,2,0,0,2,5,1
Brazil,1956,Friendly,14,12,5,3,2,10,2,0
Brazil,1956,Pan American Championship,14,5,4,0,1,5,9,0
Brazil,1957,Copa América,23,9,4,2,0,6,14,0
Brazil,1957,Copa Bernardo O'Higgins,1,2,0,1,1,2,-1,0
Brazil,1957,Copa Roca,3,2,1,1,0,2,1,1
Brazil,1957,FIFA World Cup qualification,2,1,1,0,1,2,1,0
Brazil,1957,Friendly,5,1,2,0,0,2,4,0
Brazil,1958,Copa Oswaldo Cruz,5,1,1,0,1,2,4,0
Brazil,1958,FIFA World Cup,16,4,5,0,1,6,12,1
Brazil,1958,Friendly,7,1,2,0,0,2,6,0
Brazil,1959,Copa América,24,17,6,2,2,10,7,0
Brazil,1959,Copa Bernardo O'Higgins,8,0,2,0,0,2,8,1
Brazil,1959,Friendly,4,1,2,0,0,2,3,1
Brazil,1960,Atlantic Cup,7,3,2,1,0,3,4,0
Brazil,1960,Copa Roca,6,5,1,1,0,2,1,1
Brazil,1960,Friendly,19,4,5,0,0,5,15,0
Brazil,1960,Pan American Championship,10,8,3,2,1,6,2,1
Brazil,1961,Copa Bernardo O'Higgins,3,1,2,0,0,2,2,1
Brazil,1961,Copa Oswaldo Cruz,5,2,2,0,0,2,3,1
Brazil,1961,Friendly,3,2,1,0,0,1,1,0
Brazil,1962,Copa Oswaldo Cruz,10,0,2,0,0,2,10,1
Brazil,1962,FIFA World Cup,14,5,5,0,1,6,9,1
Brazil,1962,Friendly,9,3,4,0,0,4,6,0
Brazil,1963,Copa América,12,13,2,3,1,6,-1,0
Brazil,1963,Copa Roca,7,5,1,1,0,2,2,1
Brazil,1963,Friendly,15,16,4,4,2,10,-1,0
Brazil,1964,Friendly,9,5,2,1,0,3,4,0
Brazil,1965,Friendly,25,6,7,0,3,10,19,0
Brazil,1966,Copa Bernardo O'Higgins,2,2,1,1,0,2,0,0
Brazil,1966,FIFA World Cup,4,6,1,2,0,3,-2,0
Brazil,1966,Friendly,27,11,9,0,3,12,16,0
Brazil,1967,Copa Rio Branco,3,3,0,0,3,3,0,0
Brazil,1967,Friendly,1,0,1,0,0,1,1,0
Brazil,1968,Copa Oswaldo Cruz,4,1,1,1,0,2,3,0
Brazil,1968,Copa Rio Branco,6,0,2,0,0,2,6,1
Brazil,1968,Friendly,42,26,10,4,2,16,16,0
Brazil,1969,FIFA World Cup qualification,23,2,6,0,0,6,21,0
Brazil,1969,Friendly,7,4,3,0,0,3,3,0
Brazil,1970,FIFA World Cup,19,7,6,0,0,6,12,1
Brazil,1970,Friendly,17,6,6,1,1,8,11,0
Brazil,1971,Copa Roca,3,3,0,0,2,2,0,0
Brazil,1971,Friendly,5,3,2,0,2,4,2,0
Brazil,1972,Brazil Independence Cup,5,0,3,0,1,4,5,1
Brazil,1972,Friendly,3,2,1,0,0,1,1,0
Brazil,1973,Friendly,19,8,7,2,1,10,11,0
Brazil,1974,FIFA World Cup,6,4,3,2,2,7,2,0
Brazil,1974,Friendly,13,2,6,0,3,9,11,0
Brazil,1975,Copa América,16,4,5,1,0,6,12,0
Brazil,1975,Friendly,2,1,1,0,0,1,1,0
Brazil,1976,Copa Oswaldo Cruz,4,2,1,0,1,2,2,1
Brazil,1976,Copa Rio Branco,4,2,2,0,0,2,2,1
Brazil,1976,Copa Roca,4,1,2,0,0,2,3,1
Brazil,1976,Friendly,10,1,4,0,0,4,9,0
Brazil,1977,FIFA World Cup qualification,17,1,4,0,2,6,16,0
Brazil,1977,Friendly,9,4,3,0,4,7,5,0
Brazil,1978,FIFA World Cup,10,3,4,0,3,7,7,0
Brazil,1978,Friendly,7,2,3,1,1,5,5,0
Brazil,1979,Copa América,10,9,2,2,2,6,1,0
Brazil,1979,Friendly,11,1,2,0,0,2,10,0
Brazil,1980,Friendly,17,5,6,1,1,8,12,1
Brazil,1981,FIFA World Cup qualification,11,2,4,0,0,4,9,0
Brazil,1981,Friendly,19,4,7,0,2,9,15,0
Brazil,1981,Mundialito,6,4,1,1,1,3,2,0
Brazil,1982,FIFA World Cup,15,6,4,1,0,5,9,0
Brazil,1982,Friendly,16,4,4,0,2,6,12,0
Brazil,1983,Copa América,8,5,2,2,4,8,3,0
Brazil,1983,Friendly,13,7,3,0,3,6,6,0
Brazil,1984,Friendly,1,2,1,1,1,3,-1,0
Brazil,1985,FIFA World Cup qualification,6,2,2,0,2,4,4,0
Brazil,1985,Friendly,10,7,4,3,0,7,3,0
Brazil,1986,FIFA World Cup,10,1,4,0,1,5,9,0
Brazil,1986,Friendly,15,8,4,2,1,7,7,0
Brazil,1987,Copa América,5,4,1,1,0,2,1,0
Brazil,1987,Friendly,14,6,4,1,1,6,8,0
Brazil,1987,Rous Cup,3,1,1,0,1,2,2,1
Brazil,1988,Friendly,12,3,5,0,2,7,9,0
Brazil,1989,Copa América,11,1,5,0,2,7,10,1
Brazil,1989,FIFA World Cup qualification,12,1,3,0,1,4,11,0
Brazil,1989,Friendly,16,9,7,3,2,12,7,0
Brazil,1990,FIFA World Cup,4,2,3,1,0,4,2,0
Brazil,1990,Friendly,5,8,1,2,3,6,-3,0
Brazil,1991,Copa América,12,8,4,2,1,7,4,1
Brazil,1991,Friendly,13,8,3,1,3,7,5,0
Brazil,1992,Friendly,23,8,7,2,1,10,15,0
Brazil,1993,Copa América,6,4,1,1,2,4,2,0
Brazil,1993,FIFA World Cup qualification,20,4,5,1,2,8,16,0
Brazil,1993,Friendly,8,6,2,1,3,6,2,0
Brazil,1993,USA Cup,6,4,1,0,2,3,2,0
Brazil,1994,FIFA World Cup,11,3,5,0,2,7,8,0
Brazil,1994,Friendly,20,3,5,0,1,6,17,0
Brazil,1995,Copa América,10,3,4,0,2,6,7,0
Brazil,1995,Friendly,29,6,11,0,1,12,23,0
Brazil,1996,Friendly,21,9,5,0,2,7,12,0
Brazil,1996,Gold Cup,10,3,3,1,0,4,7,0
Brazil,1997,Confederations Cup,14,2,4,0,1,5,12,1
Brazil,1997,Copa América,22,3,6,0,0,6,19,1
Brazil,1997,Friendly,30,10,9,1,0,10,20,0
Brazil,1997,Tournoi de France,5,4,1,0,2,3,1,0
Brazil,1998,FIFA World Cup,14,10,4,2,1,7,4,0
Brazil,1998,Friendly,16,5,4,1,1,6,11,0
Brazil,1998,Gold Cup,6,2,2,1,2,5,4,0
Brazil,1999,Confederations Cup,18,6,4,1,0,5,12,0
Brazil,1999,Copa América,17,2,6,0,0,6,15,1
Brazil,1999,Friendly,16,10,4,2,3,9,6,0
Brazil,2000,FIFA World Cup qualification,21,9,6,2,2,10,12,0
Brazil,2000,Friendly,4,1,1,0,1,2,3,0
Brazil,2000,King's Cup,7,0,1,0,0,1,7,0
Brazil,2001,Confederations Cup,3,3,1,2,2,5,0,0
Brazil,2001,Copa América,5,4,2,2,0,4,1,0
Brazil,2001,FIFA World Cup qualification,10,8,3,4,1,8,2,0
Brazil,2001,Friendly,10,4,2,0,1,3,6,0
Brazil,2002,FIFA World Cup,18,4,7,0,0,7,14,1
Brazil,2002,Friendly,25,6,7,1,1,9,19,0
Brazil,2003,Confederations Cup,3,3,1,1,1,3,0,0
Brazil,2003,FIFA World Cup qualification,7,5,2,0,2,4,2,0
Brazil,2003,Friendly,5,2,2,1,2,5,3,0
Brazil,2003,Gold Cup,6,4,3,2,0,5,2,0
Brazil,2004,Copa América,13,6,3,1,2,6,7,0
Brazil,2004,FIFA World Cup qualification,12,6,3,1,3,7,6,0
Brazil,2004,Friendly,16,4,3,0,3,6,12,0
Brazil,2005,Confederations Cup,12,6,3,1,1,5,6,0
Brazil,2005,FIFA World Cup qualification,16,6,4,1,2,7,10,0
Brazil,2005,Friendly,12,1,2,0,1,3,11,0
Brazil,2005,Lunar New Year Cup,7,1,1,0,0,1,6,1
Brazil,2006,FIFA World Cup,10,2,4,1,0,5,8,0
Brazil,2006,Friendly,15,3,6,0,1,7,12,0
Brazil,2007,Copa América,15,5,4,1,1,6,10,1
Brazil,2007,FIFA World Cup qualification,8,2,2,0,2,4,6,0
Brazil,2007,Friendly,15,6,5,1,2,8,9,0
Brazil,2008,FIFA World Cup qualification,7,2,2,1,3,6,5,0
Brazil,2008,Friendly,11,6,4,1,0,5,5,0
Brazil,2009,Confederations Cup,14,5,5,0,0,5,9,1
Brazil,2009,FIFA World Cup qualification,18,7,5,1,2,8,11,0
Brazil,2009,Friendly,6,0,4,0,0,4,6,0
Brazil,2010,FIFA World Cup,9,4,3,1,1,5,5,0
Brazil,2010,Friendly,17,2,6,1,0,7,15,0
Brazil,2011,Copa América,6,4,1,0,3,4,2,0
Brazil,2011,Friendly,13,5,7,2,1,10,8,0
Brazil,2011,Superclásico de las Américas,2,0,1,0,1,2,2,1
Brazil,2012,Friendly,35,10,8,2,1,11,25,0
Brazil,2012,Superclásico de las Américas,3,3,1,1,0,2,0,0
Brazil,2013,Confederations Cup,14,3,5,0,0,5,11,0
Brazil,2013,Friendly,35,12,8,2,4,14,23,0
Brazil,2014,FIFA World Cup,11,14,3,2,2,7,-3,0
Brazil,2014,Friendly,21,1,7,0,0,7,20,0
Brazil,2014,Superclásico de las Américas,2,0,1,0,0,1,2,1
Brazil,2015,Copa América,5,4,2,1,1,4,1,0
Brazil,2015,FIFA World Cup qualification,7,4,2,1,1,4,3,0
Brazil,2015,Friendly,12,2,6,0,0,6,10,0
Brazil,2016,Copa América,7,2,1,1,1,3,5,0
Brazil,2016,FIFA World Cup qualification,21,5,6,0,2,8,16,0
Brazil,2017,FIFA World Cup qualification,13,2,4,0,2,6,11,0
Brazil,2017,Friendly,8,1,3,0,1,4,7,0
Brazil,2017,Superclásico de las Américas,0,1,0,1,0,1,-1,0
Brazil,2018,FIFA World Cup,8,3,3,1,1,5,5,0
Brazil,2018,Friendly,20,0,9,0,0,9,20,0
Brazil,2018,Superclásico de las Américas,1,0,1,0,0,1,1,1
Brazil,2019,Copa América,13,1,4,0,2,6,12,1
Brazil,2019,Friendly,20,7,4,1,4,9,13,0
Brazil,2019,Superclásico de las Américas,0,1,0,1,0,1,-1,0
Brazil,2020,FIFA World Cup qualification,12,2,4,0,0,4,10,0
Brazil,2021,Copa América,12,3,5,1,1,7,9,0
Brazil,2021,FIFA World Cup qualification,15,2,7,0,2,9,13,0
Brazil,2022,FIFA World Cup,8,3,3,1,1,5,5,0
Brazil,2022,FIFA World Cup qualification,13,1,3,0,1,4,12,0
Brazil,2022,Friendly,14,2,4,0,0,4,12,0
Brazil,2023,FIFA World Cup qualification,8,7,2,3,1,6,1,0
Brazil,2023,Friendly,7,7,1,2,0,3,0,0
Brazil,2024,Copa América,5,2,1,0,3,4,3,0
Brazil,2024,FIFA World Cup qualification,9,4,3,1,2,6,5,0
Brazil,2024,Friendly,8,6,2,0,2,4,2,0
Brazil,2025,FIFA World Cup qualification,3,5,1,1,0,2,-2,0
British Virgin Islands,1985,Friendly,1,0,1,0,0,1,1,0
British Virgin Islands,1989,CFU Caribbean Cup qualification,2,5,1,1,1,3,-3,0
British Virgin Islands,1990,CFU Caribbean Cup qualification,0,3,0,1,0,1,-3,0
British Virgin Islands,1991,CFU Caribbean Cup qualification,1,2,0,1,1,2,-1,0
British Virgin Islands,1992,CFU Caribbean Cup qualification,0,6,0,2,0,2,-6,0
British Virgin Islands,1993,CFU Caribbean Cup qualification,2,8,0,2,0,2,-6,0
British Virgin Islands,1994,CFU Caribbean Cup qualification,0,20,0,3,0,3,-20,0
British Virgin Islands,1997,CFU Caribbean Cup qualification,7,11,1,2,0,3,-4,0
British Virgin Islands,1998,CFU Caribbean Cup qualification,1,11,0,3,0,3,-10,0
British Virgin Islands,1998,Friendly,0,6,0,2,0,2,-6,0
British Virgin Islands,1999,CFU Caribbean Cup qualification,11,7,3,1,1,5,4,0
British Virgin Islands,1999,Friendly,0,2,0,1,0,1,-2,0
British Virgin Islands,2000,FIFA World Cup qualification,1,14,0,2,0,2,-13,0
British Virgin Islands,2000,Friendly,11,9,1,3,2,6,2,0
British Virgin Islands,2001,CFU Caribbean Cup qualification,4,9,1,1,2,4,-5,0
British Virgin Islands,2001,Friendly,3,1,1,0,1,2,2,0
British Virgin Islands,2002,Friendly,2,6,1,1,0,2,-4,0
British Virgin Islands,2002,Gold Cup qualification,2,11,0,2,0,2,-9,0
British Virgin Islands,2004,CFU Caribbean Cup qualification,2,7,1,3,0,4,-5,0
British Virgin Islands,2004,FIFA World Cup qualification,0,10,0,2,0,2,-10,0
British Virgin Islands,2004,Friendly,8,8,2,3,0,5,0,0
British Virgin Islands,2007,Friendly,1,0,1,0,0,1,1,0
British Virgin Islands,2008,CFU Caribbean Cup qualification,1,6,0,2,0,2,-5,0
British Virgin Islands,2008,FIFA World Cup qualification,3,3,0,0,2,2,0,0
British Virgin Islands,2008,Friendly,1,1,0,0,2,2,0,0
British Virgin Islands,2009,Friendly,0,4,0,1,0,1,-4,0
British Virgin Islands,2010,CFU Caribbean Cup qualification,0,27,0,2,0,2,-27,0
British Virgin Islands,2010,Friendly,3,4,1,1,0,2,-1,0
British Virgin Islands,2011,FIFA World Cup qualification,1,4,0,2,0,2,-3,0
British Virgin Islands,2012,CFU Caribbean Cup qualification,0,27,0,3,0,3,-27,0
British Virgin Islands,2012,Friendly,1,0,1,0,0,1,1,0
British Virgin Islands,2014,CFU Caribbean Cup qualification,0,15,0,3,0,3,-15,0
British Virgin Islands,2014,Friendly,2,4,0,1,0,1,-2,0
British Virgin Islands,2015,FIFA World Cup qualification,2,3,0,1,1,2,-1,0
British Virgin Islands,2015,Friendly,0,1,0,1,0,1,-1,0
British Virgin Islands,2016,CFU Caribbean Cup qualification,0,10,0,2,0,2,-10,0
British Virgin Islands,2018,CONCACAF Nations League qualification,0,9,0,2,0,2,-9,0
British Virgin Islands,2018,Friendly,4,3,1,0,0,1,1,0
British Virgin Islands,2019,CONCACAF Nations League,5,15,0,4,0,4,-10,0
British Virgin Islands,2019,CONCACAF Nations League qualification,3,4,0,1,1,2,-1,0
British Virgin Islands,2021,FIFA World Cup qualification,0,19,0,4,0,4,-19,0
British Virgin Islands,2022,CONCACAF Nations League,2,8,0,1,2,3,-6,0
British Virgin Islands,2023,CONCACAF Nations League,8,9,1,2,2,5,-1,0
British Virgin Islands,2024,CONCACAF Nations League,1,7,0,4,0,4,-6,0
British Virgin Islands,2024,FIFA World Cup qualification,1,8,0,2,2,4,-7,0
Brittany,1922,Friendly,1,0,1,0,0,1,1,0
Brittany,1923,Friendly,5,6,1,1,0,2,-1,0
Brittany,1924,Friendly,1,1,0,0,1,1,0,0
Brittany,1925,Friendly,1,1,0,0,1,1,0,0
Brittany,1939,Friendly,3,1,1,0,0,1,2,0
Brittany,1998,Friendly,1,1,0,0,1,1,0,0
Brittany,2008,Friendly,3,1,1,0,0,1,2,0
Brittany,2010,Corsica Cup,2,3,1,1,0,2,-1,0
Brittany,2011,Friendly,0,1,0,1,0,1,-1,0
Brittany,2013,Friendly,1,0,1,0,0,1,1,0
Brunei,1971,AFC Asian Cup qualification,0,27,0,3,0,3,-27,0
Brunei,1975,AFC Asian Cup qualification,1,10,0,1,0,1,-9,0
Brunei,1977,Southeast Asian Games,1,15,0,3,0,3,-14,0
Brunei,1980,King's Cup,0,5,0,2,0,2,-5,0
Brunei,1982,Merlion Cup,0,11,0,2,0,2,-11,0
Brunei,1983,Merlion Cup,0,4,0,1,0,1,-4,0
Brunei,1983,Southeast Asian Games,4,13,1,3,1,5,-9,0
Brunei,1984,Friendly,1,7,0,1,0,1,-6,0
Brunei,1985,FIFA World Cup qualification,2,29,0,6,0,6,-27,0
Brunei,1985,Friendly,4,1,1,0,0,1,3,0
Brunei,1985,Merlion Cup,1,6,0,2,0,2,-5,0
Brunei,1985,Southeast Asian Games,1,4,0,1,1,2,-3,0
Brunei,1987,Southeast Asian Games,1,5,0,2,0,2,-4,0
Brunei,1989,Southeast Asian Games,3,8,1,2,0,3,-5,0
Brunei,1991,Friendly,1,2,0,1,0,1,-1,0
Brunei,1993,Southeast Asian Games,5,17,0,4,0,4,-12,0
Brunei,1995,Southeast Asian Games,2,8,0,3,1,4,-6,0
Brunei,1996,AFF Championship,1,15,1,3,0,4,-14,0
Brunei,1997,Southeast Asian Games,1,17,0,4,0,4,-16,0
Brunei,1998,AFF Championship qualification,2,6,0,2,0,2,-4,0
Brunei,1999,Southeast Asian Games,4,11,0,3,1,4,-7,0
Brunei,2000,AFC Asian Cup qualification,0,11,0,3,0,3,-11,0
Brunei,2001,FIFA World Cup qualification,0,28,0,6,0,6,-28,0
Brunei,2003,AFC Asian Cup qualification,1,6,0,1,1,2,-5,0
Brunei,2006,AFC Challenge Cup,2,2,1,1,1,3,0,0
Brunei,2006,AFF Championship qualification,6,11,1,2,1,4,-5,0
Brunei,2008,AFC Challenge Cup qualification,1,6,0,2,1,3,-5,0
Brunei,2008,AFF Championship qualification,8,7,1,2,1,4,1,0
Brunei,2009,AFC Challenge Cup qualification,1,11,0,2,0,2,-10,0
Brunei,2012,AFF Championship qualification,6,7,2,2,0,4,-1,1
Brunei,2014,AFF Championship qualification,5,12,0,4,0,4,-7,0
Brunei,2015,FIFA World Cup qualification,1,2,1,1,0,2,-1,0
Brunei,2015,Friendly,2,11,0,2,0,2,-9,0
Brunei,2016,AFC Challenge Cup,7,7,1,2,1,4,0,0
Brunei,2016,AFF Championship qualification,5,8,1,2,0,3,-3,0
Brunei,2017,Friendly,0,8,0,2,0,2,-8,0
Brunei,2018,AFF Championship qualification,2,3,1,1,0,2,-1,1
Brunei,2019,FIFA World Cup qualification,2,3,1,1,0,2,-1,0
Brunei,2022,AFF Championship,2,22,0,4,0,4,-20,0
Brunei,2022,AFF Championship qualification,6,3,1,1,0,2,3,0
Brunei,2022,Friendly,3,10,1,3,0,4,-7,0
Brunei,2023,FIFA World Cup qualification,0,12,0,2,0,2,-12,0
Brunei,2023,Friendly,0,10,0,1,0,1,-10,0
Brunei,2024,AFC Asian Cup qualification,4,0,2,0,0,2,4,0
Brunei,2024,ASEAN Championship qualification,0,1,0,1,1,2,-1,0
Brunei,2024,FIFA Series,3,4,1,1,0,2,-1,0
Brunei,2024,Friendly,3,2,2,1,0,3,1,0
Brunei,2025,AFC Asian Cup qualification,0,5,0,1,0,1,-5,0
Bulgaria,1924,Friendly,0,6,0,1,0,1,-6,0
Bulgaria,1924,Olympic Games,0,1,0,1,0,1,-1,0
Bulgaria,1925,Friendly,3,6,0,2,0,2,-3,0
Bulgaria,1926,Friendly,2,9,0,2,0,2,-7,0
Bulgaria,1927,Friendly,4,8,0,2,1,3,-4,0
Bulgaria,1929,Friendly,3,7,0,2,1,3,-4,0
Bulgaria,1930,Balkan Cup,6,12,1,2,0,3,-6,0
Bulgaria,1930,Friendly,3,8,0,1,1,2,-5,0
Bulgaria,1931,Balkan Cup,12,10,3,2,0,5,2,0
Bulgaria,1932,Balkan Cup,7,2,3,0,0,3,5,0
Bulgaria,1932,Friendly,10,10,2,1,1,4,0,0
Bulgaria,1933,Balkan Cup,2,11,1,2,0,3,-9,0
Bulgaria,1933,Friendly,0,13,0,1,0,1,-13,0
Bulgaria,1934,Balkan Cup,5,7,0,2,0,2,-2,0
Bulgaria,1934,FIFA World Cup qualification,3,14,0,3,0,3,-11,0
Bulgaria,1934,Friendly,4,4,1,1,0,2,0,0
Bulgaria,1935,Balkan Cup,14,6,3,0,1,4,8,0
Bulgaria,1935,Friendly,2,4,0,1,0,1,-2,0
Bulgaria,1936,Balkan Cup,6,8,1,1,0,2,-2,0
Bulgaria,1937,FIFA World Cup qualification,1,1,0,0,1,1,0,0
Bulgaria,1937,Friendly,3,3,0,0,1,1,0,0
Bulgaria,1938,FIFA World Cup qualification,0,6,0,1,0,1,-6,0
Bulgaria,1938,Friendly,1,6,0,1,0,1,-5,0
Bulgaria,1939,Friendly,4,2,1,1,0,2,2,0
Bulgaria,1940,Friendly,4,11,0,2,0,2,-7,0
Bulgaria,1942,Friendly,0,3,0,1,0,1,-3,0
Bulgaria,1943,Friendly,2,4,0,1,0,1,-2,0
Bulgaria,1946,Balkan Cup,3,5,0,1,1,2,-2,0
Bulgaria,1947,Balkan Cup,5,14,1,3,0,4,-9,0
Bulgaria,1948,Balkan Cup,6,7,2,2,1,5,-1,1
Bulgaria,1949,Friendly,5,9,1,2,1,4,-4,0
Bulgaria,1950,Friendly,3,6,0,3,1,4,-3,0
Bulgaria,1952,Friendly,1,0,1,0,0,1,1,0
Bulgaria,1953,FIFA World Cup qualification,3,7,0,3,1,4,-4,0
Bulgaria,1953,Friendly,3,3,0,0,3,3,0,0
Bulgaria,1954,Friendly,5,3,1,0,1,2,2,0
Bulgaria,1955,Friendly,10,7,3,2,2,7,3,0
Bulgaria,1956,Friendly,17,4,4,0,0,4,13,0
Bulgaria,1957,FIFA World Cup qualification,11,7,2,2,0,4,4,0
Bulgaria,1957,Friendly,4,8,0,1,3,4,-4,0
Bulgaria,1958,Friendly,3,11,1,3,2,6,-8,0
Bulgaria,1959,Friendly,6,3,3,0,0,3,3,0
Bulgaria,1959,UEFA Euro qualification,1,3,0,1,1,2,-2,0
Bulgaria,1960,FIFA World Cup qualification,0,3,0,1,0,1,-3,0
Bulgaria,1960,Friendly,12,11,4,2,0,6,1,0
Bulgaria,1961,FIFA World Cup qualification,7,1,4,0,0,4,6,1
Bulgaria,1961,Friendly,0,4,0,1,0,1,-4,0
Bulgaria,1962,FIFA World Cup,1,7,0,2,1,3,-6,0
Bulgaria,1962,Friendly,3,4,1,1,1,3,-1,0
Bulgaria,1962,UEFA Euro qualification,4,4,1,1,0,2,0,0
Bulgaria,1963,Friendly,4,4,1,1,2,4,0,0
Bulgaria,1963,UEFA Euro qualification,3,3,2,1,0,3,0,0
Bulgaria,1964,Friendly,0,2,0,2,2,4,-2,0
Bulgaria,1965,FIFA World Cup qualification,11,7,4,1,0,5,4,1
Bulgaria,1965,Friendly,8,4,2,0,1,3,4,0
Bulgaria,1966,FIFA World Cup,1,8,0,3,0,3,-7,0
Bulgaria,1966,Friendly,11,9,2,1,1,4,2,0
Bulgaria,1966,UEFA Euro qualification,4,2,1,0,0,1,2,0
Bulgaria,1967,Friendly,1,3,0,2,0,2,-2,0
Bulgaria,1967,UEFA Euro qualification,6,0,3,0,2,5,6,0
Bulgaria,1968,FIFA World Cup qualification,2,0,1,0,0,1,2,0
Bulgaria,1968,Friendly,3,1,1,0,1,2,2,0
Bulgaria,1968,UEFA Euro qualification,3,4,1,1,0,2,-1,0
Bulgaria,1969,FIFA World Cup qualification,10,7,3,1,1,5,3,0
Bulgaria,1969,Friendly,0,4,0,2,1,3,-4,0
Bulgaria,1970,FIFA World Cup,5,9,0,2,1,3,-4,0
Bulgaria,1970,Friendly,11,13,1,2,4,7,-2,0
Bulgaria,1970,UEFA Euro qualification,1,1,0,0,1,1,0,0
Bulgaria,1971,Friendly,4,3,1,0,2,3,1,0
Bulgaria,1971,UEFA Euro qualification,10,6,3,2,0,5,4,0
Bulgaria,1972,FIFA World Cup qualification,7,0,2,0,0,2,7,0
Bulgaria,1972,Friendly,2,3,0,1,2,3,-1,0
Bulgaria,1973,Balkan Cup,2,5,0,1,0,1,-3,0
Bulgaria,1973,FIFA World Cup qualification,6,3,2,0,2,4,3,0
Bulgaria,1973,Friendly,22,13,6,2,2,10,9,0
Bulgaria,1974,Balkan Cup,5,1,1,0,0,1,4,0
Bulgaria,1974,FIFA World Cup,2,5,0,1,2,3,-3,0
Bulgaria,1974,Friendly,16,10,4,4,3,11,6,0
Bulgaria,1974,UEFA Euro qualification,4,5,0,1,1,2,-1,0
Bulgaria,1975,Friendly,0,0,0,0,1,1,0,0
Bulgaria,1975,UEFA Euro qualification,8,2,2,1,1,4,6,1
Bulgaria,1976,Balkan Cup,3,3,1,1,0,2,0,0
Bulgaria,1976,FIFA World Cup qualification,2,2,0,0,1,1,0,0
Bulgaria,1976,Friendly,14,13,3,2,3,8,1,0
Bulgaria,1977,Balkan Cup,3,3,1,1,0,2,0,0
Bulgaria,1977,FIFA World Cup qualification,3,4,1,1,1,3,-1,0
Bulgaria,1977,Friendly,6,4,2,1,2,5,2,0
Bulgaria,1978,Balkan Cup,1,3,0,1,1,2,-2,0
Bulgaria,1978,Friendly,6,11,0,4,4,8,-5,0
Bulgaria,1978,UEFA Euro qualification,2,4,0,1,1,2,-2,0
Bulgaria,1979,Friendly,4,9,2,3,0,5,-5,0
Bulgaria,1979,UEFA Euro qualification,4,10,2,4,0,6,-6,0
Bulgaria,1980,FIFA World Cup qualification,5,4,2,1,0,3,1,0
Bulgaria,1980,Friendly,5,12,0,5,2,7,-7,0
Bulgaria,1981,FIFA World Cup qualification,6,6,2,2,1,5,0,0
Bulgaria,1981,Friendly,21,17,6,4,2,12,4,0
Bulgaria,1982,Friendly,21,12,2,4,2,8,9,0
Bulgaria,1982,UEFA Euro qualification,2,3,0,1,1,2,-1,0
Bulgaria,1983,Friendly,9,11,3,2,0,5,-2,0
Bulgaria,1983,UEFA Euro qualification,5,5,2,2,0,4,0,0
Bulgaria,1984,FIFA World Cup qualification,4,1,1,1,1,3,3,0
Bulgaria,1984,Friendly,5,6,0,1,4,5,-1,0
Bulgaria,1985,FIFA World Cup qualification,9,4,4,1,0,5,5,0
Bulgaria,1985,Friendly,7,10,2,3,2,7,-3,0
Bulgaria,1986,FIFA World Cup,2,6,0,2,2,4,-4,0
Bulgaria,1986,Friendly,10,7,2,2,2,6,3,0
Bulgaria,1986,UEFA Euro qualification,1,1,0,0,2,2,0,0
Bulgaria,1987,UEFA Euro qualification,11,5,4,2,0,6,6,0
Bulgaria,1988,FIFA World Cup qualification,2,4,0,1,1,2,-2,0
Bulgaria,1988,Friendly,18,12,5,2,3,10,6,0
Bulgaria,1989,FIFA World Cup qualification,4,4,1,3,0,4,0,0
Bulgaria,1989,Friendly,3,9,0,3,1,4,-6,0
Bulgaria,1990,Friendly,1,4,0,2,0,2,-3,0
Bulgaria,1990,UEFA Euro qualification,4,3,1,1,1,3,1,0
Bulgaria,1991,Friendly,3,5,1,1,2,4,-2,0
Bulgaria,1991,UEFA Euro qualification,11,5,2,1,2,5,6,0
Bulgaria,1992,FIFA World Cup qualification,7,2,3,1,0,4,5,0
Bulgaria,1992,Friendly,6,6,1,2,1,4,0,0
Bulgaria,1993,FIFA World Cup qualification,12,8,3,1,2,6,4,0
Bulgaria,1993,Friendly,3,5,1,2,0,3,-2,0
Bulgaria,1994,FIFA World Cup,10,11,3,3,1,7,-1,0
Bulgaria,1994,Friendly,5,5,0,0,4,4,0,0
Bulgaria,1994,UEFA Euro qualification,9,1,3,0,0,3,8,0
Bulgaria,1995,Friendly,1,4,0,1,1,2,-3,0
Bulgaria,1995,UEFA Euro qualification,15,9,4,2,1,7,6,0
Bulgaria,1996,FIFA World Cup qualification,6,4,2,1,0,3,2,0
Bulgaria,1996,Friendly,11,3,3,2,1,6,8,0
Bulgaria,1996,UEFA Euro,3,4,1,1,1,3,-1,0
Bulgaria,1997,FIFA World Cup qualification,12,5,4,1,0,5,7,0
Bulgaria,1997,Friendly,1,1,0,0,1,1,0,0
Bulgaria,1998,FIFA World Cup,1,7,0,2,1,3,-6,0
Bulgaria,1998,Friendly,4,4,2,2,1,5,0,0
Bulgaria,1998,UEFA Euro qualification,0,4,0,2,1,3,-4,0
Bulgaria,1999,Friendly,4,4,2,2,1,5,0,0
Bulgaria,1999,Lunar New Year Cup,1,3,0,1,0,1,-2,0
Bulgaria,1999,UEFA Euro qualification,6,4,2,2,1,5,2,0
Bulgaria,2000,FIFA World Cup qualification,4,2,1,1,1,3,2,0
Bulgaria,2000,Friendly,13,11,4,3,1,8,2,0
Bulgaria,2001,FIFA World Cup qualification,10,13,4,2,1,7,-3,0
Bulgaria,2001,Friendly,6,2,3,1,1,5,4,0
Bulgaria,2002,Friendly,2,7,0,3,2,5,-5,0
Bulgaria,2002,UEFA Euro qualification,6,1,3,0,0,3,5,0
Bulgaria,2003,Friendly,9,1,5,0,0,5,8,0
Bulgaria,2003,UEFA Euro qualification,7,3,2,1,2,5,4,0
Bulgaria,2004,FIFA World Cup qualification,9,4,2,0,1,3,5,0
Bulgaria,2004,Friendly,8,9,1,2,4,7,-1,0
Bulgaria,2004,UEFA Euro,1,9,0,3,0,3,-8,0
Bulgaria,2005,FIFA World Cup qualification,8,13,2,3,2,7,-5,0
Bulgaria,2005,Friendly,12,3,3,0,1,4,9,0
Bulgaria,2006,Friendly,2,3,1,1,1,3,-1,0
Bulgaria,2006,Kirin Cup,3,6,1,1,0,2,-3,0
Bulgaria,2006,UEFA Euro qualification,7,3,2,0,2,4,4,0
Bulgaria,2007,Cyprus International Tournament,5,0,2,0,0,2,5,1
Bulgaria,2007,Friendly,0,1,0,1,0,1,-1,0
Bulgaria,2007,UEFA Euro qualification,11,4,5,1,2,8,7,0
Bulgaria,2008,FIFA World Cup qualification,2,2,0,0,3,3,0,0
Bulgaria,2008,Friendly,6,8,3,1,0,4,-2,0
Bulgaria,2009,FIFA World Cup qualification,15,11,3,2,2,7,4,0
Bulgaria,2009,Friendly,6,2,2,0,1,3,4,0
Bulgaria,2010,Friendly,4,7,1,4,1,6,-3,0
Bulgaria,2010,UEFA Euro qualification,1,5,1,2,0,3,-4,0
Bulgaria,2011,Friendly,1,5,1,3,0,4,-4,0
Bulgaria,2011,UEFA Euro qualification,2,8,0,3,2,5,-6,0
Bulgaria,2012,FIFA World Cup qualification,4,3,1,0,3,4,1,0
Bulgaria,2012,Friendly,4,5,2,2,1,5,-1,0
Bulgaria,2013,FIFA World Cup qualification,10,6,2,3,1,6,4,0
Bulgaria,2013,Friendly,2,3,1,1,0,2,-1,0
Bulgaria,2013,Kirin Challenge Cup,2,0,1,0,0,1,2,1
Bulgaria,2014,Friendly,3,2,1,0,1,2,1,0
Bulgaria,2014,UEFA Euro qualification,4,5,1,2,1,4,-1,0
Bulgaria,2015,Friendly,0,4,0,1,0,1,-4,0
Bulgaria,2015,UEFA Euro qualification,5,7,2,3,1,6,-2,0
Bulgaria,2016,FIFA World Cup qualification,6,10,2,2,0,4,-4,0
Bulgaria,2016,Friendly,3,0,2,0,0,2,3,0
Bulgaria,2016,Kirin Cup,2,11,0,2,0,2,-9,0
Bulgaria,2017,FIFA World Cup qualification,8,9,2,3,1,6,-1,0
Bulgaria,2017,Friendly,1,0,1,0,0,1,1,0
Bulgaria,2018,Friendly,2,2,1,1,0,2,0,0
Bulgaria,2018,UEFA Nations League,7,5,3,1,2,6,2,0
Bulgaria,2019,Friendly,1,4,0,2,0,2,-3,0
Bulgaria,2019,UEFA Euro qualification,6,17,1,4,3,8,-11,0
Bulgaria,2020,Friendly,3,0,1,0,0,1,3,0
Bulgaria,2020,UEFA Euro qualification,1,3,0,1,0,1,-2,0
Bulgaria,2020,UEFA Nations League,2,7,0,4,2,6,-5,0
Bulgaria,2021,FIFA World Cup qualification,6,14,2,4,2,8,-8,0
Bulgaria,2021,Friendly,6,7,1,2,2,5,-1,0
Bulgaria,2022,Friendly,4,4,1,2,1,4,0,0
Bulgaria,2022,UEFA Nations League,10,8,2,1,3,6,2,0
Bulgaria,2023,Friendly,0,3,0,2,0,2,-3,0
Bulgaria,2023,UEFA Euro qualification,7,14,0,4,4,8,-7,0
Bulgaria,2024,FIFA Series,2,1,1,0,1,2,1,0
Bulgaria,2024,Friendly,1,1,0,0,2,2,0,0
Bulgaria,2024,UEFA Nations League,3,6,2,1,3,6,-3,0
Bulgaria,2025,UEFA Nations League,2,4,0,2,0,2,-2,0
Burkina Faso,1960,African Friendship Games,6,10,1,1,0,2,-4,0
Burkina Faso,1960,Friendly,6,10,1,1,0,2,-4,0
Burkina Faso,1961,African Friendship Games,6,3,1,1,0,2,3,0
Burkina Faso,1963,African Friendship Games,2,7,0,2,1,3,-5,0
Burkina Faso,1963,Friendly,0,1,0,1,0,1,-1,0
Burkina Faso,1967,African Cup of Nations qualification,2,10,0,4,0,4,-8,0
Burkina Faso,1967,Friendly,11,11,3,1,0,4,0,0
Burkina Faso,1968,Friendly,6,4,2,1,0,3,2,0
Burkina Faso,1970,Friendly,3,3,0,0,1,1,0,0
Burkina Faso,1971,Friendly,1,7,0,3,0,3,-6,0
Burkina Faso,1972,Friendly,3,3,0,0,1,1,0,0
Burkina Faso,1973,African Cup of Nations qualification,1,9,0,2,0,2,-8,0
Burkina Faso,1973,All-African Games,4,10,0,3,0,3,-6,0
Burkina Faso,1975,Friendly,5,4,1,1,0,2,1,0
Burkina Faso,1976,FIFA World Cup qualification,4,4,1,1,2,4,0,0
Burkina Faso,1976,Friendly,1,2,0,1,0,1,-1,0
Burkina Faso,1977,African Cup of Nations qualification,1,5,0,2,0,2,-4,0
Burkina Faso,1978,African Cup of Nations,2,9,0,3,0,3,-7,0
Burkina Faso,1978,Friendly,10,3,3,0,1,4,7,0
Burkina Faso,1979,Friendly,5,8,0,2,0,2,-3,0
Burkina Faso,1981,African Cup of Nations qualification,1,8,0,1,1,2,-7,0
Burkina Faso,1981,Friendly,1,3,0,2,0,2,-2,0
Burkina Faso,1982,Friendly,1,1,0,0,2,2,0,0
Burkina Faso,1982,West African Cup,4,5,1,2,1,4,-1,0
Burkina Faso,1984,Friendly,4,3,2,1,0,3,1,0
Burkina Faso,1984,West African Cup,6,7,1,1,3,5,-1,0
Burkina Faso,1986,West African Cup,2,7,1,4,1,6,-5,0
Burkina Faso,1987,Friendly,7,9,3,4,1,8,-2,0
Burkina Faso,1987,West African Cup,3,4,1,1,0,2,-1,0
Burkina Faso,1988,African Cup of Nations qualification,1,3,1,1,0,2,-2,1
Burkina Faso,1988,FIFA World Cup qualification,2,3,1,1,0,2,-1,0
Burkina Faso,1988,Friendly,3,0,1,0,0,1,3,0
Burkina Faso,1988,Tournament Burkina Faso,8,2,5,0,0,5,6,1
Burkina Faso,1990,African Cup of Nations qualification,4,2,2,1,0,3,2,0
Burkina Faso,1990,Friendly,2,2,1,1,1,3,0,0
Burkina Faso,1991,African Cup of Nations qualification,6,11,2,2,1,5,-5,0
Burkina Faso,1991,Friendly,5,7,1,1,1,3,-2,0
Burkina Faso,1992,Friendly,3,1,1,0,0,1,2,1
Burkina Faso,1993,Friendly,4,1,2,0,1,3,3,0
Burkina Faso,1994,African Cup of Nations qualification,2,1,1,0,0,1,1,0
Burkina Faso,1994,Friendly,2,5,0,2,3,5,-3,0
Burkina Faso,1995,African Cup of Nations qualification,3,3,0,0,3,3,0,0
Burkina Faso,1995,Friendly,4,10,0,2,1,3,-6,0
Burkina Faso,1996,African Cup of Nations,3,9,0,3,0,3,-6,0
Burkina Faso,1996,FIFA World Cup qualification,2,2,1,1,1,3,0,0
Burkina Faso,1996,Friendly,5,8,1,2,5,8,-3,0
Burkina Faso,1997,FIFA World Cup qualification,7,15,0,5,0,5,-8,0
Burkina Faso,1997,Friendly,6,3,2,1,2,5,3,0
Burkina Faso,1998,African Cup of Nations,8,9,2,2,2,6,-1,0
Burkina Faso,1998,Friendly,19,18,5,4,6,15,1,0
Burkina Faso,1999,African Cup of Nations qualification,8,5,2,0,2,4,3,0
Burkina Faso,1999,Friendly,16,17,4,4,2,10,-1,0
Burkina Faso,2000,African Cup of Nations,4,8,0,2,1,3,-4,0
Burkina Faso,2000,African Cup of Nations qualification,2,1,1,0,1,2,1,0
Burkina Faso,2000,FIFA World Cup qualification,5,3,1,1,1,3,2,0
Burkina Faso,2000,Friendly,6,7,2,2,2,6,-1,0
Burkina Faso,2001,African Cup of Nations qualification,2,2,2,1,1,4,0,0
Burkina Faso,2001,FIFA World Cup qualification,6,7,1,3,1,5,-1,0
Burkina Faso,2001,Friendly,7,12,1,5,1,7,-5,0
Burkina Faso,2002,African Cup of Nations,2,4,0,2,1,3,-2,0
Burkina Faso,2002,African Cup of Nations qualification,2,1,1,0,1,2,1,0
Burkina Faso,2002,Friendly,4,6,0,1,2,3,-2,0
Burkina Faso,2003,African Cup of Nations qualification,10,1,3,1,0,4,9,1
Burkina Faso,2003,Afro-Asian Games,1,4,0,1,0,1,-3,0
Burkina Faso,2003,Friendly,2,1,2,1,3,6,1,0
Burkina Faso,2004,African Cup of Nations,1,6,0,2,1,3,-5,0
Burkina Faso,2004,FIFA World Cup qualification,5,6,2,3,0,5,-1,0
Burkina Faso,2004,Friendly,10,13,2,3,2,7,-3,0
Burkina Faso,2005,FIFA World Cup qualification,9,7,2,2,1,5,2,0
Burkina Faso,2005,Friendly,0,5,0,3,0,3,-5,0
Burkina Faso,2006,African Cup of Nations qualification,2,2,1,1,0,2,0,0
Burkina Faso,2006,Friendly,2,2,1,1,2,4,0,0
Burkina Faso,2007,African Cup of Nations qualification,2,10,0,3,1,4,-8,0
Burkina Faso,2007,Friendly,3,5,0,2,1,3,-2,0
Burkina Faso,2008,FIFA World Cup qualification,14,5,5,0,1,6,9,0
Burkina Faso,2008,Friendly,1,4,0,2,0,2,-3,0
Burkina Faso,2009,FIFA World Cup qualification,10,11,4,2,0,6,-1,0
Burkina Faso,2009,Friendly,1,4,0,1,1,2,-3,0
Burkina Faso,2010,African Cup of Nations,0,1,0,1,1,2,-1,0
Burkina Faso,2010,African Cup of Nations qualification,3,1,1,0,0,1,2,0
Burkina Faso,2010,Friendly,6,2,2,0,1,3,4,0
Burkina Faso,2011,African Cup of Nations qualification,9,2,2,0,1,3,7,0
Burkina Faso,2011,Friendly,3,6,1,2,2,5,-3,0
Burkina Faso,2012,African Cup of Nations,2,6,0,3,0,3,-4,0
Burkina Faso,2012,African Cup of Nations qualification,3,2,1,1,0,2,1,0
Burkina Faso,2012,FIFA World Cup qualification,0,4,0,2,0,2,-4,0
Burkina Faso,2012,Friendly,6,4,2,1,3,6,2,0
Burkina Faso,2013,African Cup of Nations,7,3,2,1,3,6,4,0
Burkina Faso,2013,FIFA World Cup qualification,10,3,5,1,0,6,7,0
Burkina Faso,2013,Friendly,7,12,2,5,0,7,-5,0
Burkina Faso,2014,African Cup of Nations qualification,8,4,3,1,2,6,4,0
Burkina Faso,2014,Friendly,2,2,0,0,2,2,0,0
Burkina Faso,2015,African Cup of Nations,1,4,0,2,1,3,-3,0
Burkina Faso,2015,African Cup of Nations qualification,2,1,1,1,0,2,1,0
Burkina Faso,2015,FIFA World Cup qualification,3,2,1,1,0,2,1,0
Burkina Faso,2015,Friendly,10,9,2,3,2,7,1,0
Burkina Faso,2016,African Cup of Nations qualification,4,1,3,0,1,4,3,0
Burkina Faso,2016,FIFA World Cup qualification,3,1,1,0,1,2,2,0
Burkina Faso,2016,Friendly,0,3,0,2,0,2,-3,0
Burkina Faso,2017,African Cup of Nations,8,3,3,0,3,6,5,0
Burkina Faso,2017,African Cup of Nations qualification,3,1,1,0,0,1,2,0
Burkina Faso,2017,FIFA World Cup qualification,7,5,1,1,2,4,2,0
Burkina Faso,2017,Friendly,5,9,1,2,2,5,-4,0
Burkina Faso,2017,King's Cup,3,3,0,0,1,1,0,0
Burkina Faso,2018,African Cup of Nations qualification,4,4,1,2,1,4,0,0
Burkina Faso,2018,Friendly,3,2,2,1,0,3,1,0
Burkina Faso,2019,African Cup of Nations qualification,3,1,2,0,1,3,2,0
Burkina Faso,2019,Friendly,2,2,1,1,2,4,0,0
Burkina Faso,2020,African Cup of Nations qualification,3,1,1,0,1,2,2,0
Burkina Faso,2020,Friendly,5,1,2,0,0,2,4,0
Burkina Faso,2021,African Cup of Nations qualification,1,0,1,0,1,2,1,0
Burkina Faso,2021,FIFA World Cup qualification,12,4,3,0,3,6,8,0
Burkina Faso,2021,Friendly,1,3,0,2,1,3,-2,0
Burkina Faso,2022,African Cup of Nations,9,10,2,2,3,7,-1,0
Burkina Faso,2022,African Cup of Nations qualification,5,1,2,0,0,2,4,0
Burkina Faso,2022,Friendly,8,10,4,2,0,6,-2,0
Burkina Faso,2023,African Cup of Nations qualification,3,4,1,1,2,4,-1,0
Burkina Faso,2023,FIFA World Cup qualification,4,1,1,0,1,2,3,0
Burkina Faso,2023,Friendly,2,2,1,1,1,3,0,0
Burkina Faso,2024,African Cup of Nations,4,6,1,2,1,4,-2,0
Burkina Faso,2024,African Cup of Nations qualification,10,3,3,0,1,4,7,0
Burkina Faso,2024,FIFA World Cup qualification,3,4,0,1,1,2,-1,0
Burkina Faso,2024,Friendly,4,5,1,2,0,3,-1,0
Burkina Faso,2025,FIFA World Cup qualification,6,2,2,0,0,2,4,0
Burkina Faso,2025,Mapinduzi Cup,5,3,2,1,1,4,2,0
Burundi,1953,Friendly,1,9,0,1,0,1,-8,0
Burundi,1964,Friendly,5,7,0,1,0,1,-2,0
Burundi,1971,Friendly,1,4,0,1,0,1,-3,0
Burundi,1974,African Cup of Nations qualification,2,1,1,1,0,2,1,0
Burundi,1975,African Cup of Nations qualification,0,5,0,2,0,2,-5,0
Burundi,1976,Friendly,0,4,0,3,0,3,-4,0
Burundi,1981,Friendly,3,5,0,2,1,3,-2,0
Burundi,1982,Friendly,1,0,1,0,0,1,1,0
Burundi,1987,Friendly,6,4,1,0,2,3,2,0
Burundi,1992,African Cup of Nations qualification,3,2,1,0,1,2,1,0
Burundi,1992,FIFA World Cup qualification,2,3,1,1,0,2,-1,0
Burundi,1992,Friendly,1,0,1,0,0,1,1,0
Burundi,1993,African Cup of Nations qualification,2,2,0,0,3,3,0,0
Burundi,1993,FIFA World Cup qualification,0,1,0,1,1,2,-1,0
Burundi,1996,FIFA World Cup qualification,2,0,2,0,0,2,2,0
Burundi,1998,African Cup of Nations qualification,3,0,3,0,0,3,3,1
Burundi,1999,African Cup of Nations qualification,2,6,0,3,0,3,-4,0
Burundi,1999,CECAFA Cup,4,0,2,0,1,3,4,0
Burundi,1999,Friendly,0,0,0,0,1,1,0,0
Burundi,2000,African Cup of Nations qualification,4,2,2,1,1,4,2,0
Burundi,2000,CECAFA Cup,5,5,1,2,0,3,0,0
Burundi,2000,Friendly,3,3,1,1,0,2,0,0
Burundi,2001,African Cup of Nations qualification,2,5,0,3,1,4,-3,0
Burundi,2001,CECAFA Cup,6,3,2,1,0,3,3,0
Burundi,2001,Friendly,2,2,0,0,1,1,0,0
Burundi,2002,African Cup of Nations qualification,0,2,0,1,0,1,-2,0
Burundi,2002,CECAFA Cup,3,6,0,2,2,4,-3,0
Burundi,2003,African Cup of Nations qualification,1,9,0,3,0,3,-8,0
Burundi,2003,FIFA World Cup qualification,1,4,0,1,1,2,-3,0
Burundi,2003,Friendly,2,4,0,1,1,2,-2,0
Burundi,2004,CECAFA Cup,10,8,4,2,0,6,2,0
Burundi,2005,CECAFA Cup,2,6,0,3,1,4,-4,0
Burundi,2006,African Cup of Nations qualification,4,5,1,1,0,2,-1,0
Burundi,2006,CECAFA Cup,3,3,1,1,1,3,0,0
Burundi,2007,African Cup of Nations qualification,2,3,1,2,1,4,-1,0
Burundi,2007,CECAFA Cup,7,5,3,2,1,6,2,0
Burundi,2007,Friendly,0,1,0,1,0,1,-1,0
Burundi,2008,FIFA World Cup qualification,5,9,2,4,0,6,-4,0
Burundi,2008,Friendly,0,0,0,0,1,1,0,0
Burundi,2009,CECAFA Cup,8,17,2,6,1,9,-9,0
Burundi,2010,African Cup of Nations qualification,1,2,0,1,1,2,-1,0
Burundi,2010,CECAFA Cup,2,0,1,0,1,2,2,0
Burundi,2011,African Cup of Nations qualification,6,7,1,2,1,4,-1,0
Burundi,2011,CECAFA Cup,5,3,2,1,1,4,2,0
Burundi,2011,FIFA World Cup qualification,2,3,0,1,1,2,-1,0
Burundi,2011,Nile Basin Tournament,2,7,0,2,1,3,-5,0
Burundi,2012,African Cup of Nations qualification,2,2,1,1,0,2,0,0
Burundi,2012,CECAFA Cup,7,1,3,0,1,4,6,0
Burundi,2013,CECAFA Cup,5,6,1,3,0,4,-1,0
Burundi,2014,African Cup of Nations qualification,0,1,0,1,1,2,-1,0
Burundi,2014,Friendly,6,1,2,0,2,4,5,0
Burundi,2015,African Cup of Nations qualification,3,3,1,1,0,2,0,0
Burundi,2015,CECAFA Cup,2,2,1,1,1,3,0,0
Burundi,2015,FIFA World Cup qualification,5,6,2,2,0,4,-1,0
Burundi,2015,Friendly,2,2,0,0,1,1,0,0
Burundi,2016,African Cup of Nations qualification,5,9,1,3,0,4,-4,0
Burundi,2017,African Cup of Nations qualification,3,0,1,0,0,1,3,0
Burundi,2017,CECAFA Cup,5,4,1,2,2,5,1,0
Burundi,2017,Friendly,9,2,2,1,0,3,7,0
Burundi,2018,African Cup of Nations qualification,7,4,1,0,3,4,3,0
Burundi,2018,Friendly,1,1,0,0,1,1,0,0
Burundi,2019,African Cup of Nations,0,4,0,3,0,3,-4,0
Burundi,2019,African Cup of Nations qualification,1,6,0,2,1,3,-5,0
Burundi,2019,FIFA World Cup qualification,2,2,0,0,2,2,0,0
Burundi,2019,Friendly,2,3,0,1,1,2,-1,0
Burundi,2020,African Cup of Nations qualification,4,2,1,0,1,2,2,0
Burundi,2020,Friendly,1,0,1,0,0,1,1,0
Burundi,2021,African Cup of Nations qualification,2,3,0,1,1,2,-1,0
Burundi,2021,Friendly,10,3,2,1,0,3,7,0
Burundi,2022,African Cup of Nations qualification,1,2,0,1,1,2,-1,0
Burundi,2022,Friendly,2,6,1,2,0,3,-4,0
Burundi,2023,African Cup of Nations qualification,3,5,1,1,0,2,-2,0
Burundi,2023,FIFA World Cup qualification,4,4,1,1,0,2,0,0
Burundi,2023,Friendly,3,5,0,1,1,2,-2,0
Burundi,2024,African Cup of Nations qualification,4,9,1,3,0,4,-5,0
Burundi,2024,FIFA World Cup qualification,4,2,1,0,1,2,2,0
Burundi,2024,Friendly,0,4,0,1,0,1,-4,0
Burundi,2025,FIFA World Cup qualification,5,1,1,1,0,2,4,0
Cambodia,1954,Friendly,7,1,1,0,0,1,6,0
Cambodia,1956,AFC Asian Cup qualification,5,11,1,1,0,2,-6,0
Cambodia,1957,Friendly,1,3,0,1,0,1,-2,0
Cambodia,1957,Merdeka Tournament,1,6,0,2,1,3,-5,0
Cambodia,1961,Southeast Asian Peninsular Games,0,8,0,2,0,2,-8,0
Cambodia,1963,Friendly,2,9,0,2,0,2,-7,0
Cambodia,1964,Merdeka Tournament,0,9,0,3,0,3,-9,0
Cambodia,1965,Friendly,2,8,0,2,3,5,-6,0
Cambodia,1966,GaNEFo,10,8,1,2,1,4,2,0
Cambodia,1967,AFC Asian Cup qualification,0,1,0,1,0,1,-1,0
Cambodia,1970,Asian Games,3,3,1,2,0,3,0,0
Cambodia,1970,King's Cup,4,7,0,1,2,3,-3,0
Cambodia,1971,AFC Asian Cup qualification,8,8,2,2,1,5,0,0
Cambodia,1971,Indonesia Tournament,7,14,1,3,2,6,-7,0
Cambodia,1971,Korea Cup,4,9,0,3,0,3,-5,0
Cambodia,1971,Southeast Asian Peninsular Games,3,4,1,1,1,3,-1,0
Cambodia,1972,AFC Asian Cup,8,10,1,3,1,5,-2,0
Cambodia,1972,Friendly,1,7,0,2,0,2,-6,0
Cambodia,1972,Indonesia Tournament,8,0,3,0,0,3,8,1
Cambodia,1972,Korea Cup,2,4,1,2,1,4,-2,0
Cambodia,1972,Merdeka Tournament,11,13,2,2,1,5,-2,0
Cambodia,1972,Vietnam Independence Cup,3,2,2,1,0,3,1,0
Cambodia,1973,King's Cup,2,8,0,2,0,2,-6,0
Cambodia,1973,Korea Cup,5,8,2,1,1,4,-3,0
Cambodia,1973,Merdeka Tournament,2,13,0,5,1,6,-11,0
Cambodia,1974,King's Cup,6,8,2,3,0,5,-2,0
Cambodia,1974,Korea Cup,1,6,1,1,0,2,-5,0
Cambodia,1974,Vietnam Independence Cup,2,2,0,0,1,1,0,0
Cambodia,1995,Southeast Asian Games,0,32,0,4,0,4,-32,0
Cambodia,1996,AFF Championship,1,12,0,4,0,4,-11,0
Cambodia,1997,FIFA World Cup qualification,2,27,0,5,1,6,-25,0
Cambodia,1997,Southeast Asian Games,8,7,2,2,0,4,1,0
Cambodia,1998,AFF Championship qualification,1,4,0,1,1,2,-3,0
Cambodia,1998,Asian Games,2,9,0,2,0,2,-7,0
Cambodia,1999,AFC Asian Cup qualification,4,19,0,4,0,4,-15,0
Cambodia,1999,Southeast Asian Games,5,13,0,3,1,4,-8,0
Cambodia,2000,AFF Championship,5,10,1,3,0,4,-5,0
Cambodia,2000,Friendly,1,3,0,1,1,2,-2,0
Cambodia,2001,FIFA World Cup qualification,2,22,0,5,1,6,-20,0
Cambodia,2001,Friendly,0,1,0,1,0,1,-1,0
Cambodia,2002,AFF Championship,5,18,1,3,0,4,-13,0
Cambodia,2002,Friendly,0,5,0,1,0,1,-5,0
Cambodia,2004,AFF Championship,2,22,0,4,0,4,-20,0
Cambodia,2005,Friendly,0,2,0,1,0,1,-2,0
Cambodia,2006,AFC Challenge Cup,4,6,1,2,0,3,-2,0
Cambodia,2006,AFF Championship qualification,7,5,1,1,2,4,2,1
Cambodia,2007,FIFA World Cup qualification,1,5,0,2,0,2,-4,0
Cambodia,2007,Friendly,0,6,0,1,0,1,-6,0
Cambodia,2007,Nehru Cup,5,16,0,3,1,4,-11,0
Cambodia,2008,AFC Challenge Cup qualification,3,2,1,1,0,2,1,1
Cambodia,2008,AFF Championship,2,12,0,3,0,3,-10,0
Cambodia,2008,AFF Championship qualification,9,8,2,1,1,4,1,0
Cambodia,2008,Friendly,1,14,0,2,0,2,-13,0
Cambodia,2009,AFC Challenge Cup qualification,2,3,1,2,0,3,-1,0
Cambodia,2010,AFF Championship qualification,4,2,1,0,2,3,2,0
Cambodia,2011,AFC Challenge Cup qualification,8,15,1,4,0,5,-7,0
Cambodia,2011,FIFA World Cup qualification,6,8,1,1,0,2,-2,0
Cambodia,2012,AFF Championship qualification,3,12,0,4,0,4,-9,0
Cambodia,2012,Friendly,0,0,0,0,1,1,0,0
Cambodia,2013,AFC Challenge Cup qualification,0,15,0,2,0,2,-15,0
Cambodia,2013,Friendly,0,3,0,2,0,2,-3,0
Cambodia,2014,AFF Championship qualification,6,6,2,2,0,4,0,0
Cambodia,2014,Friendly,3,12,0,4,0,4,-9,0
Cambodia,2015,FIFA World Cup qualification,5,22,1,7,1,9,-17,0
Cambodia,2015,Friendly,11,4,3,1,1,5,7,0
Cambodia,2016,AFC Asian Cup qualification,2,0,1,0,0,1,2,0
Cambodia,2016,AFF Championship,4,8,0,3,0,3,-4,0
Cambodia,2016,AFF Championship qualification,8,3,3,0,0,3,5,1
Cambodia,2016,FIFA World Cup qualification,0,6,0,1,0,1,-6,0
Cambodia,2016,Friendly,12,11,3,4,0,7,1,0
Cambodia,2017,AFC Asian Cup qualification,2,15,1,4,0,5,-13,0
Cambodia,2017,Friendly,5,14,0,4,0,4,-9,0
Cambodia,2018,AFC Asian Cup qualification,1,2,0,1,0,1,-1,0
Cambodia,2018,AFF Championship,4,9,1,3,0,4,-5,0
Cambodia,2018,Friendly,5,7,1,2,1,4,-2,0
Cambodia,2019,FIFA World Cup qualification,5,23,2,4,1,7,-18,0
Cambodia,2019,Friendly,1,2,0,1,1,2,-1,0
Cambodia,2021,AFC Asian Cup qualification,3,1,2,0,0,2,2,1
Cambodia,2021,AFF Championship,6,11,1,3,0,4,-5,0
Cambodia,2021,FIFA World Cup qualification,1,22,0,3,0,3,-21,0
Cambodia,2022,AFC Asian Cup qualification,2,7,0,2,1,3,-5,0
Cambodia,2022,AFF Championship,9,5,2,1,0,3,4,0
Cambodia,2022,Friendly,2,6,1,2,0,3,-4,0
Cambodia,2023,AFF Championship,1,3,0,1,0,1,-2,0
Cambodia,2023,FIFA World Cup qualification,0,1,0,1,1,2,-1,0
Cambodia,2023,Friendly,5,2,1,1,1,3,3,0
Cambodia,2024,AFC Asian Cup qualification,2,2,0,0,2,2,0,0
Cambodia,2024,ASEAN Championship,7,8,1,2,1,4,-1,0
Cambodia,2024,FIFA Series,1,6,0,2,0,2,-5,0
Cambodia,2024,Friendly,6,7,2,2,0,4,-1,0
Cambodia,2025,Friendly,2,4,0,2,0,2,-2,0
Cameroon,1953,Friendly,3,2,1,0,0,1,1,0
Cameroon,1956,Friendly,4,2,1,0,0,1,2,0
Cameroon,1960,African Friendship Games,17,8,3,0,0,3,9,0
Cameroon,1960,Friendly,17,8,3,0,1,4,9,0
Cameroon,1961,African Friendship Games,6,4,1,1,0,2,2,0
Cameroon,1962,Friendly,6,8,1,2,1,4,-2,0
Cameroon,1963,African Friendship Games,3,3,1,1,0,2,0,0
Cameroon,1963,Friendly,4,8,1,2,0,3,-4,0
Cameroon,1964,Friendly,23,15,4,1,3,8,8,0
Cameroon,1966,Friendly,6,5,1,1,1,3,1,0
Cameroon,1967,African Cup of Nations qualification,2,7,0,2,1,3,-5,0
Cameroon,1968,FIFA World Cup qualification,3,4,0,1,1,2,-1,0
Cameroon,1968,Friendly,4,2,1,0,0,1,2,0
Cameroon,1969,African Cup of Nations qualification,7,5,2,1,1,4,2,0
Cameroon,1969,Friendly,3,5,0,2,0,2,-2,0
Cameroon,1970,African Cup of Nations,7,6,2,1,0,3,1,0
Cameroon,1970,Friendly,1,4,0,1,1,2,-3,0
Cameroon,1971,Friendly,9,7,1,2,1,4,2,0
Cameroon,1972,African Cup of Nations,10,5,3,1,1,5,5,0
Cameroon,1972,Friendly,1,2,0,1,0,1,-1,0
Cameroon,1973,African Cup of Nations qualification,2,3,1,1,0,2,-1,0
Cameroon,1973,FIFA World Cup qualification,1,3,1,2,0,3,-2,0
Cameroon,1974,Friendly,1,1,0,0,1,1,0,0
Cameroon,1975,African Cup of Nations qualification,3,4,1,1,0,2,-1,0
Cameroon,1975,Friendly,7,10,3,3,1,7,-3,0
Cameroon,1976,FIFA World Cup qualification,3,4,0,1,1,2,-1,0
Cameroon,1976,Friendly,2,1,1,0,0,1,1,0
Cameroon,1977,African Cup of Nations qualification,2,4,1,1,0,2,-2,0
Cameroon,1977,Friendly,2,2,0,0,1,1,0,0
Cameroon,1978,All-African Games,2,3,0,1,2,3,-1,0
Cameroon,1979,African Cup of Nations qualification,3,3,1,1,0,2,0,0
Cameroon,1979,Friendly,5,4,2,1,0,3,1,0
Cameroon,1980,FIFA World Cup qualification,6,2,2,1,1,4,4,0
Cameroon,1980,Friendly,1,1,0,0,2,2,0,0
Cameroon,1981,African Cup of Nations qualification,12,5,2,1,1,4,7,0
Cameroon,1981,FIFA World Cup qualification,10,3,3,1,0,4,7,0
Cameroon,1981,Friendly,3,1,1,0,1,2,2,0
Cameroon,1982,African Cup of Nations,1,1,0,0,3,3,0,0
Cameroon,1982,FIFA World Cup,1,1,0,0,3,3,0,0
Cameroon,1982,Friendly,5,3,2,0,3,5,2,0
Cameroon,1983,African Cup of Nations qualification,9,5,2,2,0,4,4,0
Cameroon,1983,Friendly,5,7,1,1,2,4,-2,0
Cameroon,1984,African Cup of Nations,9,3,3,1,1,5,6,1
Cameroon,1984,Friendly,4,8,1,2,0,3,-4,0
Cameroon,1984,UDEAC Cup,11,3,2,0,2,4,8,0
Cameroon,1985,FIFA World Cup qualification,2,5,0,1,1,2,-3,0
Cameroon,1985,Friendly,7,7,2,3,1,6,0,0
Cameroon,1985,UDEAC Cup,6,4,2,1,1,4,2,0
Cameroon,1986,African Cup of Nations,8,5,3,0,2,5,3,0
Cameroon,1986,Friendly,1,1,0,0,1,1,0,0
Cameroon,1986,UDEAC Cup,10,2,4,0,0,4,8,1
Cameroon,1987,African Cup of Nations qualification,8,5,2,2,0,4,3,0
Cameroon,1987,All-African Games,11,8,2,1,2,5,3,0
Cameroon,1987,UDEAC Cup,3,0,3,0,1,4,3,1
Cameroon,1988,African Cup of Nations,4,1,3,0,2,5,3,1
Cameroon,1988,UDEAC Cup,4,2,2,1,1,4,2,0
Cameroon,1989,FIFA World Cup qualification,12,6,6,1,1,8,6,1
Cameroon,1989,UDEAC Cup,5,2,3,0,1,4,3,1
Cameroon,1990,African Cup of Nations,2,3,1,2,0,3,-1,0
Cameroon,1990,African Cup of Nations qualification,1,1,0,0,2,2,0,0
Cameroon,1990,FIFA World Cup,7,9,3,2,0,5,-2,0
Cameroon,1990,Friendly,3,10,0,2,2,4,-7,0
Cameroon,1990,UDEAC Cup,7,3,3,1,0,4,4,0
Cameroon,1991,African Cup of Nations qualification,4,0,3,0,1,4,4,0
Cameroon,1991,Dakar Tournament,1,1,0,0,2,2,0,0
Cameroon,1991,Friendly,8,8,4,3,2,9,0,0
Cameroon,1992,African Cup of Nations,4,3,2,1,2,5,1,0
Cameroon,1992,African Cup of Nations qualification,2,0,1,0,1,2,2,0
Cameroon,1992,FIFA World Cup qualification,5,0,1,0,0,1,5,0
Cameroon,1992,Friendly,6,8,1,3,3,7,-2,0
Cameroon,1993,African Cup of Nations qualification,5,0,2,0,2,4,5,0
Cameroon,1993,FIFA World Cup qualification,9,4,4,1,2,7,5,0
Cameroon,1993,Friendly,0,1,0,1,0,1,-1,0
Cameroon,1993,Nehru Cup,5,3,1,0,3,4,2,0
Cameroon,1994,African Cup of Nations qualification,1,0,1,0,0,1,1,0
Cameroon,1994,FIFA World Cup,3,11,0,2,1,3,-8,0
Cameroon,1994,Friendly,9,7,1,1,5,7,2,0
Cameroon,1994,Simba Tournament,2,4,0,2,1,3,-2,0
Cameroon,1995,African Cup of Nations qualification,6,7,2,2,1,5,-1,0
Cameroon,1995,Friendly,4,7,2,2,1,5,-3,0
Cameroon,1996,African Cup of Nations,5,7,1,1,1,3,-2,0
Cameroon,1996,African Cup of Nations qualification,0,0,0,0,1,1,0,0
Cameroon,1996,FIFA World Cup qualification,4,2,1,0,0,1,2,0
Cameroon,1996,Friendly,0,2,0,1,0,1,-2,0
Cameroon,1997,African Cup of Nations qualification,7,3,1,0,2,3,4,0
Cameroon,1997,FIFA World Cup qualification,6,2,3,0,2,5,4,0
Cameroon,1997,Friendly,10,20,2,6,2,10,-10,0
Cameroon,1998,African Cup of Nations,5,4,2,1,1,4,1,0
Cameroon,1998,FIFA World Cup,2,5,0,1,2,3,-3,0
Cameroon,1998,Friendly,9,3,5,1,2,8,6,0
Cameroon,1999,African Cup of Nations qualification,8,1,3,0,1,4,7,0
Cameroon,2000,African Cup of Nations,11,5,3,1,2,6,6,0
Cameroon,2000,FIFA World Cup qualification,12,0,4,0,0,4,12,0
Cameroon,2000,Friendly,3,3,0,0,3,3,0,0
Cameroon,2001,Confederations Cup,2,4,1,2,0,3,-2,0
Cameroon,2001,FIFA World Cup qualification,8,4,4,1,1,6,4,0
Cameroon,2001,Friendly,3,1,1,0,2,3,2,0
Cameroon,2002,African Cup of Nations,9,0,5,0,1,6,9,0
Cameroon,2002,FIFA World Cup,2,3,1,1,1,3,-1,0
Cameroon,2002,Friendly,9,7,2,1,3,6,2,0
Cameroon,2003,Confederations Cup,3,1,3,1,1,5,2,0
Cameroon,2003,Friendly,2,4,1,2,1,4,-2,0
Cameroon,2004,African Cup of Nations,7,6,1,1,2,4,1,0
Cameroon,2004,FIFA World Cup qualification,7,5,2,1,2,5,2,0
Cameroon,2004,Friendly,0,6,0,2,0,2,-6,0
Cameroon,2005,FIFA World Cup qualification,11,5,4,0,1,5,6,0
Cameroon,2005,Friendly,2,0,2,0,1,3,2,0
Cameroon,2006,African Cup of Nations,8,2,3,0,1,4,6,0
Cameroon,2006,African Cup of Nations qualification,6,0,2,0,0,2,6,0
Cameroon,2006,Friendly,1,2,0,1,1,2,-1,0
Cameroon,2007,African Cup of Nations qualification,7,4,3,1,0,4,3,0
Cameroon,2007,Friendly,3,5,0,1,2,3,-2,0
Cameroon,2008,African Cup of Nations,14,8,4,2,0,6,6,0
Cameroon,2008,FIFA World Cup qualification,14,2,5,0,1,6,12,0
Cameroon,2008,Friendly,2,3,0,1,0,1,-1,0
Cameroon,2009,FIFA World Cup qualification,9,2,4,1,1,6,7,0
Cameroon,2009,Friendly,6,3,2,1,1,4,3,0
Cameroon,2010,African Cup of Nations,6,8,1,2,1,4,-2,0
Cameroon,2010,African Cup of Nations qualification,4,2,1,0,1,2,2,0
Cameroon,2010,FIFA World Cup,2,5,0,3,0,3,-3,0
Cameroon,2010,Friendly,11,9,2,2,3,7,2,0
Cameroon,2011,African Cup of Nations qualification,8,3,2,1,1,4,5,0
Cameroon,2011,Friendly,7,4,2,0,4,6,3,0
Cameroon,2012,African Cup of Nations qualification,4,3,3,1,0,4,1,1
Cameroon,2012,FIFA World Cup qualification,2,2,1,1,0,2,0,0
Cameroon,2012,Friendly,3,6,1,2,2,5,-3,0
Cameroon,2012,Nehru Cup,13,5,3,0,2,5,8,0
Cameroon,2013,FIFA World Cup qualification,10,2,4,0,2,6,8,0
Cameroon,2013,Friendly,0,1,0,1,1,2,-1,0
Cameroon,2014,African Cup of Nations qualification,9,1,4,0,2,6,8,0
Cameroon,2014,FIFA World Cup,1,9,0,3,0,3,-8,0
Cameroon,2014,Friendly,7,9,2,2,1,5,-2,0
Cameroon,2015,African Cup of Nations,2,3,0,1,2,3,-1,0
Cameroon,2015,African Cup of Nations qualification,2,0,2,0,0,2,2,0
Cameroon,2015,FIFA World Cup qualification,3,0,1,0,1,2,3,0
Cameroon,2015,Friendly,10,10,3,1,3,7,0,0
Cameroon,2016,African Cup of Nations qualification,5,2,2,0,2,4,3,0
Cameroon,2016,FIFA World Cup qualification,2,2,0,0,2,2,0,0
Cameroon,2016,Friendly,5,5,1,1,2,4,0,0
Cameroon,2017,African Cup of Nations,7,3,3,0,3,6,4,1
Cameroon,2017,African Cup of Nations qualification,1,0,1,0,0,1,1,0
Cameroon,2017,Confederations Cup,2,6,0,2,1,3,-4,0
Cameroon,2017,FIFA World Cup qualification,5,7,1,1,2,4,-2,0
Cameroon,2017,Friendly,5,7,2,2,1,5,-2,0
Cameroon,2018,African Cup of Nations qualification,2,3,1,1,2,4,-1,0
Cameroon,2018,Friendly,3,3,1,2,0,3,0,0
Cameroon,2019,African Cup of Nations,4,3,1,1,2,4,1,0
Cameroon,2019,African Cup of Nations qualification,4,0,2,0,1,3,4,0
Cameroon,2019,Friendly,3,2,1,0,2,3,1,0
Cameroon,2020,African Cup of Nations qualification,6,1,2,0,0,2,5,0
Cameroon,2020,Friendly,0,0,0,0,2,2,0,0
Cameroon,2021,African Cup of Nations qualification,1,3,0,1,1,2,-2,0
Cameroon,2021,FIFA World Cup qualification,12,3,5,1,0,6,9,0
Cameroon,2021,Friendly,1,0,1,0,1,2,1,0
Cameroon,2022,African Cup of Nations,14,7,4,0,3,7,7,0
Cameroon,2022,African Cup of Nations qualification,1,0,1,0,0,1,1,0
Cameroon,2022,FIFA World Cup,4,4,1,1,1,3,0,0
Cameroon,2022,FIFA World Cup qualification,2,2,1,1,0,2,0,0
Cameroon,2022,Friendly,2,5,0,2,2,4,-3,0
Cameroon,2023,African Cup of Nations qualification,5,3,1,1,1,3,2,0
Cameroon,2023,FIFA World Cup qualification,4,1,1,0,1,2,3,0
Cameroon,2023,Friendly,2,4,0,2,1,3,-2,0
Cameroon,2024,African Cup of Nations,5,8,1,2,1,4,-3,0
Cameroon,2024,African Cup of Nations qualification,6,1,3,0,0,3,5,0
Cameroon,2024,FIFA World Cup qualification,5,2,1,0,1,2,3,0
Cameroon,2024,Friendly,1,1,0,0,1,1,0,0
Cameroon,2025,FIFA World Cup qualification,3,1,1,0,1,2,2,0
Canada,1885,Friendly,1,0,1,0,0,1,1,1
Canada,1886,Friendly,2,3,0,1,0,1,-1,0
Canada,1888,Friendly,0,4,0,1,0,1,-4,0
Canada,1919,Inter-Allied Games,8,13,0,3,0,3,-5,0
Canada,1921,Friendly,0,1,0,1,0,1,-1,0
Canada,1924,Friendly,8,9,2,3,1,6,-1,0
Canada,1925,Friendly,2,6,1,1,0,2,-4,0
Canada,1926,Friendly,2,6,0,1,0,1,-4,0
Canada,1927,Friendly,8,5,2,1,1,4,3,0
Canada,1957,FIFA World Cup qualification,8,8,2,2,0,4,0,0
Canada,1968,FIFA World Cup qualification,8,3,2,1,1,4,5,0
Canada,1972,CONCACAF Championship qualification,6,7,1,2,1,4,-1,0
Canada,1972,Friendly,2,2,0,0,1,1,0,0
Canada,1973,Friendly,5,12,2,4,1,7,-7,0
Canada,1974,Friendly,0,4,0,2,1,3,-4,0
Canada,1975,Friendly,3,26,0,5,0,5,-23,0
Canada,1976,CONCACAF Championship qualification,5,3,2,1,2,5,2,0
Canada,1977,CONCACAF Championship,7,8,2,2,1,5,-1,0
Canada,1977,Friendly,1,1,0,0,1,1,0,0
Canada,1980,CONCACAF Championship qualification,4,3,1,0,3,4,1,0
Canada,1980,Friendly,8,2,3,1,0,4,6,0
Canada,1981,CONCACAF Championship,6,6,1,1,3,5,0,0
Canada,1981,Friendly,4,2,1,0,0,1,2,0
Canada,1983,Friendly,3,14,1,5,0,6,-11,0
Canada,1984,Friendly,3,9,1,5,0,6,-6,0
Canada,1985,CONCACAF Championship,11,4,5,0,3,8,7,1
Canada,1985,Friendly,8,5,3,1,4,8,3,0
Canada,1985,Korea Cup,3,7,1,1,0,2,-4,0
Canada,1986,FIFA World Cup,0,5,0,3,0,3,-5,0
Canada,1986,Friendly,2,7,1,3,1,5,-5,0
Canada,1986,Merlion Cup,2,3,2,2,1,5,-1,1
Canada,1986,Miami Cup,1,3,0,1,0,1,-2,0
Canada,1987,Friendly,2,7,0,2,1,3,-5,0
Canada,1988,CONCACAF Championship qualification,3,3,1,1,0,2,0,0
Canada,1988,Friendly,10,9,3,4,2,9,1,0
Canada,1988,Matthews Cup,1,3,1,1,1,3,-2,0
Canada,1989,Friendly,1,5,1,3,0,4,-4,0
Canada,1990,NAFU Championship,2,1,1,0,0,1,1,1
Canada,1991,Gold Cup,6,9,1,2,0,3,-3,0
Canada,1991,NAFU Championship,0,5,0,2,0,2,-5,0
Canada,1992,FIFA World Cup qualification,9,7,2,1,3,6,2,0
Canada,1992,Friendly,9,8,2,2,1,5,1,0
Canada,1993,FIFA World Cup qualification,13,13,4,3,1,8,0,0
Canada,1993,Friendly,3,2,2,1,0,3,1,0
Canada,1993,Gold Cup,3,11,0,1,2,3,-8,0
Canada,1994,Friendly,2,9,0,3,2,5,-7,0
Canada,1995,Friendly,11,13,3,4,1,8,-2,0
Canada,1996,FIFA World Cup qualification,10,1,5,0,1,6,9,0
Canada,1996,Friendly,0,1,0,1,0,1,-1,0
Canada,1996,Gold Cup,4,5,1,1,0,2,-1,0
Canada,1997,FIFA World Cup qualification,5,20,1,6,3,10,-15,0
Canada,1997,Friendly,0,1,0,1,0,1,-1,0
Canada,1998,Friendly,1,0,1,0,0,1,1,0
Canada,1999,Friendly,6,6,3,3,1,7,0,0
Canada,1999,Gold Cup qualification,4,2,2,0,1,3,2,0
Canada,2000,FIFA World Cup qualification,2,8,2,3,3,8,-6,0
Canada,2000,Friendly,5,1,3,0,1,4,4,0
Canada,2000,Gold Cup,7,3,3,0,2,5,4,1
Canada,2001,Confederations Cup,0,5,0,2,1,3,-5,0
Canada,2001,Friendly,2,5,1,2,0,3,-3,0
Canada,2002,Friendly,4,4,1,1,0,2,0,0
Canada,2002,Gold Cup,5,4,2,1,2,5,1,1
Canada,2003,Friendly,9,23,1,6,0,7,-14,0
Canada,2003,Gold Cup,1,2,1,1,0,2,-1,0
Canada,2004,FIFA World Cup qualification,12,8,3,3,2,8,4,0
Canada,2004,Friendly,1,1,1,1,0,2,0,0
Canada,2005,Friendly,5,8,2,3,0,5,-3,0
Canada,2005,Gold Cup,2,4,1,2,0,3,-2,0
Canada,2006,Friendly,4,3,2,2,1,5,1,0
Canada,2007,Friendly,7,6,1,1,3,5,1,0
Canada,2007,Gold Cup,9,5,3,2,0,5,4,0
Canada,2008,FIFA World Cup qualification,13,14,2,4,2,8,-1,0
Canada,2008,Friendly,5,7,1,2,1,4,-2,0
Canada,2009,Friendly,4,4,2,2,0,4,0,0
Canada,2009,Gold Cup,4,3,2,1,1,4,1,0
Canada,2010,Friendly,5,12,1,3,2,6,-7,0
Canada,2011,FIFA World Cup qualification,18,1,4,0,2,6,17,0
Canada,2011,Friendly,3,3,1,1,1,3,0,0
Canada,2011,Gold Cup,2,3,1,1,1,3,-1,0
Canada,2012,FIFA World Cup qualification,6,10,3,2,1,6,-4,0
Canada,2012,Friendly,3,3,1,1,1,3,0,0
Canada,2013,Friendly,1,12,0,7,2,9,-11,0
Canada,2013,Gold Cup,0,3,0,2,1,3,-3,0
Canada,2014,Friendly,2,2,0,0,3,3,0,0
Canada,2015,FIFA World Cup qualification,11,1,4,0,1,5,10,0
Canada,2015,Friendly,3,3,1,1,1,3,0,0
Canada,2015,Gold Cup,0,1,0,1,2,3,-1,0
Canada,2016,FIFA World Cup qualification,4,8,1,3,0,4,-4,0
Canada,2016,Friendly,7,8,2,2,1,5,-1,0
Canada,2017,Friendly,9,5,3,1,1,5,4,0
Canada,2017,Gold Cup,6,5,1,1,2,4,1,0
Canada,2018,CONCACAF Nations League qualification,14,0,3,0,0,3,14,0
Canada,2018,Friendly,1,0,1,0,0,1,1,0
Canada,2019,CONCACAF Nations League,10,4,3,1,0,4,6,0
Canada,2019,CONCACAF Nations League qualification,4,1,1,0,0,1,3,0
Canada,2019,Gold Cup,14,6,2,2,0,4,8,0
Canada,2020,Friendly,8,3,2,1,0,3,5,0
Canada,2021,FIFA World Cup qualification,44,6,10,0,4,14,38,0
Canada,2021,Gold Cup,11,5,3,2,0,5,6,0
Canada,2022,CONCACAF Nations League,5,2,1,1,0,2,3,0
Canada,2022,FIFA World Cup,2,7,0,3,0,3,-5,0
Canada,2022,FIFA World Cup qualification,10,2,4,2,0,6,8,0
Canada,2022,Friendly,6,5,2,1,1,4,1,0
Canada,2023,CONCACAF Nations League,12,7,4,2,0,6,5,0
Canada,2023,Friendly,1,4,0,1,0,1,-3,0
Canada,2023,Gold Cup,8,6,1,0,3,4,2,0
Canada,2024,CONCACAF Nations League,4,0,2,0,0,2,4,0
Canada,2024,Copa América,4,7,1,2,3,6,-3,0
Canada,2024,Copa América qualification,2,0,1,0,0,1,2,1
Canada,2024,Friendly,4,6,2,1,2,5,-2,0
Canada,2025,CONCACAF Nations League,2,3,1,1,0,2,-1,1
Canary Islands,1996,Friendly,5,1,1,0,0,1,4,0
Canary Islands,1998,Friendly,4,0,1,0,0,1,4,0
Canary Islands,2002,Friendly,0,2,0,1,0,1,-2,0
Canary Islands,2007,Friendly,2,0,1,0,0,1,2,1
Cape Verde,1959,Friendly,2,3,0,1,0,1,-1,0
Cape Verde,1979,Amílcar Cabral Cup,0,4,0,2,0,2,-4,0
Cape Verde,1981,Amílcar Cabral Cup,4,8,1,3,0,4,-4,0
Cape Verde,1982,Amílcar Cabral Cup,5,5,2,3,0,5,0,0
Cape Verde,1983,Amílcar Cabral Cup,1,2,1,1,0,2,-1,0
Cape Verde,1984,Amílcar Cabral Cup,1,5,0,2,1,3,-4,0
Cape Verde,1985,Amílcar Cabral Cup,6,5,2,2,1,5,1,0
Cape Verde,1985,Friendly,0,0,0,0,1,1,0,0
Cape Verde,1987,Amílcar Cabral Cup,0,4,0,2,0,2,-4,0
Cape Verde,1988,Amílcar Cabral Cup,5,6,1,1,1,3,-1,0
Cape Verde,1988,Friendly,2,4,0,2,0,2,-2,0
Cape Verde,1989,Amílcar Cabral Cup,6,6,2,2,1,5,0,0
Cape Verde,1991,Amílcar Cabral Cup,2,2,1,1,2,4,0,0
Cape Verde,1992,African Cup of Nations qualification,2,4,1,2,0,3,-2,0
Cape Verde,1995,Amílcar Cabral Cup,3,3,2,1,1,4,0,0
Cape Verde,1997,Amílcar Cabral Cup,3,7,0,2,1,3,-4,0
Cape Verde,1998,African Cup of Nations qualification,0,3,0,1,1,2,-3,0
Cape Verde,1998,Friendly,0,1,0,1,0,1,-1,0
Cape Verde,2000,Amílcar Cabral Cup,7,3,3,0,2,5,4,0
Cape Verde,2000,FIFA World Cup qualification,0,2,0,1,1,2,-2,0
Cape Verde,2000,Friendly,1,1,0,0,1,1,0,0
Cape Verde,2001,Amílcar Cabral Cup,1,1,0,0,1,1,0,0
Cape Verde,2001,Friendly,1,0,1,0,0,1,1,0
Cape Verde,2002,African Cup of Nations qualification,2,1,1,1,0,2,1,0
Cape Verde,2002,Friendly,0,0,0,0,1,1,0,0
Cape Verde,2003,African Cup of Nations qualification,7,7,2,2,0,4,0,0
Cape Verde,2003,FIFA World Cup qualification,4,1,1,0,1,2,3,0
Cape Verde,2003,Friendly,1,2,0,1,0,1,-1,0
Cape Verde,2004,FIFA World Cup qualification,4,5,2,2,1,5,-1,0
Cape Verde,2004,Friendly,1,3,0,1,0,1,-2,0
Cape Verde,2005,FIFA World Cup qualification,4,10,1,4,0,5,-6,0
Cape Verde,2005,Friendly,1,2,0,1,0,1,-1,0
Cape Verde,2006,African Cup of Nations qualification,1,2,1,1,0,2,-1,0
Cape Verde,2006,Friendly,1,4,0,1,0,1,-3,0
Cape Verde,2007,African Cup of Nations qualification,2,8,0,2,2,4,-6,0
Cape Verde,2007,Amílcar Cabral Cup,1,1,0,0,2,2,0,0
Cape Verde,2008,FIFA World Cup qualification,7,8,3,3,0,6,-1,0
Cape Verde,2008,Friendly,2,1,1,0,1,2,1,0
Cape Verde,2009,Friendly,9,1,3,0,1,4,8,0
Cape Verde,2010,African Cup of Nations qualification,1,0,1,0,1,2,1,0
Cape Verde,2010,Friendly,2,2,1,1,1,3,0,0
Cape Verde,2011,African Cup of Nations qualification,6,7,2,2,0,4,-1,0
Cape Verde,2011,Friendly,1,0,1,0,0,1,1,0
Cape Verde,2012,African Cup of Nations qualification,10,3,3,1,0,4,7,0
Cape Verde,2012,FIFA World Cup qualification,2,4,0,2,0,2,-2,0
Cape Verde,2012,Friendly,0,1,0,1,0,1,-1,0
Cape Verde,2013,African Cup of Nations,3,4,1,1,2,4,-1,0
Cape Verde,2013,FIFA World Cup qualification,7,3,3,1,0,4,4,0
Cape Verde,2013,Friendly,2,5,0,1,2,3,-3,0
Cape Verde,2014,African Cup of Nations qualification,9,6,4,2,0,6,3,0
Cape Verde,2014,Friendly,0,0,0,0,1,1,0,0
Cape Verde,2015,African Cup of Nations,1,1,0,0,3,3,0,0
Cape Verde,2015,African Cup of Nations qualification,9,2,2,0,0,2,7,0
Cape Verde,2015,FIFA World Cup qualification,2,1,1,1,0,2,1,0
Cape Verde,2015,Friendly,5,2,2,0,0,2,3,0
Cape Verde,2016,African Cup of Nations qualification,2,5,1,3,0,4,-3,0
Cape Verde,2016,FIFA World Cup qualification,0,4,0,2,0,2,-4,0
Cape Verde,2017,African Cup of Nations qualification,0,1,0,1,0,1,-1,0
Cape Verde,2017,FIFA World Cup qualification,4,8,2,2,0,4,-4,0
Cape Verde,2017,Friendly,2,0,1,0,0,1,2,0
Cape Verde,2018,African Cup of Nations qualification,4,4,1,2,1,4,0,0
Cape Verde,2018,Friendly,3,2,1,0,1,2,1,0
Cape Verde,2019,African Cup of Nations qualification,2,2,0,0,3,3,0,0
Cape Verde,2019,Friendly,2,1,1,0,0,1,1,0
Cape Verde,2020,African Cup of Nations qualification,0,0,0,0,2,2,0,0
Cape Verde,2020,Friendly,3,3,1,1,0,2,0,0
Cape Verde,2021,African Cup of Nations qualification,4,1,2,0,0,2,3,0
Cape Verde,2021,FIFA World Cup qualification,8,6,3,1,2,6,2,0
Cape Verde,2021,Friendly,0,2,0,1,0,1,-2,0
Cape Verde,2022,African Cup of Nations,2,4,1,2,1,4,-2,0
Cape Verde,2022,African Cup of Nations qualification,2,2,1,1,0,2,0,0
Cape Verde,2022,Friendly,12,2,4,1,0,5,10,0
Cape Verde,2023,African Cup of Nations qualification,6,4,2,1,1,4,2,0
Cape Verde,2023,FIFA World Cup qualification,2,0,1,0,1,2,2,0
Cape Verde,2023,Friendly,2,7,0,2,1,3,-5,0
Cape Verde,2024,African Cup of Nations,8,3,3,0,2,5,5,0
Cape Verde,2024,African Cup of Nations qualification,2,5,1,3,0,4,-3,0
Cape Verde,2024,FIFA Series,2,0,2,0,0,2,2,0
Cape Verde,2024,FIFA World Cup qualification,2,4,1,1,0,2,-2,0
Cape Verde,2024,Friendly,0,2,0,1,0,1,-2,0
Cape Verde,2025,FIFA World Cup qualification,3,1,2,0,0,2,2,0
Cascadia,2018,CONIFA World Football Cup,17,11,3,2,1,6,6,0
Cascadia,2019,Friendly,6,3,1,0,0,1,3,0
Catalonia,1912,Friendly,1,7,1,1,0,2,-6,0
Catalonia,1915,Friendly,3,9,0,2,1,3,-6,0
Catalonia,1916,Friendly,1,8,0,2,1,3,-7,0
Catalonia,1921,Friendly,5,0,2,0,0,2,5,0
Catalonia,1924,Friendly,1,9,0,2,0,2,-8,0
Catalonia,1925,Friendly,2,1,1,0,0,1,1,1
Catalonia,1926,Friendly,1,2,0,1,0,1,-1,0
Catalonia,1930,Friendly,0,1,0,1,0,1,-1,0
Catalonia,1931,Friendly,2,3,0,1,0,1,-1,0
Catalonia,1934,Friendly,4,5,1,1,1,3,-1,0
Catalonia,1947,Friendly,3,1,1,0,0,1,2,0
Catalonia,1953,Friendly,0,6,0,1,0,1,-6,0
Catalonia,1971,Friendly,2,1,1,0,0,1,1,0
Catalonia,1976,Friendly,1,1,0,0,1,1,0,0
Catalonia,1997,Friendly,1,1,0,0,1,1,0,0
Catalonia,1998,Friendly,5,0,1,0,0,1,5,0
Catalonia,1999,Friendly,1,0,1,0,0,1,1,0
Catalonia,2000,Friendly,5,0,1,0,0,1,5,0
Catalonia,2001,Friendly,1,0,1,0,0,1,1,0
Catalonia,2002,Friendly,3,3,1,1,0,2,0,0
Catalonia,2003,Friendly,4,2,1,0,0,1,2,1
Catalonia,2004,Friendly,2,8,0,2,0,2,-6,0
Catalonia,2005,Friendly,1,1,0,0,1,1,0,0
Catalonia,2006,Friendly,4,2,1,0,1,2,2,0
Catalonia,2007,Friendly,1,1,0,0,1,1,0,0
Catalonia,2008,Friendly,2,2,1,1,0,2,0,0
Catalonia,2009,Friendly,4,2,1,0,0,1,2,0
Catalonia,2010,Friendly,4,0,1,0,0,1,4,0
Catalonia,2011,Friendly,0,0,0,0,1,1,0,0
Catalonia,2013,Friendly,5,2,1,0,1,2,3,1
Catalonia,2014,Friendly,1,1,0,0,1,1,0,0
Catalonia,2015,Friendly,0,1,0,1,0,1,-1,0
Catalonia,2016,Friendly,3,3,0,0,1,1,0,0
Catalonia,2019,Friendly,2,1,1,0,0,1,1,0
Cayman Islands,1985,CFU Caribbean Cup qualification,1,2,0,1,0,1,-1,0
Cayman Islands,1987,Friendly,1,3,0,1,0,1,-2,0
Cayman Islands,1990,CFU Caribbean Cup qualification,1,1,0,0,1,1,0,0
Cayman Islands,1990,Friendly,1,2,0,1,0,1,-1,0
Cayman Islands,1991,CFU Caribbean Cup,3,5,0,2,0,2,-2,0
Cayman Islands,1991,CFU Caribbean Cup qualification,3,2,1,0,1,2,1,0
Cayman Islands,1992,CFU Caribbean Cup qualification,2,11,0,2,0,2,-9,0
Cayman Islands,1993,CFU Caribbean Cup qualification,3,13,0,3,0,3,-10,0
Cayman Islands,1993,Friendly,1,8,0,1,0,1,-7,0
Cayman Islands,1994,CFU Caribbean Cup,3,6,0,2,1,3,-3,0
Cayman Islands,1994,CFU Caribbean Cup qualification,13,2,3,0,0,3,11,0
Cayman Islands,1995,CFU Caribbean Cup,5,12,2,2,0,4,-7,0
Cayman Islands,1995,Friendly,1,12,0,2,0,2,-11,0
Cayman Islands,1996,CFU Caribbean Cup qualification,0,4,0,1,0,1,-4,0
Cayman Islands,1996,FIFA World Cup qualification,0,6,0,2,0,2,-6,0
Cayman Islands,1998,CFU Caribbean Cup,2,5,1,2,0,3,-3,0
Cayman Islands,1998,CFU Caribbean Cup qualification,4,2,1,0,1,2,2,1
Cayman Islands,1999,CFU Caribbean Cup qualification,6,9,1,2,0,3,-3,1
Cayman Islands,1999,Friendly,6,8,1,3,0,4,-2,0
Cayman Islands,2000,FIFA World Cup qualification,0,4,0,1,1,2,-4,0
Cayman Islands,2000,Friendly,3,7,1,2,1,4,-4,0
Cayman Islands,2001,CFU Caribbean Cup qualification,3,3,0,0,2,2,0,0
Cayman Islands,2001,Friendly,0,3,0,1,0,1,-3,0
Cayman Islands,2002,Friendly,0,1,0,1,0,1,-1,0
Cayman Islands,2002,Gold Cup qualification,1,8,1,2,0,3,-7,0
Cayman Islands,2004,CFU Caribbean Cup qualification,2,2,1,1,0,2,0,0
Cayman Islands,2004,FIFA World Cup qualification,1,5,0,2,0,2,-4,0
Cayman Islands,2006,CFU Caribbean Cup qualification,1,12,0,3,0,3,-11,0
Cayman Islands,2008,CFU Caribbean Cup qualification,7,13,1,3,2,6,-6,0
Cayman Islands,2008,FIFA World Cup qualification,2,4,0,1,1,2,-2,0
Cayman Islands,2008,Friendly,0,2,0,1,0,1,-2,0
Cayman Islands,2009,Friendly,1,4,0,1,0,1,-3,0
Cayman Islands,2010,CFU Caribbean Cup qualification,5,4,1,1,1,3,1,0
Cayman Islands,2011,FIFA World Cup qualification,2,15,0,5,1,6,-13,0
Cayman Islands,2015,FIFA World Cup qualification,1,1,0,0,1,1,0,0
Cayman Islands,2015,Friendly,0,6,0,1,0,1,-6,0
Cayman Islands,2018,CONCACAF Nations League qualification,0,7,0,2,1,3,-7,0
Cayman Islands,2019,CONCACAF Nations League,7,8,4,2,0,6,-1,0
Cayman Islands,2019,CONCACAF Nations League qualification,1,2,0,1,0,1,-1,0
Cayman Islands,2021,FIFA World Cup qualification,2,18,0,3,1,4,-16,0
Cayman Islands,2022,CONCACAF Nations League,2,5,0,1,2,3,-3,0
Cayman Islands,2023,CONCACAF Nations League,7,15,1,3,1,5,-8,0
Cayman Islands,2024,CONCACAF Nations League,4,12,2,3,1,6,-8,0
Cayman Islands,2024,FIFA World Cup qualification,1,3,1,1,0,2,-2,0
Central African Republic,1960,African Friendship Games,3,4,0,1,0,1,-1,0
Central African Republic,1960,Friendly,3,4,0,1,0,1,-1,0
Central African Republic,1961,African Friendship Games,1,2,0,1,1,2,-1,0
Central African Republic,1962,Friendly,5,5,1,1,0,2,0,1
Central African Republic,1964,Friendly,1,2,0,1,0,1,-1,0
Central African Republic,1966,Friendly,1,9,0,2,0,2,-8,0
Central African Republic,1973,African Cup of Nations qualification,5,7,1,1,0,2,-2,0
Central African Republic,1984,UDEAC Cup,5,12,0,2,2,4,-7,0
Central African Republic,1985,UDEAC Cup,1,8,0,2,0,2,-7,0
Central African Republic,1986,African Cup of Nations qualification,2,7,0,2,0,2,-5,0
Central African Republic,1986,UDEAC Cup,1,4,0,2,0,2,-3,0
Central African Republic,1987,Friendly,1,4,0,2,0,2,-3,0
Central African Republic,1987,UDEAC Cup,2,3,0,1,1,2,-1,0
Central African Republic,1988,UDEAC Cup,2,5,1,2,1,4,-3,0
Central African Republic,1989,Friendly,0,3,0,1,0,1,-3,0
Central African Republic,1989,UDEAC Cup,5,5,1,2,1,4,0,0
Central African Republic,1990,UDEAC Cup,3,7,0,2,1,3,-4,0
Central African Republic,1999,UNIFFAC Cup,13,8,3,2,0,5,5,0
Central African Republic,2000,African Cup of Nations qualification,1,3,0,1,1,2,-2,0
Central African Republic,2000,FIFA World Cup qualification,1,4,0,2,0,2,-3,0
Central African Republic,2002,African Cup of Nations qualification,2,3,0,1,1,2,-1,0
Central African Republic,2003,African Cup of Nations qualification,1,6,0,3,1,4,-5,0
Central African Republic,2010,African Cup of Nations qualification,2,0,1,0,1,2,2,0
Central African Republic,2011,African Cup of Nations qualification,3,5,1,2,1,4,-2,0
Central African Republic,2011,Friendly,1,8,0,3,0,3,-7,0
Central African Republic,2012,African Cup of Nations qualification,6,6,2,1,1,4,0,0
Central African Republic,2012,FIFA World Cup qualification,2,2,1,1,0,2,0,0
Central African Republic,2013,FIFA World Cup qualification,3,10,0,4,0,4,-7,0
Central African Republic,2013,Friendly,0,0,0,0,1,1,0,0
Central African Republic,2014,African Cup of Nations qualification,1,3,0,1,1,2,-2,0
Central African Republic,2014,Friendly,0,4,0,1,0,1,-4,0
Central African Republic,2015,African Cup of Nations qualification,2,4,1,1,0,2,-2,1
Central African Republic,2015,FIFA World Cup qualification,2,5,0,1,1,2,-3,0
Central African Republic,2016,African Cup of Nations qualification,7,6,2,1,1,4,1,0
Central African Republic,2017,African Cup of Nations qualification,2,1,1,0,0,1,1,0
Central African Republic,2017,Friendly,1,5,0,2,0,2,-4,0
Central African Republic,2018,African Cup of Nations qualification,2,7,0,2,2,4,-5,0
Central African Republic,2018,Friendly,8,6,2,0,2,4,2,0
Central African Republic,2019,African Cup of Nations qualification,2,2,1,1,1,3,0,0
Central African Republic,2019,Friendly,2,0,1,0,0,1,2,0
Central African Republic,2020,African Cup of Nations qualification,1,6,0,2,0,2,-5,0
Central African Republic,2021,African Cup of Nations qualification,2,3,0,1,1,2,-1,0
Central African Republic,2021,FIFA World Cup qualification,4,9,1,4,1,6,-5,0
Central African Republic,2021,Friendly,0,7,0,2,0,2,-7,0
Central African Republic,2022,African Cup of Nations qualification,2,3,0,1,1,2,-1,0
Central African Republic,2022,Friendly,1,3,0,1,1,2,-2,0
Central African Republic,2023,African Cup of Nations qualification,7,4,2,2,0,4,3,0
Central African Republic,2023,FIFA World Cup qualification,3,5,0,1,1,2,-2,0
Central African Republic,2024,African Cup of Nations qualification,3,12,1,3,0,4,-9,0
Central African Republic,2024,FIFA Series,10,0,2,0,0,2,10,0
Central African Republic,2024,FIFA World Cup qualification,4,4,1,1,0,2,0,0
Central African Republic,2025,FIFA World Cup qualification,1,4,0,1,1,2,-3,0
Central Spain,1922,Friendly,1,4,0,1,0,1,-3,0
Central Spain,1923,Friendly,1,0,1,0,0,1,1,0
Chad,1961,African Friendship Games,2,2,0,0,1,1,0,0
Chad,1963,African Friendship Games,4,10,0,3,0,3,-6,0
Chad,1964,Friendly,0,11,0,1,0,1,-11,0
Chad,1976,Friendly,5,0,2,0,0,2,5,0
Chad,1984,UDEAC Cup,4,6,0,1,2,3,-2,0
Chad,1985,UDEAC Cup,4,8,0,2,2,4,-4,0
Chad,1986,UDEAC Cup,3,7,1,2,1,4,-4,0
Chad,1987,UDEAC Cup,7,3,2,1,1,4,4,0
Chad,1988,UDEAC Cup,2,4,0,2,0,2,-2,0
Chad,1989,UDEAC Cup,3,5,1,2,2,5,-2,0
Chad,1990,African Cup of Nations qualification,1,2,0,1,1,2,-1,0
Chad,1990,UDEAC Cup,3,5,2,2,0,4,-2,0
Chad,1991,African Cup of Nations qualification,1,5,0,1,1,2,-4,0
Chad,1992,Friendly,0,3,0,3,0,3,-3,0
Chad,1997,Friendly,1,1,0,0,1,1,0,0
Chad,1998,African Cup of Nations qualification,1,1,0,0,2,2,0,0
Chad,1999,UNIFFAC Cup,9,6,3,2,0,5,3,0
Chad,2000,African Cup of Nations qualification,4,4,1,1,0,2,0,0
Chad,2000,FIFA World Cup qualification,0,1,0,1,1,2,-1,0
Chad,2002,African Cup of Nations qualification,1,4,0,1,0,1,-3,0
Chad,2002,Friendly,3,6,1,2,0,3,-3,0
Chad,2003,African Cup of Nations qualification,3,2,1,1,1,3,1,0
Chad,2003,FIFA World Cup qualification,3,3,1,1,0,2,0,0
Chad,2005,Friendly,2,5,0,1,1,2,-3,0
Chad,2006,African Cup of Nations qualification,1,5,0,2,0,2,-4,0
Chad,2007,African Cup of Nations qualification,2,9,0,2,2,4,-7,0
Chad,2007,Friendly,1,0,1,0,0,1,1,0
Chad,2008,FIFA World Cup qualification,7,11,2,4,0,6,-4,0
Chad,2008,Friendly,0,3,0,1,0,1,-3,0
Chad,2010,African Cup of Nations qualification,5,12,0,3,2,5,-7,0
Chad,2010,Friendly,1,2,0,1,1,2,-1,0
Chad,2011,African Cup of Nations qualification,2,8,0,2,1,3,-6,0
Chad,2011,FIFA World Cup qualification,2,2,1,1,0,2,0,0
Chad,2012,African Cup of Nations qualification,3,4,1,1,0,2,-1,0
Chad,2012,Friendly,1,6,0,2,1,3,-5,0
Chad,2014,African Cup of Nations qualification,3,3,1,1,0,2,0,0
Chad,2014,Friendly,0,0,0,0,1,1,0,0
Chad,2015,FIFA World Cup qualification,3,6,2,2,0,4,-3,0
Chad,2015,Friendly,1,2,0,1,0,1,-1,0
Chad,2019,African Cup of Nations qualification,2,5,1,3,0,4,-3,0
Chad,2019,FIFA World Cup qualification,1,3,0,1,1,2,-2,0
Chad,2020,African Cup of Nations qualification,1,2,0,1,1,2,-1,0
Chad,2020,Friendly,0,2,0,1,0,1,-2,0
Chad,2021,African Cup of Nations qualification,0,6,0,2,0,2,-6,0
Chad,2022,African Cup of Nations qualification,2,3,0,1,1,2,-1,0
Chad,2023,FIFA World Cup qualification,1,6,0,2,0,2,-5,0
Chad,2023,Friendly,0,1,0,1,0,1,-1,0
Chad,2024,African Cup of Nations qualification,3,4,2,2,2,6,-1,0
Chad,2024,FIFA World Cup qualification,0,3,0,2,0,2,-3,0
Chad,2025,FIFA World Cup qualification,0,6,0,2,0,2,-6,0
Chagos Islands,2011,Friendly,6,1,1,0,0,1,5,0
Chagos Islands,2012,Friendly,3,1,1,0,0,1,2,0
Chagos Islands,2014,Friendly,3,5,0,1,1,2,-2,0
Chagos Islands,2015,Friendly,1,4,0,1,0,1,-3,0
Chagos Islands,2016,CONIFA World Football Cup,5,27,0,3,1,4,-22,0
Chagos Islands,2016,World Unity Cup,4,7,1,1,0,2,-3,0
Chagos Islands,2018,Friendly,1,10,0,2,0,2,-9,0
Chagos Islands,2019,Atlantic Heritage Cup,2,9,0,1,0,1,-7,0
Chagos Islands,2019,Friendly,3,12,0,2,0,2,-9,0
Chameria,2019,CONIFA European Football Cup,9,4,2,1,2,5,5,0
Chameria,2023,CONIFA World Football Cup qualification,5,4,1,1,0,2,1,0
Chechnya,2005,Friendly,2,16,0,1,1,2,-14,0
Chechnya,2006,Friendly,1,13,0,1,0,1,-12,0
Chile,1910,Friendly,2,14,0,4,0,4,-12,0
Chile,1913,Friendly,0,2,0,1,0,1,-2,0
Chile,1916,Copa América,2,11,0,2,1,3,-9,0
Chile,1916,Friendly,1,5,0,2,0,2,-4,0
Chile,1917,Copa América,0,10,0,3,0,3,-10,0
Chile,1919,Copa América,1,12,0,3,0,3,-11,0
Chile,1920,Copa América,2,4,0,2,1,3,-2,0
Chile,1922,Copa América,1,10,0,3,1,4,-9,0
Chile,1922,Friendly,0,1,0,1,0,1,-1,0
Chile,1924,Copa América,1,10,0,3,0,3,-9,0
Chile,1926,Copa América,14,6,2,1,1,4,8,1
Chile,1927,Friendly,2,3,0,1,0,1,-1,0
Chile,1928,Olympic Games,7,7,1,1,1,3,0,0
Chile,1930,FIFA World Cup,5,3,2,1,0,3,2,0
Chile,1935,Copa América,2,7,0,3,0,3,-5,0
Chile,1936,Copa América,1,2,0,1,0,1,-1,0
Chile,1937,Copa América,11,11,1,2,1,4,0,0
Chile,1939,Copa América,8,12,1,3,0,4,-4,0
Chile,1939,Friendly,4,1,1,0,0,1,3,0
Chile,1940,Friendly,5,10,0,3,0,3,-5,0
Chile,1941,Copa América,6,3,2,2,0,4,3,0
Chile,1941,Friendly,3,7,0,2,0,2,-4,0
Chile,1942,Copa América,4,15,1,3,2,6,-11,0
Chile,1945,Copa América,15,5,4,1,1,6,10,0
Chile,1946,Copa América,8,11,2,3,0,5,-3,0
Chile,1947,Copa América,14,13,4,2,1,7,1,1
Chile,1949,Copa América,10,14,2,4,1,7,-4,0
Chile,1950,FIFA World Cup,5,6,1,2,0,3,-1,0
Chile,1950,Friendly,8,8,2,2,0,4,0,0
Chile,1952,Pan American Championship,15,6,4,1,0,5,9,0
Chile,1953,Copa América,10,10,2,2,2,6,0,0
Chile,1953,Copa del Pacífico,2,6,1,1,0,2,-4,0
Chile,1953,Friendly,2,4,0,2,0,2,-2,0
Chile,1954,Copa del Pacífico,4,5,1,1,0,2,-1,0
Chile,1954,FIFA World Cup qualification,1,10,0,4,0,4,-9,0
Chile,1955,Copa América,19,8,3,1,1,5,11,0
Chile,1955,Copa Bernardo O'Higgins,2,3,0,1,1,2,-1,0
Chile,1956,Copa América,11,8,3,2,0,5,3,0
Chile,1956,Friendly,3,0,1,0,0,1,3,0
Chile,1956,Pan American Championship,4,9,0,3,1,4,-5,0
Chile,1957,Copa América,9,17,1,4,1,6,-8,0
Chile,1957,Copa Bernardo O'Higgins,2,1,1,0,1,2,1,0
Chile,1957,FIFA World Cup qualification,2,10,1,3,0,4,-8,0
Chile,1959,Copa América,9,14,2,3,1,6,-5,0
Chile,1959,Copa Bernardo O'Higgins,0,8,0,2,0,2,-8,0
Chile,1959,Friendly,4,2,1,0,0,1,2,0
Chile,1960,Friendly,16,34,2,8,2,12,-18,0
Chile,1961,Copa Bernardo O'Higgins,1,3,0,2,0,2,-2,0
Chile,1961,Friendly,15,8,3,2,1,6,7,0
Chile,1962,Copa Carlos Dittborn,1,2,0,1,1,2,-1,0
Chile,1962,FIFA World Cup,10,8,4,2,0,6,2,0
Chile,1963,Copa Juan Pinto Durán,2,3,0,1,1,2,-1,0
Chile,1964,Copa Carlos Dittborn,1,6,0,1,1,2,-5,0
Chile,1965,Copa Carlos Dittborn,1,2,0,1,1,2,-1,0
Chile,1965,Copa Juan Pinto Durán,1,1,0,0,2,2,0,0
Chile,1965,Copa del Pacífico,5,1,2,0,0,2,4,1
Chile,1965,FIFA World Cup qualification,14,8,3,1,1,5,6,0
Chile,1966,Copa América qualification,5,2,1,0,1,2,3,0
Chile,1966,Copa Bernardo O'Higgins,2,2,1,1,0,2,0,1
Chile,1966,FIFA World Cup,2,5,0,2,1,3,-3,0
Chile,1966,Friendly,5,11,1,5,1,7,-6,0
Chile,1967,Copa América,8,6,2,1,2,5,2,0
Chile,1967,Friendly,9,11,2,3,0,5,-2,0
Chile,1968,Copa Carlos Dittborn,2,5,1,1,0,2,-3,1
Chile,1968,Copa del Pacífico,2,1,1,0,1,2,1,0
Chile,1968,Friendly,5,2,2,0,0,2,3,0
Chile,1969,FIFA World Cup qualification,5,4,1,1,2,4,1,0
Chile,1969,Friendly,8,8,2,2,3,7,0,0
Chile,1970,Friendly,2,12,0,3,0,3,-10,0
Chile,1971,Copa Carlos Dittborn,2,3,0,1,1,2,-1,0
Chile,1971,Copa Juan Pinto Durán,5,3,1,1,0,2,2,1
Chile,1971,Copa del Pacífico,1,1,1,1,0,2,0,1
Chile,1971,Friendly,7,8,2,2,0,4,-1,0
Chile,1972,Brazil Independence Cup,7,7,3,1,0,4,0,0
Chile,1972,Copa Carlos Dittborn,3,4,0,1,0,1,-1,0
Chile,1972,Friendly,0,5,0,3,0,3,-5,0
Chile,1973,Copa Carlos Dittborn,7,6,1,1,0,2,1,1
Chile,1973,FIFA World Cup qualification,4,3,2,1,1,4,1,0
Chile,1973,Friendly,17,4,3,0,2,5,13,0
Chile,1974,Copa Carlos Dittborn,1,3,0,1,1,2,-2,0
Chile,1974,FIFA World Cup,1,2,0,1,2,3,-1,0
Chile,1974,Friendly,3,2,2,1,1,4,1,0
Chile,1975,Copa América,7,6,1,2,1,4,1,0
Chile,1975,Copa Juan Pinto Durán,1,4,0,2,0,2,-3,0
Chile,1976,Copa Carlos Dittborn,0,2,0,1,0,1,-2,0
Chile,1976,Copa Juan Pinto Durán,0,0,0,0,1,1,0,0
Chile,1977,Copa Juan Pinto Durán,0,3,0,1,0,1,-3,0
Chile,1977,FIFA World Cup qualification,5,3,2,1,1,4,2,0
Chile,1977,Friendly,6,6,1,2,0,3,0,0
Chile,1979,Copa América,13,6,4,2,3,9,7,0
Chile,1979,Copa Juan Pinto Durán,2,2,1,1,0,2,0,0
Chile,1979,Friendly,1,2,0,1,1,2,-1,0
Chile,1980,Friendly,3,4,0,1,2,3,-1,0
Chile,1981,Copa Juan Pinto Durán,1,2,0,1,1,2,-1,0
Chile,1981,FIFA World Cup qualification,6,0,3,0,1,4,6,0
Chile,1981,Friendly,10,5,4,1,2,7,5,0
Chile,1982,Copa del Pacífico,0,1,0,1,0,1,-1,0
Chile,1982,FIFA World Cup,3,8,0,3,0,3,-5,0
Chile,1982,Friendly,3,1,2,0,0,2,2,0
Chile,1983,Copa América,8,2,2,1,1,4,6,0
Chile,1983,Copa del Pacífico,3,0,2,0,0,2,3,1
Chile,1983,Friendly,15,14,3,3,3,9,1,0
Chile,1984,Friendly,1,0,1,0,1,2,1,0
Chile,1985,FIFA World Cup qualification,17,12,4,2,2,8,5,0
Chile,1985,Friendly,9,10,3,3,3,9,-1,0
Chile,1986,Friendly,1,1,0,0,1,1,0,0
Chile,1987,Copa América,9,3,3,1,0,4,6,0
Chile,1987,Friendly,5,5,2,2,0,4,0,0
Chile,1988,Copa Juan Pinto Durán,2,4,0,1,1,2,-2,0
Chile,1988,Copa del Pacífico,3,1,1,0,1,2,2,0
Chile,1988,Friendly,10,5,3,1,2,6,5,0
Chile,1988,Matthews Cup,0,2,0,2,0,2,-2,0
Chile,1989,Copa América,7,5,2,2,0,4,2,0
Chile,1989,FIFA World Cup qualification,9,3,2,1,1,4,6,0
Chile,1989,Friendly,11,9,6,3,3,12,2,0
Chile,1989,Rous Cup,0,2,0,1,1,2,-2,0
Chile,1990,Friendly,0,0,0,0,1,1,0,0
Chile,1991,Copa América,11,6,3,2,2,7,5,0
Chile,1991,Friendly,8,8,2,3,1,6,0,0
Chile,1993,Copa América,3,4,1,2,0,3,-1,0
Chile,1993,Friendly,8,7,3,2,1,6,1,0
Chile,1994,Friendly,11,12,3,3,1,7,-1,0
Chile,1995,Copa América,3,8,0,2,1,3,-5,0
Chile,1995,Friendly,9,11,4,2,2,8,-2,0
Chile,1996,FIFA World Cup qualification,9,9,2,2,2,6,0,0
Chile,1996,Friendly,9,2,3,0,1,4,7,0
Chile,1997,Copa América,1,5,0,3,0,3,-4,0
Chile,1997,FIFA World Cup qualification,23,9,5,3,2,10,14,0
Chile,1997,Friendly,14,7,3,1,0,4,7,0
Chile,1998,FIFA World Cup,5,8,0,1,3,4,-3,0
Chile,1998,Friendly,12,8,4,1,4,9,4,0
Chile,1998,Lunar New Year Cup,1,1,0,0,1,1,0,0
Chile,1999,Copa América,8,7,2,3,1,6,1,0
Chile,1999,Friendly,7,4,2,1,2,5,3,0
Chile,2000,FIFA World Cup qualification,11,13,3,6,1,10,-2,0
Chile,2000,Friendly,12,12,3,4,0,7,0,0
Chile,2001,Copa América,5,5,2,2,0,4,0,0
Chile,2001,FIFA World Cup qualification,4,14,0,6,2,8,-10,0
Chile,2001,Friendly,3,6,1,3,0,4,-3,0
Chile,2001,Millennium Cup,6,1,3,1,0,4,5,0
Chile,2002,Friendly,5,6,1,2,0,3,-1,0
Chile,2003,FIFA World Cup qualification,5,6,1,2,1,4,-1,0
Chile,2003,Friendly,5,5,3,2,1,6,0,0
Chile,2004,Copa América,2,4,0,2,1,3,-2,0
Chile,2004,FIFA World Cup qualification,5,5,2,2,3,7,0,0
Chile,2004,Friendly,2,2,0,0,2,2,0,0
Chile,2005,FIFA World Cup qualification,8,11,2,2,3,7,-3,0
Chile,2005,Friendly,4,3,1,1,0,2,1,0
Chile,2006,Copa del Pacífico,4,2,2,0,0,2,2,1
Chile,2006,Friendly,12,7,4,1,2,7,5,0
Chile,2007,Copa América,4,11,1,2,1,4,-7,0
Chile,2007,FIFA World Cup qualification,4,7,1,2,1,4,-3,0
Chile,2007,Friendly,11,9,5,3,3,11,2,0
Chile,2008,FIFA World Cup qualification,10,6,4,2,0,6,4,0
Chile,2008,Friendly,4,5,3,3,2,8,-1,0
Chile,2009,FIFA World Cup qualification,18,9,5,1,2,8,9,0
Chile,2009,Friendly,8,5,4,1,0,5,3,0
Chile,2009,Kirin Cup,1,5,0,1,1,2,-4,0
Chile,2010,FIFA World Cup,3,5,2,2,0,4,-2,0
Chile,2010,Friendly,17,4,8,2,1,11,13,0
Chile,2011,Copa América,5,4,2,1,1,4,1,0
Chile,2011,FIFA World Cup qualification,7,10,2,2,0,4,-3,0
Chile,2011,Friendly,14,9,3,2,4,9,5,0
Chile,2012,Copa del Pacífico,6,1,2,0,0,2,5,1
Chile,2012,FIFA World Cup qualification,7,8,2,3,0,5,-1,0
Chile,2012,Friendly,2,9,0,3,1,4,-7,0
Chile,2013,FIFA World Cup qualification,15,7,5,1,1,7,8,0
Chile,2013,Friendly,18,7,4,1,2,7,11,0
Chile,2014,FIFA World Cup,6,4,2,1,1,4,2,0
Chile,2014,Friendly,9,3,3,2,1,6,6,0
Chile,2015,Copa América,13,4,4,0,2,6,9,0
Chile,2015,FIFA World Cup qualification,7,7,2,1,1,4,0,0
Chile,2015,Friendly,6,7,2,2,0,4,-1,0
Chile,2016,Copa América,16,5,4,1,1,6,11,0
Chile,2016,FIFA World Cup qualification,14,10,4,3,1,8,4,0
Chile,2017,Confederations Cup,4,3,1,1,3,5,1,0
Chile,2017,FIFA World Cup qualification,5,10,2,4,0,6,-5,0
Chile,2017,Friendly,8,5,2,1,2,5,3,0
Chile,2018,Friendly,14,13,4,3,3,10,1,0
Chile,2019,Copa América,7,7,2,3,1,6,0,0
Chile,2019,Friendly,8,9,2,2,3,7,-1,0
Chile,2020,FIFA World Cup qualification,6,6,1,2,1,4,0,0
Chile,2021,Copa América,3,5,1,2,2,5,-2,0
Chile,2021,FIFA World Cup qualification,9,10,3,4,3,10,-1,0
Chile,2021,Friendly,5,3,2,0,1,3,2,0
Chile,2022,FIFA World Cup qualification,4,10,1,3,0,4,-6,0
Chile,2022,Friendly,2,7,0,3,2,5,-5,0
Chile,2022,Kirin Cup,0,2,0,1,1,2,-2,0
Chile,2023,FIFA World Cup qualification,3,7,1,3,2,6,-4,0
Chile,2023,Friendly,11,2,3,0,1,4,9,0
Chile,2024,Copa América,0,1,0,1,2,3,-1,0
Chile,2024,FIFA World Cup qualification,6,13,1,4,1,6,-7,0
Chile,2024,Friendly,8,3,2,1,0,3,5,0
Chile,2025,FIFA World Cup qualification,0,1,0,1,1,2,-1,0
Chile,2025,Friendly,6,1,1,0,0,1,5,0
China PR,1913,Far Eastern Championship Games,1,2,0,1,0,1,-1,0
China PR,1915,Far Eastern Championship Games,1,0,1,0,1,2,1,1
China PR,1917,Far Eastern Championship Games,8,0,2,0,0,2,8,1
China PR,1919,Far Eastern Championship Games,5,3,2,1,0,3,2,1
China PR,1921,Far Eastern Championship Games,5,0,2,0,0,2,5,1
China PR,1921,Open International Championship,3,0,1,0,0,1,3,1
China PR,1923,Far Eastern Championship Games,8,1,2,0,0,2,7,1
China PR,1923,Friendly,8,1,2,0,0,2,7,0
China PR,1925,Far Eastern Championship Games,7,1,2,0,0,2,6,1
China PR,1925,Friendly,7,1,2,0,0,2,6,0
China PR,1927,Far Eastern Championship Games,8,2,2,0,0,2,6,1
China PR,1927,Friendly,8,2,2,0,0,2,6,0
China PR,1930,Far Eastern Championship Games,8,3,1,0,1,2,5,0
China PR,1930,Friendly,8,3,1,0,1,2,5,0
China PR,1934,Far Eastern Championship Games,8,3,3,0,0,3,5,1
China PR,1934,Friendly,8,3,3,0,0,3,5,0
China PR,1939,Friendly,0,3,0,1,0,1,-3,0
China PR,1940,Friendly,0,6,0,1,0,1,-6,0
China PR,1942,Friendly,1,6,0,1,0,1,-5,0
China PR,1949,Friendly,3,2,1,0,0,1,1,0
China PR,1952,Friendly,1,9,0,2,0,2,-8,0
China PR,1956,Friendly,9,10,3,2,0,5,-1,0
China PR,1957,FIFA World Cup qualification,4,5,1,1,1,3,-1,0
China PR,1957,Friendly,8,5,2,1,0,3,3,0
China PR,1959,Friendly,2,2,1,2,0,3,0,0
China PR,1960,Friendly,11,4,3,0,0,3,7,0
China PR,1963,Friendly,26,11,7,3,3,13,15,0
China PR,1965,Friendly,11,7,3,1,1,5,4,0
China PR,1966,Friendly,20,4,3,0,0,3,16,0
China PR,1966,GaNEFo,20,2,4,1,0,5,18,1
China PR,1971,Friendly,6,4,2,0,1,3,2,0
China PR,1972,Friendly,17,9,4,0,3,7,8,0
China PR,1973,Friendly,20,11,3,0,1,4,9,0
China PR,1974,Asian Games,7,4,1,2,0,3,3,0
China PR,1974,Friendly,20,11,4,0,1,5,9,0
China PR,1975,AFC Asian Cup qualification,14,4,4,1,0,5,10,0
China PR,1975,Friendly,20,16,3,3,3,9,4,0
China PR,1976,AFC Asian Cup,2,4,1,2,1,4,-2,0
China PR,1976,Friendly,2,0,1,0,0,1,2,0
China PR,1977,Beijing International Friendship Tournament,7,6,2,1,0,3,1,0
China PR,1977,Friendly,15,7,5,2,1,8,8,0
China PR,1978,AFC Asian Cup qualification,5,2,2,1,0,3,3,0
China PR,1978,Asian Games,16,5,5,2,0,7,11,0
China PR,1978,Beijing International Friendship Tournament,1,0,1,0,0,1,1,1
China PR,1978,Friendly,2,2,1,1,0,2,0,0
China PR,1980,AFC Asian Cup,9,5,1,2,1,4,4,0
China PR,1980,FIFA World Cup qualification,5,0,3,0,1,4,5,0
China PR,1980,Friendly,1,3,0,1,0,1,-2,0
China PR,1980,Guangzhou International Friendship Tournament,8,0,2,0,0,2,8,0
China PR,1981,FIFA World Cup qualification,13,6,4,2,1,7,7,0
China PR,1981,Kirin Cup,0,0,0,0,1,1,0,0
China PR,1982,Asian Games,4,3,2,1,1,4,1,0
China PR,1982,Beijing International Friendship Tournament,5,3,1,0,1,2,2,0
China PR,1982,FIFA World Cup qualification,1,2,0,1,0,1,-1,0
China PR,1982,Friendly,2,4,1,2,0,3,-2,0
China PR,1982,Nehru Cup,2,4,0,1,3,4,-2,0
China PR,1983,Great Wall Cup,2,1,1,0,0,1,1,1
China PR,1983,Merlion Cup,2,2,1,1,0,2,0,0
China PR,1984,AFC Asian Cup,11,4,4,2,0,6,7,0
China PR,1984,AFC Asian Cup qualification,15,0,4,0,0,4,15,0
China PR,1984,Friendly,5,8,1,3,0,4,-3,0
China PR,1984,Great Wall Cup,2,0,1,0,0,1,2,1
China PR,1984,Kirin Cup,0,2,0,2,0,2,-2,0
China PR,1984,Nehru Cup,4,2,2,2,0,4,2,0
China PR,1985,FIFA World Cup qualification,23,2,4,1,1,6,21,0
China PR,1985,Friendly,5,5,1,1,1,3,0,0
China PR,1985,Nehru Cup,3,4,0,1,1,2,-1,0
China PR,1986,Asian Games,10,7,2,1,1,4,3,0
China PR,1986,Friendly,15,7,4,2,2,8,8,0
China PR,1986,Great Wall Cup,1,1,0,0,1,1,0,0
China PR,1986,Merlion Cup,8,2,4,0,1,5,6,0
China PR,1986,Nehru Cup,3,1,1,0,1,2,2,0
China PR,1987,Friendly,2,3,0,1,0,1,-1,0
China PR,1987,Nehru Cup,1,1,0,0,1,1,0,0
China PR,1988,AFC Asian Cup,7,5,2,2,2,6,2,0
China PR,1988,AFC Asian Cup qualification,10,1,2,0,3,5,9,0
China PR,1988,Friendly,0,0,0,0,1,1,0,0
China PR,1988,Kirin Cup,3,0,1,0,0,1,3,1
China PR,1989,FIFA World Cup qualification,18,9,7,4,0,11,9,0
China PR,1989,Friendly,2,6,0,2,1,3,-4,0
China PR,1989,King's Cup,3,3,1,1,0,2,0,0
China PR,1989,Lunar New Year Cup,0,0,0,0,1,1,0,0
China PR,1990,Asian Games,8,4,2,2,0,4,4,0
China PR,1990,Dynasty Cup,4,2,2,1,1,4,2,0
China PR,1990,Friendly,1,3,0,2,0,2,-2,0
China PR,1992,AFC Asian Cup,6,6,1,1,3,5,0,0
China PR,1992,AFC Asian Cup qualification,7,0,3,0,0,3,7,0
China PR,1992,Dynasty Cup,2,6,0,2,2,4,-4,0
China PR,1992,Friendly,6,14,1,3,0,4,-8,0
China PR,1993,East Asian Games,18,2,2,0,1,3,16,0
China PR,1993,FIFA World Cup qualification,18,4,6,2,0,8,14,0
China PR,1993,Friendly,0,4,0,2,0,2,-4,0
China PR,1993,King's Cup,4,1,1,1,0,2,3,1
China PR,1994,Asian Games,16,8,5,1,1,7,8,0
China PR,1994,Friendly,1,2,0,1,1,2,-1,0
China PR,1995,Dynasty Cup,2,3,0,1,3,4,-1,0
China PR,1995,Friendly,2,1,1,0,0,1,1,0
China PR,1996,AFC Asian Cup,6,7,1,3,0,4,-1,0
China PR,1996,AFC Asian Cup qualification,16,1,3,0,0,3,15,0
China PR,1996,Friendly,6,14,1,5,1,7,-8,0
China PR,1997,Dunhill Cup,13,3,5,0,0,5,10,1
China PR,1997,East Asian Games,15,0,3,0,1,4,15,0
China PR,1997,FIFA World Cup qualification,24,16,8,3,3,14,8,0
China PR,1997,Friendly,11,4,3,1,3,7,7,0
China PR,1997,Nehru Cup,2,3,1,1,2,4,-1,1
China PR,1998,Asian Games,24,7,6,2,0,8,17,0
China PR,1998,Dynasty Cup,4,2,2,1,0,3,2,0
China PR,1998,Friendly,4,1,1,0,2,3,3,0
China PR,2000,AFC Asian Cup,11,7,2,2,2,6,4,0
China PR,2000,AFC Asian Cup qualification,29,0,3,0,0,3,29,0
China PR,2000,Friendly,10,9,4,4,2,10,1,0
China PR,2001,Cup of Ancient Civilizations,0,4,0,1,1,2,-4,0
China PR,2001,FIFA World Cup qualification,38,5,12,1,1,14,33,0
China PR,2001,Friendly,6,4,1,1,1,3,2,0
China PR,2001,King's Cup,8,7,1,1,2,4,1,0
China PR,2002,FIFA World Cup,0,9,0,3,0,3,-9,0
China PR,2002,Friendly,0,6,0,3,1,4,-6,0
China PR,2002,Lunar New Year Cup,0,0,0,0,1,1,0,0
China PR,2002,Prime Minister's Cup,5,3,1,0,2,3,2,0
China PR,2003,EAFF Championship,3,4,1,2,0,3,-1,0
China PR,2003,Friendly,4,6,1,2,2,5,-2,0
China PR,2004,AFC Asian Cup,13,6,3,1,2,6,7,0
China PR,2004,FIFA World Cup qualification,14,1,5,1,0,6,13,0
China PR,2004,Friendly,18,5,7,0,3,10,13,0
China PR,2005,EAFF Championship,5,3,1,0,2,3,2,0
China PR,2005,Friendly,5,13,1,5,1,7,-8,0
China PR,2006,AFC Asian Cup qualification,7,3,3,1,2,6,4,0
China PR,2006,Friendly,2,8,0,3,0,3,-6,0
China PR,2007,AFC Asian Cup,7,6,1,1,1,3,1,0
China PR,2007,FIFA World Cup qualification,11,0,2,0,0,2,11,0
China PR,2007,Friendly,6,9,2,3,0,5,-3,0
China PR,2008,EAFF Championship,5,5,1,2,0,3,0,0
China PR,2008,FIFA World Cup qualification,3,4,1,2,3,6,-1,0
China PR,2008,Friendly,11,12,3,3,4,10,-1,0
China PR,2009,AFC Asian Cup qualification,11,4,3,1,0,4,7,1
China PR,2009,Friendly,19,15,4,2,5,11,4,0
China PR,2010,AFC Asian Cup qualification,2,1,1,0,1,2,1,0
China PR,2010,EAFF Championship,5,0,2,0,1,3,5,0
China PR,2010,Friendly,14,11,6,3,2,11,3,0
China PR,2011,AFC Asian Cup,4,4,1,1,1,3,0,0
China PR,2011,FIFA World Cup qualification,20,8,4,3,0,7,12,0
China PR,2011,Friendly,15,6,6,0,2,8,9,0
China PR,2012,FIFA World Cup qualification,3,1,1,0,0,1,2,0
China PR,2012,Friendly,7,12,2,3,2,7,-5,0
China PR,2013,AFC Asian Cup qualification,4,3,2,1,2,5,1,0
China PR,2013,EAFF Championship,7,6,1,0,2,3,1,0
China PR,2013,Friendly,10,11,2,4,0,6,-1,0
China PR,2014,AFC Asian Cup qualification,1,3,0,1,0,1,-2,0
China PR,2014,Friendly,13,7,4,1,5,10,6,0
China PR,2015,AFC Asian Cup,5,4,3,1,0,4,1,0
China PR,2015,EAFF Championship,3,3,1,1,1,3,0,0
China PR,2015,FIFA World Cup qualification,21,1,3,1,2,6,20,0
China PR,2015,Friendly,7,4,1,0,2,3,3,0
China PR,2016,FIFA World Cup qualification,8,6,2,3,2,7,2,0
China PR,2016,Friendly,4,3,1,1,0,2,1,0
China PR,2017,EAFF Championship,4,5,0,1,2,3,-1,0
China PR,2017,FIFA World Cup qualification,6,4,3,1,1,5,2,0
China PR,2017,Friendly,9,10,1,3,1,5,-1,0
China PR,2018,Friendly,9,15,3,4,4,11,-6,0
China PR,2019,AFC Asian Cup,7,7,3,2,0,5,0,0
China PR,2019,EAFF Championship,3,3,1,2,0,3,0,0
China PR,2019,FIFA World Cup qualification,13,2,2,1,1,4,11,0
China PR,2019,Friendly,7,1,3,0,0,3,6,0
China PR,2021,FIFA World Cup qualification,24,12,5,3,2,10,12,0
China PR,2022,EAFF Championship,1,3,1,1,1,3,-2,0
China PR,2022,FIFA World Cup qualification,2,8,0,3,1,4,-6,0
China PR,2023,FIFA World Cup qualification,2,4,1,1,0,2,-2,0
China PR,2023,Friendly,11,6,3,3,2,8,5,0
China PR,2024,AFC Asian Cup,0,1,0,1,2,3,-1,0
China PR,2024,FIFA World Cup qualification,13,21,3,5,2,10,-8,0
China PR,2024,Friendly,1,2,0,1,0,1,-1,0
China PR,2025,FIFA World Cup qualification,0,3,0,2,0,2,-3,0
Cilento,2011,Friendly,0,2,0,1,0,1,-2,0
Colombia,1938,Bolivarian Games,6,8,1,3,0,4,-2,0
Colombia,1938,Central American and Caribbean Games,10,11,2,3,0,5,-1,0
Colombia,1945,Copa América,7,25,1,4,1,6,-18,0
Colombia,1946,Central American and Caribbean Games,20,7,6,0,0,6,13,0
Colombia,1947,Copa América,2,19,0,5,2,7,-17,0
Colombia,1949,Copa América,4,23,0,5,2,7,-19,0
Colombia,1957,Copa América,10,25,2,4,0,6,-15,0
Colombia,1957,FIFA World Cup qualification,3,8,0,3,1,4,-5,0
Colombia,1957,Friendly,1,2,0,1,0,1,-1,0
Colombia,1961,FIFA World Cup qualification,2,1,1,0,1,2,1,0
Colombia,1961,Friendly,2,0,1,0,0,1,2,0
Colombia,1962,FIFA World Cup,5,11,0,2,1,3,-6,0
Colombia,1962,Friendly,2,4,0,2,1,3,-2,0
Colombia,1963,Copa América,10,19,0,5,1,6,-9,0
Colombia,1963,Friendly,5,5,1,1,0,2,0,0
Colombia,1965,FIFA World Cup qualification,4,10,1,3,0,4,-6,0
Colombia,1966,Copa América qualification,2,5,0,1,1,2,-3,0
Colombia,1968,Friendly,0,1,0,1,0,1,-1,0
Colombia,1969,FIFA World Cup qualification,7,12,1,4,1,6,-5,0
Colombia,1969,Friendly,7,16,0,5,2,7,-9,0
Colombia,1970,Friendly,0,4,0,1,0,1,-4,0
Colombia,1972,Brazil Independence Cup,3,7,0,2,0,2,-4,0
Colombia,1972,Friendly,1,1,0,0,2,2,0,0
Colombia,1973,FIFA World Cup qualification,3,2,1,0,3,4,1,0
Colombia,1973,Friendly,4,8,1,3,0,4,-4,0
Colombia,1975,Copa América,11,5,6,3,0,9,6,0
Colombia,1976,Friendly,1,2,0,1,0,1,-1,0
Colombia,1977,FIFA World Cup qualification,1,8,0,2,2,4,-7,0
Colombia,1977,Friendly,1,6,0,3,0,3,-5,0
Colombia,1979,Copa América,5,2,2,1,1,4,3,0
Colombia,1979,Friendly,2,2,1,1,0,2,0,0
Colombia,1980,Friendly,1,4,0,1,0,1,-3,0
Colombia,1981,FIFA World Cup qualification,4,7,0,2,2,4,-3,0
Colombia,1981,Friendly,5,5,1,2,2,5,0,0
Colombia,1983,Copa América,5,5,1,1,2,4,0,0
Colombia,1983,Friendly,2,2,0,0,3,3,0,0
Colombia,1984,Friendly,2,3,1,2,2,5,-1,0
Colombia,1985,FIFA World Cup qualification,8,10,3,3,2,8,-2,0
Colombia,1985,Friendly,16,13,5,3,3,11,3,0
Colombia,1987,Copa América,8,3,3,1,0,4,5,0
Colombia,1987,Friendly,1,3,1,1,0,2,-2,0
Colombia,1988,Friendly,8,2,3,0,0,3,6,0
Colombia,1988,Rous Cup,1,1,0,0,2,2,0,0
Colombia,1989,Copa América,5,4,1,1,2,4,1,0
Colombia,1989,FIFA World Cup qualification,6,3,3,1,2,6,3,0
Colombia,1989,Friendly,8,0,5,0,1,6,8,0
Colombia,1990,FIFA World Cup,4,4,1,2,1,4,0,0
Colombia,1990,Friendly,3,6,1,2,1,4,-3,0
Colombia,1990,Marlboro Cup,2,1,1,0,1,2,1,0
Colombia,1990,Miami Cup,1,3,0,1,1,2,-2,0
Colombia,1991,Copa América,5,6,2,3,2,7,-1,0
Colombia,1991,Friendly,3,2,1,0,2,3,1,0
Colombia,1991,Miami Cup,2,3,0,1,0,1,-1,0
Colombia,1992,Friendly,1,0,1,0,1,2,1,0
Colombia,1993,Copa América,6,4,2,0,4,6,2,0
Colombia,1993,FIFA World Cup qualification,13,2,4,0,2,6,11,0
Colombia,1993,Friendly,9,4,3,0,3,6,5,0
Colombia,1994,FIFA World Cup,4,5,1,2,0,3,-1,0
Colombia,1994,Friendly,10,5,4,1,3,8,5,0
Colombia,1994,Joe Robbie Cup,2,0,1,0,1,2,2,0
Colombia,1994,Miami Cup,4,0,2,0,0,2,4,0
Colombia,1995,Copa América,7,8,2,2,2,6,-1,0
Colombia,1995,Friendly,7,8,2,2,3,7,-1,0
Colombia,1995,Lunar New Year Cup,0,1,0,1,0,1,-1,0
Colombia,1995,USA Cup,1,0,1,0,2,3,1,0
Colombia,1996,FIFA World Cup qualification,14,5,5,0,2,7,9,0
Colombia,1996,Friendly,13,7,5,1,0,6,6,0
Colombia,1997,Copa América,6,7,1,3,0,4,-1,0
Colombia,1997,FIFA World Cup qualification,9,10,3,4,2,9,-1,0
Colombia,1997,Friendly,4,5,1,2,2,5,-1,0
Colombia,1998,FIFA World Cup,1,3,1,2,0,3,-2,0
Colombia,1998,Friendly,4,8,0,2,3,5,-4,0
Colombia,1999,Copa América,8,4,3,1,0,4,4,0
Colombia,1999,Friendly,15,17,1,4,5,10,-2,0
Colombia,2000,FIFA World Cup qualification,8,7,4,3,3,10,1,0
Colombia,2000,Friendly,3,0,1,0,0,1,3,0
Colombia,2000,Gold Cup,5,7,2,2,1,5,-2,0
Colombia,2001,Copa América,11,0,6,0,0,6,11,0
Colombia,2001,FIFA World Cup qualification,12,8,3,2,3,8,4,0
Colombia,2001,Friendly,9,5,4,0,0,4,4,0
Colombia,2002,Friendly,3,4,1,2,1,4,-1,0
Colombia,2003,Confederations Cup,5,5,2,3,0,5,0,0
Colombia,2003,FIFA World Cup qualification,2,8,0,3,1,4,-6,0
Colombia,2003,Friendly,0,0,0,0,5,5,0,0
Colombia,2003,Gold Cup,2,3,1,1,1,3,-1,0
Colombia,2004,Copa América,7,7,3,2,1,6,0,0
Colombia,2004,FIFA World Cup qualification,10,3,3,1,3,7,7,0
Colombia,2004,Friendly,5,1,2,0,1,3,4,0
Colombia,2005,FIFA World Cup qualification,12,5,3,2,2,7,7,0
Colombia,2005,Friendly,6,9,1,2,2,5,-3,0
Colombia,2005,Gold Cup,7,7,2,3,0,5,0,0
Colombia,2006,Friendly,8,7,3,1,3,7,1,0
Colombia,2007,Copa América,3,9,1,2,0,3,-6,0
Colombia,2007,FIFA World Cup qualification,3,1,2,0,2,4,2,0
Colombia,2007,Friendly,17,7,6,1,1,8,10,0
Colombia,2007,Kirin Cup,1,0,1,0,1,2,1,0
Colombia,2008,FIFA World Cup qualification,1,7,0,3,3,6,-6,0
Colombia,2008,Friendly,10,11,2,5,1,8,-1,0
Colombia,2009,FIFA World Cup qualification,10,10,4,4,0,8,0,0
Colombia,2009,Friendly,7,4,3,1,0,4,3,0
Colombia,2010,Friendly,7,6,2,2,4,8,1,0
Colombia,2011,Copa América,3,2,2,1,1,4,1,0
Colombia,2011,FIFA World Cup qualification,4,4,1,1,1,3,0,0
Colombia,2011,Friendly,8,3,4,2,0,6,5,0
Colombia,2012,FIFA World Cup qualification,10,2,4,1,0,5,8,0
Colombia,2012,Friendly,6,1,2,0,1,3,5,0
Colombia,2013,FIFA World Cup qualification,13,7,4,2,2,8,6,0
Colombia,2013,Friendly,3,0,2,0,1,3,3,0
Colombia,2014,FIFA World Cup,12,4,4,1,0,5,8,0
Colombia,2014,Friendly,9,5,3,1,2,6,4,0
Colombia,2015,Copa América,1,1,1,1,2,4,0,0
Colombia,2015,FIFA World Cup qualification,3,5,1,2,1,4,-2,0
Colombia,2015,Friendly,11,2,3,0,1,4,9,0
Colombia,2016,Copa América,7,6,3,2,1,6,1,0
Colombia,2016,FIFA World Cup qualification,12,10,4,2,2,8,2,0
Colombia,2017,FIFA World Cup qualification,6,4,2,1,3,6,2,0
Colombia,2017,Friendly,11,5,2,2,1,5,6,0
Colombia,2018,FIFA World Cup,6,3,2,1,1,4,3,0
Colombia,2018,Friendly,12,6,4,0,3,7,6,0
Colombia,2019,Copa América,4,0,3,0,1,4,4,0
Colombia,2019,Friendly,11,7,4,2,3,9,4,0
Colombia,2019,Kirin Challenge Cup,1,0,1,0,0,1,1,0
Colombia,2020,FIFA World Cup qualification,6,11,1,2,1,4,-5,0
Colombia,2021,Copa América,7,7,2,2,3,7,0,0
Colombia,2021,FIFA World Cup qualification,10,6,2,1,7,10,4,0
Colombia,2022,FIFA World Cup qualification,4,2,2,2,0,4,2,0
Colombia,2022,Friendly,12,4,5,0,0,5,8,0
Colombia,2023,FIFA World Cup qualification,6,3,3,0,3,6,3,0
Colombia,2023,Friendly,10,5,4,0,2,6,5,1
Colombia,2024,Copa América,12,3,4,1,1,6,9,0
Colombia,2024,FIFA World Cup qualification,9,7,2,3,1,6,2,0
Colombia,2024,Friendly,12,3,4,0,0,4,9,0
Colombia,2025,FIFA World Cup qualification,3,4,0,1,1,2,-1,0
Comoros,1979,Indian Ocean Island Games,4,13,1,3,0,4,-9,0
Comoros,1985,Indian Ocean Island Games,2,3,0,1,1,2,-1,0
Comoros,1990,Indian Ocean Island Games,2,8,1,3,0,4,-6,0
Comoros,1993,Indian Ocean Island Games,0,8,0,2,0,2,-8,0
Comoros,1998,Indian Ocean Island Games,0,6,0,2,0,2,-6,0
Comoros,2003,Indian Ocean Island Games,0,12,0,4,0,4,-12,0
Comoros,2006,Arab Cup qualification,4,4,1,1,0,2,0,0
Comoros,2007,FIFA World Cup qualification,2,10,0,2,0,2,-8,0
Comoros,2007,Indian Ocean Island Games,1,4,0,1,1,2,-3,0
Comoros,2008,COSAFA Cup qualification,0,5,0,3,0,3,-5,0
Comoros,2009,COSAFA Cup,2,4,1,1,1,3,-2,0
Comoros,2010,African Cup of Nations qualification,0,5,0,2,0,2,-5,0
Comoros,2010,Friendly,0,1,0,1,0,1,-1,0
Comoros,2011,African Cup of Nations qualification,2,9,0,3,1,4,-7,0
Comoros,2011,FIFA World Cup qualification,1,5,0,2,0,2,-4,0
Comoros,2011,Indian Ocean Island Games,2,4,0,1,2,3,-2,0
Comoros,2014,African Cup of Nations qualification,1,2,0,1,1,2,-1,0
Comoros,2014,Friendly,1,1,0,0,1,1,0,0
Comoros,2015,African Cup of Nations qualification,0,3,0,2,0,2,-3,0
Comoros,2015,FIFA World Cup qualification,1,3,0,1,3,4,-2,0
Comoros,2015,Indian Ocean Island Games,0,6,0,2,0,2,-6,0
Comoros,2016,African Cup of Nations qualification,2,4,1,3,0,4,-2,0
Comoros,2016,Friendly,3,3,0,0,2,2,0,0
Comoros,2017,African Cup of Nations qualification,3,2,1,1,1,3,1,0
Comoros,2017,Friendly,2,3,1,1,1,3,-1,0
Comoros,2018,African Cup of Nations qualification,5,5,1,1,2,4,0,0
Comoros,2018,COSAFA Cup,1,5,0,2,1,3,-4,0
Comoros,2018,Friendly,2,2,0,0,1,1,0,0
Comoros,2019,African Cup of Nations qualification,1,3,1,1,1,3,-2,0
Comoros,2019,COSAFA Cup,5,7,1,2,1,4,-2,0
Comoros,2019,FIFA World Cup qualification,1,3,0,1,1,2,-2,0
Comoros,2019,Friendly,2,3,1,1,0,2,-1,0
Comoros,2019,Indian Ocean Island Games,4,2,2,1,0,3,2,0
Comoros,2020,African Cup of Nations qualification,3,2,1,0,1,2,1,0
Comoros,2021,African Cup of Nations qualification,0,4,0,1,1,2,-4,0
Comoros,2021,Arab Cup qualification,1,5,0,1,0,1,-4,0
Comoros,2021,Friendly,11,3,3,1,0,4,8,0
Comoros,2022,African Cup of Nations,4,7,1,3,0,4,-3,0
Comoros,2022,African Cup of Nations qualification,3,2,1,1,0,2,1,0
Comoros,2022,COSAFA Cup,3,5,1,2,0,3,-2,0
Comoros,2022,Friendly,3,4,1,2,0,3,-1,0
Comoros,2023,African Cup of Nations qualification,3,6,1,2,1,4,-3,0
Comoros,2023,COSAFA Cup,4,4,1,2,0,3,0,0
Comoros,2023,FIFA World Cup qualification,5,2,2,0,0,2,3,0
Comoros,2023,Friendly,2,1,1,0,0,1,1,0
Comoros,2023,Indian Ocean Island Games,3,7,0,2,2,4,-4,0
Comoros,2024,African Cup of Nations qualification,4,3,1,0,3,4,1,0
Comoros,2024,FIFA World Cup qualification,3,2,1,1,0,2,1,0
Comoros,2024,Friendly,4,0,1,0,1,2,4,0
Comoros,2025,FIFA World Cup qualification,1,3,1,1,0,2,-2,0
Congo,1960,African Friendship Games,12,16,2,2,0,4,-4,0
Congo,1960,Friendly,7,7,1,1,0,2,0,0
Congo,1962,Friendly,13,5,3,1,0,4,8,0
Congo,1963,African Friendship Games,12,5,3,1,0,4,7,0
Congo,1964,Friendly,19,16,2,3,2,7,3,0
Congo,1965,All-African Games,11,5,3,1,1,5,6,0
Congo,1965,Friendly,5,19,1,5,1,7,-14,0
Congo,1966,Friendly,3,2,1,0,0,1,1,0
Congo,1967,African Cup of Nations qualification,4,3,1,0,2,3,1,0
Congo,1967,Friendly,18,11,4,2,2,8,7,0
Congo,1968,African Cup of Nations,2,8,0,3,0,3,-6,0
Congo,1969,Friendly,7,3,2,0,2,4,4,0
Congo,1970,African Cup of Nations qualification,2,1,1,0,1,2,1,0
Congo,1970,Friendly,2,3,0,1,0,1,-1,0
Congo,1971,African Cup of Nations qualification,4,3,1,1,0,2,1,0
Congo,1971,Friendly,1,7,0,1,0,1,-6,0
Congo,1972,African Cup of Nations,9,7,3,1,1,5,2,1
Congo,1972,FIFA World Cup qualification,2,3,0,1,1,2,-1,0
Congo,1972,Friendly,10,9,2,1,2,5,1,0
Congo,1973,All-African Games,5,8,1,2,0,3,-3,0
Congo,1973,Friendly,5,8,1,3,0,4,-3,0
Congo,1974,African Cup of Nations,7,10,2,2,1,5,-3,0
Congo,1974,Friendly,5,3,1,0,2,3,2,0
Congo,1975,African Cup of Nations qualification,3,5,1,3,0,4,-2,0
Congo,1975,Friendly,2,2,1,1,0,2,0,0
Congo,1976,FIFA World Cup qualification,4,3,1,0,1,2,1,0
Congo,1976,Friendly,10,6,3,0,1,4,4,0
Congo,1977,African Cup of Nations qualification,10,7,2,1,1,4,3,0
Congo,1977,FIFA World Cup qualification,3,6,0,2,0,2,-3,0
Congo,1977,Friendly,4,4,0,0,2,2,0,0
Congo,1978,African Cup of Nations,1,4,0,2,1,3,-3,0
Congo,1978,Beijing International Friendship Tournament,0,1,0,1,0,1,-1,0
Congo,1978,Friendly,1,5,0,2,0,2,-4,0
Congo,1979,African Cup of Nations qualification,5,6,1,1,0,2,-1,0
Congo,1979,Friendly,4,1,2,0,0,2,3,0
Congo,1980,African Cup of Nations qualification,1,1,0,0,2,2,0,0
Congo,1980,Friendly,8,4,3,1,1,5,4,0
Congo,1981,African Cup of Nations qualification,1,2,0,1,1,2,-1,0
Congo,1981,Friendly,4,5,0,1,2,3,-1,0
Congo,1982,Friendly,1,2,0,1,0,1,-1,0
Congo,1983,African Cup of Nations qualification,2,2,1,1,0,2,0,0
Congo,1983,Friendly,10,4,4,0,1,5,6,0
Congo,1984,Friendly,3,10,0,5,0,5,-7,0
Congo,1984,UDEAC Cup,12,3,3,0,1,4,9,0
Congo,1985,African Cup of Nations qualification,2,5,0,1,1,2,-3,0
Congo,1985,Friendly,3,4,1,2,0,3,-1,0
Congo,1985,UDEAC Cup,5,5,2,2,0,4,0,0
Congo,1986,African Cup of Nations qualification,7,2,2,0,0,2,5,0
Congo,1986,Great Wall Cup,1,1,0,0,1,1,0,0
Congo,1986,UDEAC Cup,3,3,1,2,0,3,0,0
Congo,1987,African Cup of Nations qualification,1,4,0,2,0,2,-3,0
Congo,1987,Friendly,3,4,0,1,1,2,-1,0
Congo,1988,Friendly,1,5,0,2,0,2,-4,0
Congo,1988,UDEAC Cup,6,3,3,1,0,4,3,0
Congo,1989,UDEAC Cup,2,4,1,2,0,3,-2,0
Congo,1990,African Cup of Nations qualification,3,0,2,0,0,2,3,0
Congo,1990,Friendly,2,3,1,2,0,3,-1,0
Congo,1990,UDEAC Cup,12,1,4,0,0,4,11,1
Congo,1991,African Cup of Nations qualification,4,3,1,0,1,2,1,0
Congo,1991,Friendly,1,2,0,1,1,2,-1,0
Congo,1992,African Cup of Nations,2,3,0,1,2,3,-1,0
Congo,1992,African Cup of Nations qualification,0,1,0,1,0,1,-1,0
Congo,1992,FIFA World Cup qualification,0,2,0,2,0,2,-2,0
Congo,1992,Friendly,5,2,1,0,1,2,3,0
Congo,1992,Jordan International Tournament,5,8,1,3,0,4,-3,0
Congo,1993,African Cup of Nations qualification,0,1,0,1,2,3,-1,0
Congo,1993,FIFA World Cup qualification,0,3,0,2,0,2,-3,0
Congo,1994,African Cup of Nations qualification,2,3,0,1,0,1,-1,0
Congo,1994,Friendly,5,4,2,1,1,4,1,0
Congo,1995,African Cup of Nations qualification,1,7,0,3,0,3,-6,0
Congo,1995,Friendly,2,2,0,0,1,1,0,0
Congo,1996,African Cup of Nations qualification,0,1,0,1,1,2,-1,0
Congo,1996,FIFA World Cup qualification,4,1,2,0,1,3,3,0
Congo,1996,Friendly,3,4,1,1,0,2,-1,0
Congo,1997,FIFA World Cup qualification,4,5,2,2,1,5,-1,0
Congo,1997,Friendly,0,2,0,1,0,1,-2,0
Congo,1998,African Cup of Nations qualification,2,1,1,0,2,3,1,0
Congo,1999,African Cup of Nations qualification,5,5,2,2,1,5,0,0
Congo,1999,Friendly,5,4,2,1,1,4,1,0
Congo,1999,UNIFFAC Cup,5,7,2,2,1,5,-2,0
Congo,2000,African Cup of Nations,0,2,0,2,1,3,-2,0
Congo,2000,African Cup of Nations qualification,9,6,2,2,0,4,3,0
Congo,2000,FIFA World Cup qualification,5,4,2,1,0,3,1,0
Congo,2000,Friendly,5,2,2,0,0,2,3,0
Congo,2001,African Cup of Nations qualification,1,6,0,2,2,4,-5,0
Congo,2001,FIFA World Cup qualification,5,13,1,4,2,7,-8,0
Congo,2002,African Cup of Nations qualification,3,0,1,0,1,2,3,0
Congo,2002,Friendly,1,3,0,1,1,2,-2,0
Congo,2003,African Cup of Nations qualification,2,4,1,1,2,4,-2,0
Congo,2003,FIFA World Cup qualification,2,1,1,0,1,2,1,0
Congo,2003,Friendly,0,3,0,1,0,1,-3,0
Congo,2004,FIFA World Cup qualification,6,7,2,3,0,5,-1,0
Congo,2005,FIFA World Cup qualification,4,7,1,3,1,5,-3,0
Congo,2005,Friendly,0,2,0,1,1,2,-2,0
Congo,2006,African Cup of Nations qualification,3,1,1,0,1,2,2,0
Congo,2006,Friendly,0,1,0,1,0,1,-1,0
Congo,2007,African Cup of Nations qualification,2,5,0,1,3,4,-3,0
Congo,2007,Friendly,2,1,1,0,1,2,1,0
Congo,2008,FIFA World Cup qualification,7,8,3,3,0,6,-1,0
Congo,2008,Friendly,1,3,0,1,0,1,-2,0
Congo,2009,Friendly,5,7,0,1,5,6,-2,0
Congo,2010,African Cup of Nations qualification,3,3,1,1,0,2,0,0
Congo,2010,Friendly,0,3,0,1,0,1,-3,0
Congo,2011,African Cup of Nations qualification,2,7,1,3,0,4,-5,0
Congo,2011,FIFA World Cup qualification,6,1,1,0,1,2,5,0
Congo,2012,African Cup of Nations qualification,3,5,1,1,0,2,-2,0
Congo,2012,FIFA World Cup qualification,4,0,2,0,0,2,4,0
Congo,2012,Friendly,3,7,0,2,1,3,-4,0
Congo,2013,FIFA World Cup qualification,3,3,1,1,2,4,0,0
Congo,2013,Friendly,0,3,0,1,0,1,-3,0
Congo,2014,African Cup of Nations qualification,11,9,5,4,1,10,2,0
Congo,2015,African Cup of Nations,6,6,2,1,1,4,0,0
Congo,2015,African Cup of Nations qualification,5,3,1,0,1,2,2,0
Congo,2015,FIFA World Cup qualification,6,4,2,0,0,2,2,1
Congo,2015,Friendly,6,7,1,2,0,3,-1,0
Congo,2016,African Cup of Nations qualification,4,4,1,1,2,4,0,0
Congo,2016,FIFA World Cup qualification,1,3,0,2,0,2,-2,0
Congo,2016,Friendly,0,2,0,1,0,1,-2,0
Congo,2017,African Cup of Nations qualification,1,3,0,1,0,1,-2,0
Congo,2017,FIFA World Cup qualification,4,9,0,2,2,4,-5,0
Congo,2017,Friendly,2,5,0,2,1,3,-3,0
Congo,2018,African Cup of Nations qualification,6,5,1,1,2,4,1,0
Congo,2019,African Cup of Nations qualification,3,4,1,2,0,3,-1,0
Congo,2019,Friendly,1,1,0,0,1,1,0,0
Congo,2020,African Cup of Nations qualification,2,0,1,0,1,2,2,0
Congo,2020,Friendly,0,1,0,1,0,1,-1,0
Congo,2021,African Cup of Nations qualification,0,3,0,1,1,2,-3,0
Congo,2021,FIFA World Cup qualification,5,10,0,3,3,6,-5,0
Congo,2021,Friendly,1,0,1,0,0,1,1,0
Congo,2022,African Cup of Nations qualification,1,4,1,1,0,2,-3,0
Congo,2022,Friendly,5,10,0,3,1,4,-5,0
Congo,2023,African Cup of Nations qualification,4,6,1,2,1,4,-2,0
Congo,2023,FIFA World Cup qualification,2,4,0,1,0,1,-2,0
Congo,2024,African Cup of Nations qualification,2,8,1,2,1,4,-6,0
Congo,2024,FIFA World Cup qualification,0,6,0,1,0,1,-6,0
Congo,2024,Friendly,1,1,0,0,1,1,0,0
Cook Islands,1971,South Pacific Games,2,61,0,3,0,3,-59,0
Cook Islands,1995,South Pacific Games,2,37,1,3,0,4,-35,0
Cook Islands,1996,FIFA World Cup qualification,1,4,0,2,0,2,-3,0
Cook Islands,1998,Oceania Nations Cup,0,19,0,2,0,2,-19,0
Cook Islands,1998,Oceania Nations Cup qualification,8,11,2,1,1,4,-3,0
Cook Islands,2000,Oceania Nations Cup,1,22,0,2,0,2,-21,0
Cook Islands,2000,Oceania Nations Cup qualification,2,1,1,0,0,1,1,0
Cook Islands,2001,FIFA World Cup qualification,2,25,0,4,0,4,-23,0
Cook Islands,2004,FIFA World Cup qualification,1,17,0,4,0,4,-16,0
Cook Islands,2004,Friendly,0,0,0,0,1,1,0,0
Cook Islands,2007,South Pacific Games,4,9,1,3,0,4,-5,0
Cook Islands,2009,Friendly,3,2,1,0,1,2,1,0
Cook Islands,2011,FIFA World Cup qualification,4,6,0,2,1,3,-2,0
Cook Islands,2011,Pacific Games,4,15,1,3,0,4,-11,0
Cook Islands,2015,FIFA World Cup qualification,4,2,2,1,0,3,2,0
Cook Islands,2022,FIFA World Cup qualification,0,2,0,1,0,1,-2,0
Cook Islands,2023,Friendly,1,12,0,2,0,2,-11,0
Cook Islands,2023,Pacific Games,2,15,1,3,0,4,-13,0
Cook Islands,2024,FIFA World Cup qualification,1,3,0,1,0,1,-2,0
Cook Islands,2024,Oceania Nations Cup qualification,1,1,1,1,0,2,0,1
Corsica,1967,Friendly,2,0,1,0,0,1,2,0
Corsica,1998,Friendly,0,1,0,1,0,1,-1,0
Corsica,2009,Friendly,1,1,0,0,1,1,0,0
Corsica,2010,Corsica Cup,3,1,1,0,1,2,2,0
Corsica,2011,Friendly,1,0,1,0,0,1,1,0
Corsica,2015,Friendly,1,0,1,0,0,1,1,0
Corsica,2016,Friendly,1,1,0,0,1,1,0,0
Corsica,2017,Friendly,1,1,0,0,1,1,0,0
Costa Rica,1921,Friendly,13,0,2,0,0,2,13,0
Costa Rica,1930,Central American and Caribbean Games,31,5,4,1,0,5,26,1
Costa Rica,1935,Central American and Caribbean Games,18,7,4,1,0,5,11,0
Costa Rica,1938,Central American and Caribbean Games,24,3,4,1,0,5,21,0
Costa Rica,1941,CCCF Championship,23,5,4,0,0,4,18,0
Costa Rica,1943,CCCF Championship,20,15,3,3,0,6,5,1
Costa Rica,1946,CCCF Championship,24,6,4,1,0,5,18,0
Costa Rica,1946,Central American and Caribbean Games,25,12,3,3,0,6,13,0
Costa Rica,1948,CCCF Championship,18,11,4,2,1,7,7,0
Costa Rica,1951,CCCF Championship,13,5,2,1,1,4,8,0
Costa Rica,1953,CCCF Championship,19,2,6,0,0,6,17,0
Costa Rica,1955,CCCF Championship,19,4,6,0,0,6,15,1
Costa Rica,1955,Friendly,10,4,1,1,0,2,6,0
Costa Rica,1956,Pan American Championship,11,15,2,2,1,5,-4,0
Costa Rica,1957,FIFA World Cup qualification,16,7,4,1,1,6,9,0
Costa Rica,1959,Friendly,8,6,1,2,0,3,2,0
Costa Rica,1960,CCCF Championship,5,1,1,0,1,2,4,1
Costa Rica,1960,FIFA World Cup qualification,13,8,2,1,1,4,5,0
Costa Rica,1960,Pan American Championship,3,6,1,2,1,4,-3,0
Costa Rica,1961,CCCF Championship,4,1,1,0,0,1,3,0
Costa Rica,1961,FIFA World Cup qualification,9,6,3,2,0,5,3,0
Costa Rica,1963,CONCACAF Championship,14,2,5,0,1,6,12,1
Costa Rica,1963,Friendly,5,5,1,1,0,2,0,0
Costa Rica,1965,CONCACAF Championship,11,4,2,1,2,5,7,0
Costa Rica,1965,FIFA World Cup qualification,17,3,5,1,2,8,14,0
Costa Rica,1965,Friendly,5,2,3,0,2,5,3,0
Costa Rica,1967,Friendly,1,3,0,1,0,1,-2,0
Costa Rica,1968,FIFA World Cup qualification,7,3,2,1,1,4,4,0
Costa Rica,1968,Friendly,5,2,1,0,2,3,3,0
Costa Rica,1969,CONCACAF Championship,13,2,4,0,1,5,11,0
Costa Rica,1969,Friendly,1,2,0,1,0,1,-1,0
Costa Rica,1970,Friendly,2,0,1,0,0,1,2,0
Costa Rica,1971,CONCACAF Championship,6,5,2,2,1,5,1,0
Costa Rica,1972,CONCACAF Championship qualification,4,5,0,1,1,2,-1,0
Costa Rica,1972,Friendly,6,4,3,1,2,6,2,0
Costa Rica,1975,Friendly,4,9,1,1,1,3,-5,0
Costa Rica,1976,CONCACAF Championship qualification,8,6,1,1,4,6,2,0
Costa Rica,1976,Friendly,0,1,0,1,0,1,-1,0
Costa Rica,1980,CONCACAF Championship qualification,6,8,1,2,4,7,-2,0
Costa Rica,1980,Friendly,7,3,2,0,3,5,4,0
Costa Rica,1983,Friendly,6,3,2,2,1,5,3,0
Costa Rica,1984,Friendly,1,1,0,0,1,1,0,0
Costa Rica,1985,CONCACAF Championship,10,8,2,1,5,8,2,0
Costa Rica,1985,Friendly,8,4,4,2,1,7,4,0
Costa Rica,1988,CONCACAF Championship qualification,3,1,1,0,1,2,2,0
Costa Rica,1988,Friendly,6,5,3,2,1,6,1,0
Costa Rica,1989,CONCACAF Championship,10,6,5,2,1,8,4,0
Costa Rica,1989,Friendly,5,8,0,2,1,3,-3,0
Costa Rica,1990,FIFA World Cup,4,6,2,2,0,4,-2,0
Costa Rica,1990,Friendly,0,1,0,1,0,1,-1,0
Costa Rica,1990,Marlboro Cup,1,4,0,2,0,2,-3,0
Costa Rica,1990,Miami Cup,2,2,1,1,0,2,0,0
Costa Rica,1991,Friendly,2,3,0,1,3,4,-1,0
Costa Rica,1991,Gold Cup,5,9,1,4,0,5,-4,0
Costa Rica,1991,UNCAF Cup,10,1,3,0,0,3,9,0
Costa Rica,1992,FIFA World Cup qualification,16,11,4,4,0,8,5,0
Costa Rica,1992,Friendly,9,9,2,2,3,7,0,0
Costa Rica,1993,Friendly,9,13,2,4,1,7,-4,0
Costa Rica,1993,Gold Cup,6,5,1,1,3,5,1,0
Costa Rica,1993,UNCAF Cup,11,2,4,1,0,5,9,0
Costa Rica,1994,Friendly,3,2,1,1,1,3,1,0
Costa Rica,1995,Friendly,2,6,1,2,0,3,-4,0
Costa Rica,1995,Korea Cup,1,3,0,2,0,2,-2,0
Costa Rica,1995,UNCAF Cup,5,6,1,2,1,4,-1,0
Costa Rica,1996,FIFA World Cup qualification,9,5,4,2,0,6,4,0
Costa Rica,1996,Friendly,5,7,2,2,4,8,-2,0
Costa Rica,1997,Copa América,2,10,0,2,1,3,-8,0
Costa Rica,1997,FIFA World Cup qualification,13,12,3,4,3,10,1,0
Costa Rica,1997,Friendly,12,4,2,0,1,3,8,0
Costa Rica,1997,UNCAF Cup,12,3,3,0,2,5,9,0
Costa Rica,1998,Friendly,1,4,0,1,0,1,-3,0
Costa Rica,1998,Gold Cup,8,4,1,1,0,2,4,0
Costa Rica,1999,Friendly,20,10,3,2,3,8,10,0
Costa Rica,1999,UNCAF Cup,13,3,3,2,0,5,10,0
Costa Rica,2000,FIFA World Cup qualification,9,6,3,2,1,6,3,0
Costa Rica,2000,Friendly,9,8,3,2,0,5,1,0
Costa Rica,2000,Gold Cup,5,6,0,1,2,3,-1,0
Costa Rica,2001,Copa América,7,3,2,1,1,4,4,0
Costa Rica,2001,FIFA World Cup qualification,22,9,8,1,2,11,13,0
Costa Rica,2001,UNCAF Cup,8,5,2,1,2,5,3,0
Costa Rica,2002,FIFA World Cup,5,6,1,1,1,3,-1,0
Costa Rica,2002,Friendly,5,9,0,3,3,6,-4,0
Costa Rica,2002,Gold Cup,8,5,3,1,1,5,3,0
Costa Rica,2003,Friendly,8,7,4,3,0,7,1,0
Costa Rica,2003,Gold Cup,10,8,2,3,0,5,2,0
Costa Rica,2003,UNCAF Cup,5,1,4,0,1,5,4,1
Costa Rica,2004,Copa América,3,8,1,3,0,4,-5,0
Costa Rica,2004,FIFA World Cup qualification,15,11,3,2,3,8,4,0
Costa Rica,2004,Friendly,5,3,1,1,0,2,2,0
Costa Rica,2005,FIFA World Cup qualification,15,14,5,4,1,10,1,0
Costa Rica,2005,Friendly,8,13,0,4,2,6,-5,0
Costa Rica,2005,Gold Cup,6,4,2,1,1,4,2,0
Costa Rica,2005,UNCAF Cup,8,2,3,0,1,4,6,0
Costa Rica,2006,FIFA World Cup,3,9,0,3,0,3,-6,0
Costa Rica,2006,Friendly,5,14,1,5,1,7,-9,0
Costa Rica,2007,Friendly,19,7,4,0,7,11,12,0
Costa Rica,2007,Gold Cup,3,4,1,2,1,4,-1,0
Costa Rica,2007,UNCAF Cup,6,3,2,1,1,4,3,0
Costa Rica,2008,FIFA World Cup qualification,25,5,7,0,1,8,20,0
Costa Rica,2008,Friendly,2,5,0,2,2,4,-3,0
Costa Rica,2009,FIFA World Cup qualification,16,17,5,5,2,12,-1,0
Costa Rica,2009,Friendly,2,1,1,0,1,2,1,0
Costa Rica,2009,Gold Cup,10,6,2,1,2,5,4,0
Costa Rica,2009,UNCAF Cup,9,1,3,0,1,4,8,0
Costa Rica,2010,Friendly,8,16,2,6,2,10,-8,0
Costa Rica,2011,Copa América,2,4,1,2,0,3,-2,0
Costa Rica,2011,Friendly,10,16,2,4,5,11,-6,0
Costa Rica,2011,Gold Cup,8,6,1,1,2,4,2,0
Costa Rica,2011,UNCAF Cup,5,4,1,1,2,4,1,0
Costa Rica,2012,FIFA World Cup qualification,14,5,3,2,1,6,9,0
Costa Rica,2012,Friendly,6,6,2,2,3,7,0,0
Costa Rica,2013,FIFA World Cup qualification,13,7,5,2,3,10,6,0
Costa Rica,2013,Friendly,5,1,2,1,0,3,4,0
Costa Rica,2013,Gold Cup,4,2,2,2,0,4,2,0
Costa Rica,2013,UNCAF Cup,6,1,4,0,1,5,5,1
Costa Rica,2014,FIFA World Cup,5,2,2,0,3,5,3,0
Costa Rica,2014,Friendly,12,16,2,3,2,7,-4,0
Costa Rica,2014,UNCAF Cup,5,2,1,0,1,2,3,0
Costa Rica,2015,FIFA World Cup qualification,3,1,2,0,0,2,2,0
Costa Rica,2015,Friendly,4,8,0,4,1,5,-4,0
Costa Rica,2015,Gold Cup,3,4,0,1,3,4,-1,0
Costa Rica,2016,Copa América,3,6,1,1,1,3,-3,0
Costa Rica,2016,FIFA World Cup qualification,14,2,5,0,1,6,12,0
Costa Rica,2016,Friendly,6,4,2,0,0,2,2,0
Costa Rica,2017,FIFA World Cup qualification,8,8,2,2,4,8,0,0
Costa Rica,2017,Friendly,0,6,0,2,0,2,-6,0
Costa Rica,2017,Gold Cup,6,3,3,1,1,5,3,0
Costa Rica,2017,UNCAF Cup,3,1,1,1,0,2,2,0
Costa Rica,2018,FIFA World Cup,2,5,0,2,1,3,-3,0
Costa Rica,2018,Friendly,14,19,4,6,0,10,-5,0
Costa Rica,2018,Kirin Challenge Cup,0,3,0,1,0,1,-3,0
Costa Rica,2019,CONCACAF Nations League,4,3,1,0,3,4,1,0
Costa Rica,2019,Friendly,2,6,1,4,0,5,-4,0
Costa Rica,2019,Gold Cup,8,4,2,1,1,4,4,0
Costa Rica,2020,Friendly,2,6,0,4,1,5,-4,0
Costa Rica,2021,CONCACAF Nations League,2,2,0,0,2,2,0,0
Costa Rica,2021,FIFA World Cup qualification,6,7,2,3,3,8,-1,0
Costa Rica,2021,Friendly,0,5,0,2,2,4,-5,0
Costa Rica,2021,Gold Cup,6,4,3,1,0,4,2,0
Costa Rica,2022,CONCACAF Nations League,2,2,1,1,0,2,0,0
Costa Rica,2022,FIFA World Cup,3,11,1,2,0,3,-8,0
Costa Rica,2022,FIFA World Cup qualification,8,1,6,0,1,7,7,1
Costa Rica,2022,Friendly,6,3,2,0,1,3,3,0
Costa Rica,2023,CONCACAF Nations League,3,8,1,3,0,4,-5,0
Costa Rica,2023,Friendly,5,9,1,3,1,5,-4,0
Costa Rica,2023,Gold Cup,7,8,1,2,1,4,-1,0
Costa Rica,2024,CONCACAF Nations League,9,4,2,1,3,6,5,0
Costa Rica,2024,Copa América,2,4,1,1,1,3,-2,0
Costa Rica,2024,Copa América qualification,3,1,1,0,0,1,2,0
Costa Rica,2024,FIFA World Cup qualification,7,0,2,0,0,2,7,0
Costa Rica,2024,Friendly,3,3,1,1,1,3,0,0
Costa Rica,2025,Friendly,0,3,0,1,0,1,-3,0
Costa Rica,2025,Gold Cup qualification,13,1,2,0,0,2,12,0
County of Nice,2014,CONIFA World Football Cup,8,5,3,1,1,5,3,0
County of Nice,2015,CONIFA European Football Cup,11,8,3,1,0,4,3,0
Crimea,2006,ELF Cup,7,11,3,2,0,5,-4,0
Croatia,1940,Friendly,6,2,2,1,1,4,4,0
Croatia,1941,Friendly,6,7,1,1,0,2,-1,0
Croatia,1942,Friendly,12,16,2,3,2,7,-4,0
Croatia,1943,Friendly,1,1,1,1,0,2,0,0
Croatia,1944,Friendly,7,3,1,0,0,1,4,0
Croatia,1950,Friendly,4,1,1,0,0,1,3,0
Croatia,1956,Friendly,5,2,1,0,0,1,3,0
Croatia,1990,Friendly,4,1,2,0,0,2,3,1
Croatia,1991,Friendly,1,0,1,0,0,1,1,0
Croatia,1992,Friendly,4,4,1,2,1,4,0,0
Croatia,1993,Friendly,3,1,1,0,0,1,2,0
Croatia,1994,Friendly,9,6,2,1,2,5,3,0
Croatia,1994,UEFA Euro qualification,6,1,3,0,0,3,5,0
Croatia,1995,UEFA Euro qualification,16,4,4,1,2,7,12,0
Croatia,1996,FIFA World Cup qualification,5,2,1,0,1,2,3,0
Croatia,1996,Friendly,13,4,4,0,2,6,9,0
Croatia,1996,King Hassan II Tournament,3,3,0,0,2,2,0,0
Croatia,1996,UEFA Euro,5,5,2,2,0,4,0,0
Croatia,1997,FIFA World Cup qualification,15,11,4,1,3,8,4,0
Croatia,1997,Kirin Cup,4,5,0,1,1,2,-1,0
Croatia,1998,FIFA World Cup,11,5,5,2,0,7,6,0
Croatia,1998,Friendly,13,1,3,0,0,3,12,0
Croatia,1998,UEFA Euro qualification,7,5,2,1,0,3,2,0
Croatia,1999,Friendly,3,10,0,4,1,5,-7,0
Croatia,1999,Korea Cup,5,4,1,0,2,3,1,0
Croatia,1999,UEFA Euro qualification,6,4,2,0,3,5,2,0
Croatia,2000,FIFA World Cup qualification,1,1,0,0,2,2,0,0
Croatia,2000,Friendly,4,5,1,1,3,5,-1,0
Croatia,2001,FIFA World Cup qualification,14,1,5,0,1,6,13,0
Croatia,2001,Friendly,6,7,1,1,3,5,-1,0
Croatia,2002,FIFA World Cup,2,3,1,2,0,3,-1,0
Croatia,2002,Friendly,6,1,3,0,3,6,5,0
Croatia,2002,UEFA Euro qualification,0,2,0,1,1,2,-2,0
Croatia,2003,Friendly,5,6,1,1,2,4,-1,0
Croatia,2003,UEFA Euro qualification,14,3,6,1,1,8,11,0
Croatia,2004,FIFA World Cup qualification,6,2,2,0,1,3,4,0
Croatia,2004,Friendly,8,6,4,2,1,7,2,0
Croatia,2004,UEFA Euro,4,6,0,1,2,3,-2,0
Croatia,2005,FIFA World Cup qualification,15,3,5,0,2,7,12,0
Croatia,2005,Friendly,4,6,0,1,2,3,-2,0
Croatia,2006,FIFA World Cup,2,3,0,1,2,3,-1,0
Croatia,2006,Friendly,12,8,3,2,1,6,4,0
Croatia,2006,Lunar New Year Cup,4,2,1,1,0,2,2,1
Croatia,2006,UEFA Euro qualification,13,3,3,0,1,4,10,0
Croatia,2007,Friendly,10,4,3,0,0,3,6,0
Croatia,2007,UEFA Euro qualification,15,5,6,1,1,8,10,0
Croatia,2008,FIFA World Cup qualification,8,4,2,1,1,4,4,0
Croatia,2008,Friendly,6,7,2,1,2,5,-1,0
Croatia,2008,UEFA Euro,5,2,3,0,1,4,3,0
Croatia,2009,FIFA World Cup qualification,11,9,4,1,1,6,2,0
Croatia,2009,Friendly,10,3,3,0,0,3,7,0
Croatia,2010,Friendly,7,2,4,0,2,6,5,0
Croatia,2010,UEFA Euro qualification,8,1,3,0,1,4,7,0
Croatia,2011,Friendly,4,2,1,0,2,3,2,0
Croatia,2011,UEFA Euro qualification,13,6,5,2,1,8,7,0
Croatia,2012,FIFA World Cup qualification,6,2,3,0,1,4,4,0
Croatia,2012,Friendly,7,9,1,2,1,4,-2,0
Croatia,2012,UEFA Euro,4,3,1,1,1,3,1,0
Croatia,2013,FIFA World Cup qualification,8,7,3,3,2,8,1,0
Croatia,2013,Friendly,9,4,3,1,0,4,5,0
Croatia,2014,FIFA World Cup,6,6,1,2,0,3,0,0
Croatia,2014,Friendly,8,5,3,1,1,5,3,0
Croatia,2014,UEFA Euro qualification,10,1,3,0,1,4,9,0
Croatia,2015,Friendly,7,1,2,0,0,2,6,0
Croatia,2015,UEFA Euro qualification,10,4,3,1,2,6,6,0
Croatia,2016,FIFA World Cup qualification,10,1,3,0,1,4,9,0
Croatia,2016,Friendly,17,1,4,0,1,5,16,0
Croatia,2016,UEFA Euro,5,4,2,1,1,4,1,0
Croatia,2017,FIFA World Cup qualification,9,4,4,2,2,8,5,0
Croatia,2017,Friendly,4,6,1,1,2,4,-2,0
Croatia,2018,FIFA World Cup,14,9,4,1,2,7,5,0
Croatia,2018,Friendly,6,7,3,2,1,6,-1,0
Croatia,2018,UEFA Nations League,4,10,1,2,1,4,-6,0
Croatia,2019,Friendly,3,3,1,1,0,2,0,0
Croatia,2019,UEFA Euro qualification,17,7,5,1,2,8,10,0
Croatia,2020,Friendly,5,4,1,0,1,2,1,0
Croatia,2020,UEFA Nations League,9,16,1,5,0,6,-7,0
Croatia,2021,FIFA World Cup qualification,21,4,7,1,2,10,17,0
Croatia,2021,Friendly,1,2,0,1,1,2,-1,0
Croatia,2021,UEFA Euro,7,8,1,2,1,4,-1,0
Croatia,2022,FIFA World Cup,8,7,2,1,4,7,1,0
Croatia,2022,Friendly,4,2,2,0,1,3,2,0
Croatia,2022,UEFA Nations League,8,6,4,1,1,6,2,0
Croatia,2023,UEFA Euro qualification,13,4,5,2,1,8,9,0
Croatia,2023,UEFA Nations League,4,2,1,0,1,2,2,0
Croatia,2024,FIFA Series,4,2,1,0,1,2,2,0
Croatia,2024,Friendly,5,1,2,0,0,2,4,0
Croatia,2024,UEFA Euro,3,6,0,1,2,3,-3,0
Croatia,2024,UEFA Nations League,8,8,2,2,2,6,0,0
Croatia,2025,UEFA Nations League,2,2,1,1,0,2,0,0
Cuba,1930,Central American and Caribbean Games,22,4,5,0,0,5,18,0
Cuba,1934,FIFA World Cup qualification,13,14,2,3,1,6,-1,0
Cuba,1935,Central American and Caribbean Games,8,13,2,3,0,5,-5,0
Cuba,1938,FIFA World Cup,5,12,1,1,1,3,-7,0
Cuba,1938,Friendly,3,8,0,2,0,2,-5,0
Cuba,1939,Friendly,4,0,1,0,0,1,4,0
Cuba,1940,Friendly,1,1,0,0,1,1,0,0
Cuba,1942,Friendly,2,0,2,0,0,2,2,0
Cuba,1947,Friendly,4,0,1,0,1,2,4,0
Cuba,1947,NAFC Championship,6,5,1,1,0,2,1,1
Cuba,1948,Friendly,1,4,0,1,1,2,-3,0
Cuba,1949,FIFA World Cup qualification,2,8,0,2,0,2,-6,0
Cuba,1949,Friendly,3,9,1,3,1,5,-6,0
Cuba,1949,NAFC Championship,1,3,0,1,1,2,-2,0
Cuba,1955,CCCF Championship,2,17,0,5,0,5,-15,0
Cuba,1957,CCCF Championship,1,11,0,4,0,4,-10,0
Cuba,1960,CCCF Championship,3,4,0,1,0,1,-1,0
Cuba,1961,CCCF Championship,2,9,0,4,0,4,-7,0
Cuba,1965,FIFA World Cup qualification,3,5,1,2,1,4,-2,0
Cuba,1967,CONCACAF Championship qualification,5,7,0,2,2,4,-2,0
Cuba,1970,Friendly,1,2,0,1,0,1,-1,0
Cuba,1971,CONCACAF Championship,5,7,1,2,2,5,-2,0
Cuba,1971,CONCACAF Championship qualification,1,0,1,0,1,2,1,0
Cuba,1971,Friendly,0,1,0,1,0,1,-1,0
Cuba,1972,Friendly,0,2,0,1,0,1,-2,0
Cuba,1975,Friendly,10,4,3,0,1,4,6,0
Cuba,1976,CONCACAF Championship qualification,7,5,2,1,2,5,2,0
Cuba,1976,Friendly,6,3,1,1,0,2,3,1
Cuba,1977,Friendly,3,3,2,2,1,5,0,0
Cuba,1980,CONCACAF Championship qualification,7,0,3,0,1,4,7,0
Cuba,1980,Friendly,2,5,0,1,1,2,-3,0
Cuba,1981,CONCACAF Championship,4,8,1,2,2,5,-4,0
Cuba,1981,Friendly,0,6,0,2,0,2,-6,0
Cuba,1983,Friendly,0,6,0,3,1,4,-6,0
Cuba,1984,Friendly,2,1,1,0,1,2,1,0
Cuba,1985,Friendly,2,3,0,1,1,2,-1,0
Cuba,1986,Friendly,1,1,0,0,1,1,0,0
Cuba,1987,Friendly,7,8,2,3,3,8,-1,0
Cuba,1988,CONCACAF Championship qualification,1,2,0,1,1,2,-1,0
Cuba,1988,Friendly,0,0,0,0,1,1,0,0
Cuba,1992,CFU Caribbean Cup,1,2,0,1,2,3,-1,0
Cuba,1992,CFU Caribbean Cup qualification,8,0,2,0,0,2,8,0
Cuba,1995,CFU Caribbean Cup,7,3,3,1,0,4,4,1
Cuba,1995,CFU Caribbean Cup qualification,15,0,3,0,0,3,15,1
Cuba,1995,Friendly,0,0,0,0,1,1,0,0
Cuba,1996,CFU Caribbean Cup,7,2,3,1,1,5,5,0
Cuba,1996,CFU Caribbean Cup qualification,4,0,1,0,0,1,4,0
Cuba,1996,FIFA World Cup qualification,17,18,4,5,1,10,-1,0
Cuba,1996,Friendly,4,8,0,1,3,4,-4,0
Cuba,1997,Friendly,3,6,0,1,2,3,-3,0
Cuba,1997,Gold Cup qualification,2,0,1,0,0,1,2,1
Cuba,1998,CFU Caribbean Cup qualification,4,3,1,0,1,2,1,0
Cuba,1998,Gold Cup,2,10,0,2,0,2,-8,0
Cuba,1999,CFU Caribbean Cup,8,3,3,1,0,4,5,0
Cuba,1999,CFU Caribbean Cup qualification,13,2,3,0,0,3,11,0
Cuba,1999,Friendly,0,1,0,1,0,1,-1,0
Cuba,1999,Gold Cup qualification,3,2,1,1,1,3,1,1
Cuba,2000,FIFA World Cup qualification,7,3,2,1,5,8,4,0
Cuba,2000,Friendly,7,7,1,2,2,5,0,0
Cuba,2001,CFU Caribbean Cup,5,7,1,2,2,5,-2,0
Cuba,2001,CFU Caribbean Cup qualification,7,1,3,0,0,3,6,0
Cuba,2001,Friendly,3,7,0,2,1,3,-4,0
Cuba,2001,Gold Cup qualification,1,0,1,0,1,2,1,1
Cuba,2002,Friendly,0,1,0,1,1,2,-1,0
Cuba,2002,Gold Cup,0,1,0,1,1,2,-1,0
Cuba,2002,Gold Cup qualification,9,2,3,0,0,3,7,1
Cuba,2003,Friendly,4,6,2,3,1,6,-2,0
Cuba,2003,Gold Cup,2,8,1,2,0,3,-6,0
Cuba,2003,Gold Cup qualification,8,3,3,0,0,3,5,0
Cuba,2004,CFU Caribbean Cup qualification,4,0,2,0,0,2,4,1
Cuba,2004,FIFA World Cup qualification,8,4,2,0,2,4,4,0
Cuba,2004,Friendly,6,3,1,0,3,4,3,0
Cuba,2005,CFU Caribbean Cup,5,2,2,1,0,3,3,0
Cuba,2005,CFU Caribbean Cup qualification,2,1,1,0,1,2,1,0
Cuba,2005,Gold Cup,3,9,0,3,0,3,-6,0
Cuba,2006,CFU Caribbean Cup qualification,24,2,5,0,1,6,22,0
Cuba,2006,Friendly,1,0,1,0,1,2,1,0
Cuba,2007,CFU Caribbean Cup,4,6,1,2,1,4,-2,0
Cuba,2007,Friendly,1,8,0,3,0,3,-7,0
Cuba,2007,Gold Cup,3,9,0,2,1,3,-6,0
Cuba,2008,CFU Caribbean Cup,7,4,2,1,2,5,3,0
Cuba,2008,CFU Caribbean Cup qualification,14,2,2,0,1,3,12,0
Cuba,2008,FIFA World Cup qualification,13,21,3,5,0,8,-8,0
Cuba,2008,Friendly,1,0,1,0,1,2,1,0
Cuba,2010,CFU Caribbean Cup,5,2,3,1,1,5,3,0
Cuba,2010,CFU Caribbean Cup qualification,7,5,1,0,2,3,2,0
Cuba,2010,Friendly,3,0,1,0,0,1,3,0
Cuba,2011,Friendly,4,6,1,2,2,5,-2,0
Cuba,2011,Gold Cup,1,16,0,3,0,3,-15,0
Cuba,2012,CFU Caribbean Cup,5,2,4,1,0,5,3,0
Cuba,2012,CFU Caribbean Cup qualification,5,0,1,0,0,1,5,0
Cuba,2012,FIFA World Cup qualification,1,10,0,5,1,6,-9,0
Cuba,2012,Friendly,0,5,0,3,0,3,-5,0
Cuba,2013,Gold Cup,6,13,1,3,0,4,-7,0
Cuba,2014,CFU Caribbean Cup,5,5,1,1,1,3,0,0
Cuba,2014,Friendly,1,5,1,2,0,3,-4,0
Cuba,2015,FIFA World Cup qualification,1,1,0,0,2,2,0,0
Cuba,2015,Friendly,3,11,1,4,0,5,-8,0
Cuba,2015,Gold Cup,1,14,1,3,0,4,-13,0
Cuba,2016,CFU Caribbean Cup qualification,2,4,1,1,0,2,-2,0
Cuba,2016,Copa América qualification,0,4,0,1,0,1,-4,0
Cuba,2016,Friendly,0,2,0,1,0,1,-2,0
Cuba,2018,CONCACAF Nations League qualification,14,0,3,0,0,3,14,0
Cuba,2018,Friendly,6,10,1,3,2,6,-4,0
Cuba,2019,CONCACAF Nations League,0,18,0,4,0,4,-18,0
Cuba,2019,CONCACAF Nations League qualification,1,2,0,1,0,1,-1,0
Cuba,2019,Friendly,6,0,2,0,1,3,6,0
Cuba,2019,Gold Cup,0,17,0,3,0,3,-17,0
Cuba,2021,FIFA World Cup qualification,7,3,2,2,0,4,4,0
Cuba,2021,Friendly,3,4,1,2,0,3,-1,0
Cuba,2021,Gold Cup qualification,0,3,0,1,0,1,-3,0
Cuba,2022,CONCACAF Nations League,9,3,3,1,0,4,6,0
Cuba,2022,Friendly,8,4,2,1,1,4,4,0
Cuba,2023,CONCACAF Nations League,3,4,3,1,2,6,-1,0
Cuba,2023,Friendly,0,13,0,3,0,3,-13,0
Cuba,2023,Gold Cup,3,9,0,3,0,3,-6,0
Cuba,2024,CONCACAF Nations League,9,8,1,2,3,6,1,0
Cuba,2024,FIFA World Cup qualification,4,3,1,1,0,2,1,0
Cuba,2024,Friendly,1,0,1,0,0,1,1,0
Cuba,2025,Gold Cup qualification,1,6,0,2,0,2,-5,0
Curaçao,1924,Friendly,4,0,1,0,0,1,4,0
Curaçao,1926,Friendly,5,7,1,2,2,5,-2,0
Curaçao,1930,Friendly,2,1,1,0,0,1,1,0
Curaçao,1931,Friendly,1,0,1,0,0,1,1,0
Curaçao,1933,Friendly,5,1,2,0,0,2,4,0
Curaçao,1934,Friendly,8,5,2,0,1,3,3,0
Curaçao,1935,Friendly,13,7,5,2,0,7,6,0
Curaçao,1936,Friendly,4,5,1,1,0,2,-1,0
Curaçao,1937,Friendly,2,2,0,0,2,2,0,0
Curaçao,1938,Friendly,7,2,3,0,0,3,5,0
Curaçao,1941,CCCF Championship,16,12,1,1,2,4,4,0
Curaçao,1941,Friendly,8,3,2,0,2,4,5,0
Curaçao,1942,Friendly,2,2,0,0,1,1,0,0
Curaçao,1943,Friendly,8,7,1,0,3,4,1,0
Curaçao,1944,Friendly,26,14,6,2,1,9,12,0
Curaçao,1945,Friendly,2,4,0,2,0,2,-2,0
Curaçao,1946,Central American and Caribbean Games,25,10,3,1,2,6,15,0
Curaçao,1946,Friendly,13,4,3,1,0,4,9,0
Curaçao,1947,Friendly,11,1,3,0,1,4,10,0
Curaçao,1948,CCCF Championship,14,16,2,4,2,8,-2,0
Curaçao,1949,Friendly,3,0,1,0,0,1,3,0
Curaçao,1950,Friendly,8,11,1,3,0,4,-3,0
Curaçao,1952,Friendly,9,4,2,0,1,3,5,0
Curaçao,1953,CCCF Championship,17,9,2,2,2,6,8,0
Curaçao,1954,Friendly,4,1,2,0,0,2,3,0
Curaçao,1955,CCCF Championship,11,7,4,2,0,6,4,0
Curaçao,1956,Friendly,9,3,4,0,0,4,6,0
Curaçao,1957,CCCF Championship,7,4,2,1,1,4,3,0
Curaçao,1957,FIFA World Cup qualification,4,7,1,2,0,3,-3,0
Curaçao,1958,Friendly,3,11,0,2,0,2,-8,0
Curaçao,1960,CCCF Championship,9,11,2,1,2,5,-2,0
Curaçao,1960,FIFA World Cup qualification,2,1,1,0,1,2,1,0
Curaçao,1960,Friendly,0,0,0,0,1,1,0,0
Curaçao,1961,CCCF Championship,4,5,1,1,1,3,-1,0
Curaçao,1961,FIFA World Cup qualification,2,13,1,2,1,4,-11,0
Curaçao,1962,Friendly,9,18,2,3,1,6,-9,0
Curaçao,1963,CONCACAF Championship,10,8,3,3,0,6,2,0
Curaçao,1963,Friendly,5,3,2,0,0,2,2,0
Curaçao,1963,Phillip Seaga Cup,3,1,2,0,0,2,2,1
Curaçao,1965,CONCACAF Championship,4,16,0,3,2,5,-12,0
Curaçao,1965,FIFA World Cup qualification,2,3,1,1,2,4,-1,0
Curaçao,1965,Friendly,1,2,0,1,0,1,-1,0
Curaçao,1966,Friendly,5,5,1,2,2,5,0,0
Curaçao,1967,CONCACAF Championship qualification,4,6,0,2,2,4,-2,0
Curaçao,1968,FIFA World Cup qualification,3,9,1,3,0,4,-6,0
Curaçao,1968,Friendly,1,1,0,0,1,1,0,0
Curaçao,1969,CONCACAF Championship,9,12,2,2,1,5,-3,0
Curaçao,1970,Friendly,2,6,0,1,1,2,-4,0
Curaçao,1971,Friendly,3,1,1,0,0,1,2,0
Curaçao,1972,Friendly,1,7,0,2,0,2,-6,0
Curaçao,1973,CONCACAF Championship,4,19,0,3,2,5,-15,0
Curaçao,1973,Friendly,3,3,0,0,2,2,0,0
Curaçao,1976,CONCACAF Championship qualification,1,9,0,2,0,2,-8,0
Curaçao,1978,CFU Caribbean Cup qualification,1,5,1,2,1,4,-4,0
Curaçao,1980,CONCACAF Championship qualification,1,2,0,1,3,4,-1,0
Curaçao,1981,Friendly,3,2,1,1,0,2,1,0
Curaçao,1984,CONCACAF Championship qualification,0,4,0,1,1,2,-4,0
Curaçao,1988,CONCACAF Championship qualification,4,7,2,2,0,4,-3,0
Curaçao,1988,Friendly,2,1,1,0,2,3,1,0
Curaçao,1989,CFU Caribbean Cup,2,2,0,0,2,2,0,0
Curaçao,1989,CFU Caribbean Cup qualification,11,5,3,1,0,4,6,0
Curaçao,1989,Friendly,2,1,1,0,1,2,1,0
Curaçao,1990,CFU Caribbean Cup qualification,3,3,0,0,3,3,0,0
Curaçao,1990,Friendly,3,1,1,0,0,1,2,0
Curaçao,1992,CFU Caribbean Cup qualification,3,3,1,1,1,3,0,0
Curaçao,1992,FIFA World Cup qualification,1,4,0,1,1,2,-3,0
Curaçao,1995,CFU Caribbean Cup qualification,11,11,3,1,1,5,0,0
Curaçao,1996,CFU Caribbean Cup qualification,0,1,0,1,0,1,-1,0
Curaçao,1996,FIFA World Cup qualification,1,2,0,1,1,2,-1,0
Curaçao,1997,CFU Caribbean Cup qualification,1,2,0,1,0,1,-1,0
Curaçao,1998,CFU Caribbean Cup,2,9,0,3,0,3,-7,0
Curaçao,1998,CFU Caribbean Cup qualification,6,4,2,0,1,3,2,0
Curaçao,1999,CFU Caribbean Cup qualification,2,4,0,1,1,2,-2,0
Curaçao,2000,FIFA World Cup qualification,1,6,0,1,1,2,-5,0
Curaçao,2002,Gold Cup qualification,3,6,1,2,1,4,-3,0
Curaçao,2004,FIFA World Cup qualification,4,8,1,3,0,4,-4,0
Curaçao,2004,Friendly,12,3,3,0,1,4,9,0
Curaçao,2006,CFU Caribbean Cup qualification,1,7,0,2,1,3,-6,0
Curaçao,2008,CFU Caribbean Cup qualification,5,11,1,3,1,5,-6,0
Curaçao,2008,FIFA World Cup qualification,3,1,2,1,1,4,2,0
Curaçao,2008,Friendly,2,4,1,2,0,3,-2,0
Curaçao,2009,Friendly,2,6,0,2,1,3,-4,0
Curaçao,2010,ABCS Tournament,5,2,1,0,1,2,3,0
Curaçao,2010,CFU Caribbean Cup qualification,5,7,0,2,1,3,-2,0
Curaçao,2011,ABCS Tournament,1,5,0,2,0,2,-4,0
Curaçao,2011,FIFA World Cup qualification,15,13,2,3,1,6,2,0
Curaçao,2011,Friendly,2,6,0,3,1,4,-4,0
Curaçao,2012,ABCS Tournament,11,5,1,1,0,2,6,1
Curaçao,2012,CFU Caribbean Cup qualification,2,11,0,3,0,3,-9,0
Curaçao,2013,ABCS Tournament,3,3,1,1,0,2,0,0
Curaçao,2014,CFU Caribbean Cup,5,10,0,3,0,3,-5,0
Curaçao,2014,CFU Caribbean Cup qualification,6,5,2,1,3,6,1,0
Curaçao,2015,ABCS Tournament,4,1,1,0,1,2,3,1
Curaçao,2015,FIFA World Cup qualification,5,6,1,2,3,6,-1,0
Curaçao,2015,Friendly,1,0,1,0,0,1,1,0
Curaçao,2016,CFU Caribbean Cup qualification,21,6,5,1,0,6,15,0
Curaçao,2017,CFU Caribbean Cup,4,2,2,0,0,2,2,1
Curaçao,2017,Friendly,4,4,1,1,2,4,0,0
Curaçao,2017,Gold Cup,0,6,0,3,0,3,-6,0
Curaçao,2018,CONCACAF Nations League qualification,21,0,3,0,0,3,21,0
Curaçao,2018,Friendly,2,1,1,0,1,2,1,0
Curaçao,2019,CONCACAF Nations League,3,3,1,1,2,4,0,0
Curaçao,2019,CONCACAF Nations League qualification,1,2,0,1,0,1,-1,0
Curaçao,2019,Gold Cup,2,3,1,2,1,4,-1,0
Curaçao,2021,FIFA World Cup qualification,16,3,3,1,2,6,13,0
Curaçao,2021,Friendly,1,6,0,2,0,2,-5,0
Curaçao,2022,CONCACAF Nations League,2,6,1,2,0,3,-4,0
Curaçao,2022,Friendly,3,5,0,2,0,2,-2,0
Curaçao,2023,CONCACAF Nations League,6,9,1,4,0,5,-3,0
Curaçao,2023,Friendly,2,9,0,1,3,4,-7,0
Curaçao,2023,Gold Cup qualification,1,1,0,0,1,1,0,0
Curaçao,2024,CONCACAF Nations League,15,3,4,1,1,6,12,0
Curaçao,2024,FIFA World Cup qualification,6,1,2,0,0,2,5,0
Curaçao,2025,Friendly,0,2,0,1,0,1,-2,0
Cyprus,1949,Friendly,1,3,0,1,0,1,-2,0
Cyprus,1960,FIFA World Cup qualification,2,7,0,1,1,2,-5,0
Cyprus,1963,Friendly,3,1,1,0,0,1,2,0
Cyprus,1965,FIFA World Cup qualification,0,19,0,4,0,4,-19,0
Cyprus,1965,Friendly,2,0,1,0,0,1,2,0
Cyprus,1966,UEFA Euro qualification,1,5,0,1,0,1,-4,0
Cyprus,1967,UEFA Euro qualification,0,19,0,4,0,4,-19,0
Cyprus,1968,FIFA World Cup qualification,1,13,0,3,0,3,-12,0
Cyprus,1968,UEFA Euro qualification,2,1,1,0,0,1,1,0
Cyprus,1969,FIFA World Cup qualification,1,22,0,3,0,3,-21,0
Cyprus,1969,Friendly,0,1,0,1,0,1,-1,0
Cyprus,1970,Friendly,1,1,0,0,1,1,0,0
Cyprus,1970,UEFA Euro qualification,1,3,0,1,0,1,-2,0
Cyprus,1971,Friendly,0,9,0,3,0,3,-9,0
Cyprus,1971,UEFA Euro qualification,1,23,0,5,0,5,-22,0
Cyprus,1972,FIFA World Cup qualification,0,9,0,3,0,3,-9,0
Cyprus,1973,FIFA World Cup qualification,1,5,1,2,0,3,-4,0
Cyprus,1973,Friendly,0,3,0,1,0,1,-3,0
Cyprus,1974,Friendly,2,7,0,2,0,2,-5,0
Cyprus,1975,Friendly,1,2,0,1,0,1,-1,0
Cyprus,1975,UEFA Euro qualification,0,16,0,6,0,6,-16,0
Cyprus,1976,FIFA World Cup qualification,2,17,0,4,0,4,-15,0
Cyprus,1977,FIFA World Cup qualification,1,7,0,2,0,2,-6,0
Cyprus,1977,Friendly,1,3,0,2,0,2,-2,0
Cyprus,1978,Friendly,0,2,0,1,0,1,-2,0
Cyprus,1978,UEFA Euro qualification,0,5,0,1,0,1,-5,0
Cyprus,1979,Friendly,0,1,0,1,0,1,-1,0
Cyprus,1979,UEFA Euro qualification,2,14,0,4,1,5,-12,0
Cyprus,1980,FIFA World Cup qualification,2,18,0,4,0,4,-16,0
Cyprus,1980,Friendly,1,1,0,0,1,1,0,0
Cyprus,1981,FIFA World Cup qualification,2,11,0,4,0,4,-9,0
Cyprus,1981,Friendly,0,1,0,1,0,1,-1,0
Cyprus,1982,Friendly,1,2,0,1,1,2,-1,0
Cyprus,1982,UEFA Euro qualification,1,4,0,2,0,2,-3,0
Cyprus,1983,UEFA Euro qualification,3,17,0,4,2,6,-14,0
Cyprus,1984,FIFA World Cup qualification,2,5,0,3,0,3,-3,0
Cyprus,1984,Friendly,2,3,1,1,1,3,-1,0
Cyprus,1985,FIFA World Cup qualification,1,13,0,3,0,3,-12,0
Cyprus,1986,Friendly,0,0,0,0,1,1,0,0
Cyprus,1986,UEFA Euro qualification,2,6,0,2,0,2,-4,0
Cyprus,1987,Friendly,1,2,0,1,0,1,-1,0
Cyprus,1987,UEFA Euro qualification,1,18,0,6,1,7,-17,0
Cyprus,1988,FIFA World Cup qualification,1,8,0,2,1,3,-7,0
Cyprus,1988,Friendly,1,2,0,1,1,2,-1,0
Cyprus,1989,FIFA World Cup qualification,5,12,0,5,0,5,-7,0
Cyprus,1989,Friendly,0,0,0,0,1,1,0,0
Cyprus,1990,UEFA Euro qualification,2,11,0,3,0,3,-9,0
Cyprus,1991,Friendly,2,2,0,0,2,2,0,0
Cyprus,1991,UEFA Euro qualification,0,14,0,5,0,5,-14,0
Cyprus,1992,FIFA World Cup qualification,3,6,1,3,0,4,-3,0
Cyprus,1992,Friendly,10,8,3,2,1,6,2,0
Cyprus,1993,FIFA World Cup qualification,5,12,1,4,1,6,-7,0
Cyprus,1993,Friendly,2,2,0,0,2,2,0,0
Cyprus,1994,Friendly,5,7,1,2,0,3,-2,0
Cyprus,1994,UEFA Euro qualification,3,5,1,2,1,4,-2,0
Cyprus,1995,Friendly,8,9,1,2,1,4,-1,0
Cyprus,1995,UEFA Euro qualification,3,15,0,3,3,6,-12,0
Cyprus,1996,FIFA World Cup qualification,3,7,1,2,0,3,-4,0
Cyprus,1996,Friendly,6,8,2,3,2,7,-2,0
Cyprus,1997,Cyprus International Tournament,5,3,2,1,0,3,2,0
Cyprus,1997,FIFA World Cup qualification,7,8,2,2,1,5,-1,0
Cyprus,1997,Friendly,1,6,0,2,0,2,-5,0
Cyprus,1998,Cyprus International Tournament,2,1,1,0,1,2,1,0
Cyprus,1998,Friendly,3,2,1,0,0,1,1,0
Cyprus,1998,UEFA Euro qualification,4,5,2,1,0,3,-1,0
Cyprus,1999,Cyprus International Tournament,2,2,1,1,0,2,0,0
Cyprus,1999,Friendly,3,4,0,1,1,2,-1,0
Cyprus,1999,UEFA Euro qualification,8,16,2,3,0,5,-8,0
Cyprus,2000,Cyprus International Tournament,8,5,3,0,0,3,3,0
Cyprus,2000,FIFA World Cup qualification,8,6,2,1,0,3,2,0
Cyprus,2000,Friendly,0,2,0,1,2,3,-2,0
Cyprus,2001,Cyprus International Tournament,5,5,1,1,0,2,0,1
Cyprus,2001,FIFA World Cup qualification,5,25,0,5,2,7,-20,0
Cyprus,2001,Friendly,2,1,1,0,0,1,1,0
Cyprus,2002,Cyprus International Tournament,4,5,0,1,1,2,-1,0
Cyprus,2002,Friendly,1,3,0,1,1,2,-2,0
Cyprus,2002,UEFA Euro qualification,3,3,1,1,0,2,0,1
Cyprus,2003,Cyprus International Tournament,1,4,0,2,0,2,-3,0
Cyprus,2003,Friendly,1,2,0,1,0,1,-1,0
Cyprus,2003,UEFA Euro qualification,6,15,1,3,2,6,-9,0
Cyprus,2004,Cyprus International Tournament,5,4,2,1,0,3,1,1
Cyprus,2004,FIFA World Cup qualification,4,11,0,4,1,5,-7,0
Cyprus,2004,Friendly,2,1,1,0,1,2,1,0
Cyprus,2005,Cyprus International Tournament,2,3,0,1,1,2,-1,0
Cyprus,2005,FIFA World Cup qualification,4,9,1,4,0,5,-5,0
Cyprus,2005,Friendly,5,2,3,0,0,3,3,0
Cyprus,2006,Cyprus International Tournament,2,1,1,1,0,2,1,0
Cyprus,2006,Friendly,0,2,0,1,0,1,-2,0
Cyprus,2006,UEFA Euro qualification,8,12,1,2,1,4,-4,0
Cyprus,2007,Cyprus International Tournament,2,4,1,1,0,2,-2,0
Cyprus,2007,Friendly,3,1,1,0,0,1,2,0
Cyprus,2007,UEFA Euro qualification,9,12,3,4,1,8,-3,0
Cyprus,2008,FIFA World Cup qualification,2,4,0,2,1,3,-2,0
Cyprus,2008,Friendly,4,8,1,2,1,4,-4,0
Cyprus,2009,Cyprus International Tournament,3,4,1,1,0,2,-1,1
Cyprus,2009,FIFA World Cup qualification,12,12,2,3,2,7,0,0
Cyprus,2009,Friendly,1,7,0,2,0,2,-6,0
Cyprus,2010,Friendly,1,0,1,0,2,3,1,0
Cyprus,2010,UEFA Euro qualification,5,8,0,2,1,3,-3,0
Cyprus,2011,Cyprus International Tournament,1,3,0,1,1,2,-2,0
Cyprus,2011,Friendly,4,5,1,2,0,3,-1,0
Cyprus,2011,UEFA Euro qualification,2,12,0,4,1,5,-10,0
Cyprus,2012,FIFA World Cup qualification,4,8,1,3,0,4,-4,0
Cyprus,2012,Friendly,0,4,0,2,1,3,-4,0
Cyprus,2013,FIFA World Cup qualification,0,7,0,4,2,6,-7,0
Cyprus,2013,Friendly,1,3,0,1,0,1,-2,0
Cyprus,2014,Friendly,0,3,0,2,1,3,-3,0
Cyprus,2014,UEFA Euro qualification,9,5,2,2,0,4,4,0
Cyprus,2015,UEFA Euro qualification,7,12,2,4,0,6,-5,0
Cyprus,2016,FIFA World Cup qualification,3,8,1,3,0,4,-5,0
Cyprus,2016,Friendly,1,3,0,2,0,2,-2,0
Cyprus,2017,FIFA World Cup qualification,6,10,2,3,1,6,-4,0
Cyprus,2017,Friendly,5,9,1,3,0,4,-4,0
Cyprus,2018,Friendly,0,3,0,1,1,2,-3,0
Cyprus,2018,UEFA Nations League,5,9,1,3,2,6,-4,0
Cyprus,2019,UEFA Euro qualification,15,20,3,6,1,10,-5,0
Cyprus,2020,Friendly,2,4,0,2,0,2,-2,0
Cyprus,2020,UEFA Nations League,2,10,1,4,1,6,-8,0
Cyprus,2021,FIFA World Cup qualification,4,21,1,7,2,10,-17,0
Cyprus,2021,Friendly,0,5,0,2,0,2,-5,0
Cyprus,2022,Friendly,3,4,1,1,0,2,-1,0
Cyprus,2022,UEFA Nations League,6,12,2,3,3,8,-6,0
Cyprus,2023,Friendly,3,2,1,0,1,2,1,0
Cyprus,2023,UEFA Euro qualification,3,28,0,8,0,8,-25,0
Cyprus,2024,Friendly,7,6,1,2,1,4,1,0
Cyprus,2024,UEFA Nations League,4,15,2,4,0,6,-11,0
Cyprus,2025,FIFA World Cup qualification,3,2,1,1,0,2,1,0
Czech Republic,1994,Friendly,14,10,3,1,1,5,4,0
Czech Republic,1994,UEFA Euro qualification,6,1,1,0,2,3,5,0
Czech Republic,1995,Friendly,7,3,2,0,1,3,4,0
Czech Republic,1995,UEFA Euro qualification,15,5,5,1,1,7,10,0
Czech Republic,1996,FIFA World Cup qualification,6,1,1,1,1,3,5,0
Czech Republic,1996,Friendly,9,3,4,1,0,5,6,0
Czech Republic,1996,King Hassan II Tournament,3,2,1,0,1,2,1,0
Czech Republic,1996,UEFA Euro,7,8,2,2,2,6,-1,0
Czech Republic,1997,Confederations Cup,10,7,2,2,1,5,3,0
Czech Republic,1997,FIFA World Cup qualification,10,5,4,3,0,7,5,0
Czech Republic,1997,Friendly,2,1,1,0,0,1,1,0
Czech Republic,1998,Friendly,8,6,3,1,1,5,2,0
Czech Republic,1998,Kirin Cup,1,0,1,0,1,2,1,0
Czech Republic,1998,UEFA Euro qualification,8,2,3,0,0,3,6,0
Czech Republic,1999,Friendly,6,3,2,1,1,4,3,0
Czech Republic,1999,UEFA Euro qualification,18,3,7,0,0,7,15,0
Czech Republic,2000,FIFA World Cup qualification,5,0,2,0,1,3,5,0
Czech Republic,2000,Friendly,11,9,2,3,0,5,2,0
Czech Republic,2000,Lunar New Year Cup,2,1,1,0,0,1,1,1
Czech Republic,2000,UEFA Euro,3,3,1,2,0,3,0,0
Czech Republic,2001,FIFA World Cup qualification,15,10,4,4,1,9,5,0
Czech Republic,2001,Friendly,7,2,1,0,2,3,5,0
Czech Republic,2002,Cyprus International Tournament,6,3,2,0,0,2,3,1
Czech Republic,2002,Friendly,13,4,3,0,3,6,9,0
Czech Republic,2002,UEFA Euro qualification,4,0,2,0,0,2,4,0
Czech Republic,2003,Friendly,11,1,3,0,0,3,10,0
Czech Republic,2003,UEFA Euro qualification,19,5,5,0,1,6,14,0
Czech Republic,2004,FIFA World Cup qualification,6,2,3,1,0,4,4,0
Czech Republic,2004,Friendly,8,6,2,2,2,6,2,0
Czech Republic,2004,UEFA Euro,10,5,4,1,0,5,5,0
Czech Republic,2005,FIFA World Cup qualification,31,10,8,2,0,10,21,0
Czech Republic,2005,Friendly,4,2,1,1,0,2,2,0
Czech Republic,2006,FIFA World Cup,3,4,1,2,0,3,-1,0
Czech Republic,2006,Friendly,10,6,3,1,2,6,4,0
Czech Republic,2006,UEFA Euro qualification,13,2,3,0,1,4,11,0
Czech Republic,2007,Friendly,3,1,1,0,1,2,2,0
Czech Republic,2007,UEFA Euro qualification,14,3,6,1,1,8,11,0
Czech Republic,2008,FIFA World Cup qualification,5,2,2,1,1,4,3,0
Czech Republic,2008,Friendly,8,6,2,1,2,5,2,0
Czech Republic,2008,UEFA Euro,4,6,1,2,0,3,-2,0
Czech Republic,2009,FIFA World Cup qualification,12,4,2,1,3,6,8,0
Czech Republic,2009,Friendly,4,3,2,1,2,5,1,0
Czech Republic,2010,Friendly,9,6,2,2,1,5,3,0
Czech Republic,2010,UEFA Euro qualification,3,1,2,1,0,3,2,0
Czech Republic,2011,Friendly,6,7,1,2,0,3,-1,0
Czech Republic,2011,Kirin Cup,0,0,0,0,2,2,0,0
Czech Republic,2011,UEFA Euro qualification,12,7,4,2,1,7,5,0
Czech Republic,2012,FIFA World Cup qualification,3,1,1,0,2,3,2,0
Czech Republic,2012,Friendly,7,5,2,2,2,6,2,0
Czech Republic,2012,UEFA Euro,4,6,2,2,0,4,-2,0
Czech Republic,2013,FIFA World Cup qualification,10,8,3,3,1,7,2,0
Czech Republic,2013,Friendly,5,1,2,0,1,3,4,0
Czech Republic,2014,Friendly,5,7,0,2,2,4,-2,0
Czech Republic,2014,UEFA Euro qualification,10,5,4,0,0,4,5,0
Czech Republic,2015,Friendly,5,5,1,2,0,3,0,0
Czech Republic,2015,UEFA Euro qualification,9,9,3,2,1,6,0,0
Czech Republic,2016,FIFA World Cup qualification,2,4,1,1,2,4,-2,0
Czech Republic,2016,Friendly,14,6,3,2,2,7,8,0
Czech Republic,2016,UEFA Euro,2,5,0,2,1,3,-3,0
Czech Republic,2017,FIFA World Cup qualification,15,6,3,2,1,6,9,0
Czech Republic,2017,Friendly,7,3,3,1,0,4,4,0
Czech Republic,2018,Friendly,7,12,3,3,0,6,-5,0
Czech Republic,2018,UEFA Nations League,4,4,2,2,0,4,0,0
Czech Republic,2019,Friendly,3,6,0,2,0,2,-3,0
Czech Republic,2019,UEFA Euro qualification,13,11,5,3,0,8,2,0
Czech Republic,2020,Friendly,2,2,1,1,0,2,0,0
Czech Republic,2020,UEFA Nations League,9,5,4,2,0,6,4,0
Czech Republic,2021,FIFA World Cup qualification,14,9,4,2,2,8,5,0
Czech Republic,2021,Friendly,11,6,2,1,1,4,5,0
Czech Republic,2021,UEFA Euro,6,4,2,2,1,5,2,0
Czech Republic,2022,FIFA World Cup qualification,0,1,0,1,0,1,-1,0
Czech Republic,2022,Friendly,7,3,1,1,1,3,4,0
Czech Republic,2022,UEFA Nations League,5,13,1,4,1,6,-8,0
Czech Republic,2023,Friendly,5,2,1,0,1,2,3,0
Czech Republic,2023,UEFA Euro qualification,12,6,4,1,3,8,6,0
Czech Republic,2024,Friendly,13,4,4,0,0,4,9,0
Czech Republic,2024,UEFA Euro,3,5,0,2,1,3,-2,0
Czech Republic,2024,UEFA Nations League,9,8,3,1,2,6,1,0
Czech Republic,2025,FIFA World Cup qualification,6,1,2,0,0,2,5,0
Czechoslovakia,1903,Friendly,1,2,0,1,0,1,-1,0
Czechoslovakia,1906,Friendly,5,5,0,0,2,2,0,0
Czechoslovakia,1907,Friendly,7,8,1,1,0,2,-1,0
Czechoslovakia,1908,Friendly,2,9,0,2,0,2,-7,0
Czechoslovakia,1910,Friendly,4,6,0,2,0,2,-2,0
Czechoslovakia,1919,Inter-Allied Games,18,7,4,0,0,4,11,1
Czechoslovakia,1920,Olympic Games,15,3,3,1,0,4,12,0
Czechoslovakia,1921,Friendly,8,3,1,0,1,2,5,0
Czechoslovakia,1922,Friendly,9,5,2,1,1,4,4,0
Czechoslovakia,1923,Friendly,17,5,3,0,1,4,12,0
Czechoslovakia,1924,Friendly,6,1,2,0,0,2,5,0
Czechoslovakia,1924,Olympic Games,6,4,1,1,1,3,2,0
Czechoslovakia,1925,Friendly,13,3,3,1,0,4,10,0
Czechoslovakia,1926,Friendly,20,17,4,4,1,9,3,0
Czechoslovakia,1927,Central European International Cup,4,2,1,0,1,2,2,0
Czechoslovakia,1927,Friendly,22,10,6,0,1,7,12,0
Czechoslovakia,1928,Central European International Cup,1,2,1,1,0,2,-1,0
Czechoslovakia,1928,Friendly,18,4,4,0,0,4,14,0
Czechoslovakia,1929,Central European International Cup,12,6,2,1,1,4,6,0
Czechoslovakia,1929,Friendly,11,11,1,1,2,4,0,0
Czechoslovakia,1930,Friendly,12,10,3,2,3,8,2,0
Czechoslovakia,1931,Central European International Cup,13,10,1,1,2,4,3,0
Czechoslovakia,1931,Friendly,7,6,2,2,0,4,1,0
Czechoslovakia,1932,Central European International Cup,5,9,1,2,1,4,-4,1
Czechoslovakia,1932,Friendly,5,5,2,1,0,3,0,0
Czechoslovakia,1933,Central European International Cup,0,2,0,1,0,1,-2,0
Czechoslovakia,1933,FIFA World Cup qualification,2,1,1,0,0,1,1,0
Czechoslovakia,1933,Friendly,10,8,2,2,1,5,2,0
Czechoslovakia,1934,Central European International Cup,6,6,0,0,3,3,0,0
Czechoslovakia,1934,FIFA World Cup,9,6,3,1,0,4,3,0
Czechoslovakia,1934,Friendly,7,3,3,0,0,3,4,0
Czechoslovakia,1935,Central European International Cup,5,3,2,1,1,4,2,0
Czechoslovakia,1935,Friendly,1,2,0,1,1,2,-1,0
Czechoslovakia,1936,Central European International Cup,6,3,1,0,1,2,3,0
Czechoslovakia,1936,Friendly,4,4,1,2,0,3,0,0
Czechoslovakia,1937,Central European International Cup,10,13,2,2,0,4,-3,0
Czechoslovakia,1937,FIFA World Cup qualification,1,1,0,0,1,1,0,0
Czechoslovakia,1937,Friendly,19,18,4,2,1,7,1,0
Czechoslovakia,1938,Central European International Cup,0,4,0,1,0,1,-4,0
Czechoslovakia,1938,FIFA World Cup,5,3,1,1,1,3,2,0
Czechoslovakia,1938,FIFA World Cup qualification,6,0,1,0,0,1,6,0
Czechoslovakia,1938,Friendly,17,7,3,0,1,4,10,0
Czechoslovakia,1939,Friendly,15,11,1,0,2,3,4,0
Czechoslovakia,1946,Friendly,7,10,2,2,0,4,-3,0
Czechoslovakia,1947,Friendly,21,13,4,1,1,6,8,0
Czechoslovakia,1948,Balkan Cup,2,6,0,3,0,3,-4,0
Czechoslovakia,1948,Central European International Cup,5,4,1,1,1,3,1,1
Czechoslovakia,1948,Friendly,1,6,0,2,0,2,-5,0
Czechoslovakia,1949,Central European International Cup,6,5,1,1,0,2,1,0
Czechoslovakia,1949,Friendly,8,8,2,2,1,5,0,0
Czechoslovakia,1950,Friendly,7,8,2,1,1,4,-1,0
Czechoslovakia,1951,Friendly,3,4,0,1,1,2,-1,0
Czechoslovakia,1952,Friendly,5,13,0,3,1,4,-8,0
Czechoslovakia,1953,Central European International Cup,7,3,2,1,0,3,4,0
Czechoslovakia,1953,FIFA World Cup qualification,5,1,3,0,1,4,4,0
Czechoslovakia,1953,Friendly,2,6,0,1,1,2,-4,0
Czechoslovakia,1954,FIFA World Cup,0,7,0,2,0,2,-7,0
Czechoslovakia,1954,Friendly,1,4,0,1,0,1,-3,0
Czechoslovakia,1955,Central European International Cup,4,5,1,1,0,2,-1,0
Czechoslovakia,1955,Friendly,8,6,2,1,0,3,2,0
Czechoslovakia,1956,Central European International Cup,12,4,3,0,0,3,8,0
Czechoslovakia,1956,Friendly,4,11,1,4,2,7,-7,0
Czechoslovakia,1957,Central European International Cup,3,2,1,0,1,2,1,0
Czechoslovakia,1957,FIFA World Cup qualification,9,3,3,1,0,4,6,0
Czechoslovakia,1957,Friendly,2,1,1,0,0,1,1,0
Czechoslovakia,1958,Central European International Cup,3,2,1,0,1,2,1,0
Czechoslovakia,1958,FIFA World Cup,9,6,1,2,1,4,3,0
Czechoslovakia,1958,Friendly,4,6,1,3,0,4,-2,0
Czechoslovakia,1959,Central European International Cup,2,1,1,0,0,1,1,0
Czechoslovakia,1959,Friendly,2,5,0,2,0,2,-3,0
Czechoslovakia,1959,UEFA Euro qualification,11,5,2,1,1,4,6,0
Czechoslovakia,1960,Friendly,8,0,2,0,0,2,8,0
Czechoslovakia,1960,UEFA Euro,2,3,1,1,0,2,-1,0
Czechoslovakia,1960,UEFA Euro qualification,5,0,2,0,0,2,5,1
Czechoslovakia,1961,FIFA World Cup qualification,20,7,4,1,0,5,13,0
Czechoslovakia,1961,Friendly,7,5,2,0,1,3,2,0
Czechoslovakia,1962,FIFA World Cup,7,7,3,2,1,6,0,0
Czechoslovakia,1962,Friendly,12,5,3,1,0,4,7,0
Czechoslovakia,1962,UEFA Euro qualification,1,2,0,1,0,1,-1,0
Czechoslovakia,1963,Friendly,5,12,0,4,1,5,-7,0
Czechoslovakia,1963,UEFA Euro qualification,1,1,0,0,1,1,0,0
Czechoslovakia,1964,Friendly,9,10,1,2,2,5,-1,0
Czechoslovakia,1965,FIFA World Cup qualification,12,4,3,2,1,6,8,0
Czechoslovakia,1966,Friendly,6,8,1,3,2,6,-2,0
Czechoslovakia,1967,Friendly,2,1,1,0,0,1,1,0
Czechoslovakia,1967,UEFA Euro qualification,8,4,3,2,1,6,4,0
Czechoslovakia,1968,FIFA World Cup qualification,4,0,2,0,0,2,4,0
Czechoslovakia,1968,Friendly,6,2,2,0,0,2,4,0
Czechoslovakia,1969,FIFA World Cup qualification,12,7,3,1,1,5,5,0
Czechoslovakia,1969,Friendly,0,2,0,1,0,1,-2,0
Czechoslovakia,1970,FIFA World Cup,2,7,0,3,0,3,-5,0
Czechoslovakia,1970,Friendly,11,8,4,2,1,7,3,0
Czechoslovakia,1970,UEFA Euro qualification,1,1,0,0,1,1,0,0
Czechoslovakia,1971,Friendly,1,2,0,1,1,2,-1,0
Czechoslovakia,1971,UEFA Euro qualification,10,3,4,1,0,5,7,0
Czechoslovakia,1972,Brazil Independence Cup,1,2,0,1,2,3,-1,0
Czechoslovakia,1972,Friendly,12,9,3,3,0,6,3,0
Czechoslovakia,1973,FIFA World Cup qualification,9,3,2,1,1,4,6,0
Czechoslovakia,1973,Friendly,1,4,0,1,1,2,-3,0
Czechoslovakia,1974,Friendly,15,8,5,2,2,9,7,0
Czechoslovakia,1974,UEFA Euro qualification,0,3,0,1,0,1,-3,0
Czechoslovakia,1975,Friendly,3,3,0,0,4,4,0,0
Czechoslovakia,1975,UEFA Euro qualification,15,2,4,0,1,5,13,0
Czechoslovakia,1976,FIFA World Cup qualification,2,0,1,0,0,1,2,0
Czechoslovakia,1976,Friendly,8,9,1,1,3,5,-1,0
Czechoslovakia,1976,UEFA Euro,5,3,1,0,1,2,2,0
Czechoslovakia,1976,UEFA Euro qualification,4,2,1,0,1,2,2,0
Czechoslovakia,1977,FIFA World Cup qualification,2,6,1,2,0,3,-4,0
Czechoslovakia,1977,Friendly,7,7,2,3,2,7,0,0
Czechoslovakia,1978,Friendly,9,11,2,5,2,9,-2,0
Czechoslovakia,1978,UEFA Euro qualification,3,1,1,0,0,1,2,0
Czechoslovakia,1979,Friendly,6,6,2,2,0,4,0,0
Czechoslovakia,1979,UEFA Euro qualification,14,3,4,1,0,5,11,0
Czechoslovakia,1980,FIFA World Cup qualification,2,1,1,1,0,2,1,0
Czechoslovakia,1980,Friendly,15,9,3,3,3,9,6,0
Czechoslovakia,1980,UEFA Euro,5,4,1,1,2,4,1,0
Czechoslovakia,1981,FIFA World Cup qualification,13,5,3,1,2,6,8,0
Czechoslovakia,1981,Friendly,5,6,1,2,1,4,-1,0
Czechoslovakia,1982,FIFA World Cup,2,4,0,1,2,3,-2,0
Czechoslovakia,1982,Friendly,8,7,2,2,2,6,1,0
Czechoslovakia,1982,UEFA Euro qualification,4,4,0,0,2,2,0,0
Czechoslovakia,1983,Friendly,1,2,0,1,1,2,-1,0
Czechoslovakia,1983,UEFA Euro qualification,11,3,3,1,2,6,8,0
Czechoslovakia,1984,FIFA World Cup qualification,5,2,1,1,0,2,3,0
Czechoslovakia,1984,Friendly,4,3,2,1,1,4,1,0
Czechoslovakia,1985,FIFA World Cup qualification,6,10,2,2,2,6,-4,0
Czechoslovakia,1985,Friendly,3,3,1,1,0,2,0,0
Czechoslovakia,1986,Friendly,10,3,5,1,1,7,7,0
Czechoslovakia,1986,UEFA Euro qualification,3,0,1,0,1,2,3,0
Czechoslovakia,1987,Friendly,5,5,2,2,0,4,0,0
Czechoslovakia,1987,UEFA Euro qualification,4,5,1,1,2,4,-1,0
Czechoslovakia,1988,FIFA World Cup qualification,2,0,1,0,1,2,2,0
Czechoslovakia,1988,Friendly,13,11,5,2,2,9,2,0
Czechoslovakia,1989,FIFA World Cup qualification,11,3,4,1,1,6,8,0
Czechoslovakia,1989,Friendly,4,1,2,0,0,2,3,0
Czechoslovakia,1989,Korea Cup,0,0,0,0,1,1,0,0
Czechoslovakia,1990,FIFA World Cup,10,5,3,2,0,5,5,0
Czechoslovakia,1990,Friendly,3,8,0,4,1,5,-5,0
Czechoslovakia,1990,UEFA Euro qualification,5,4,2,1,0,3,1,0
Czechoslovakia,1991,Friendly,12,5,4,1,2,7,7,0
Czechoslovakia,1991,UEFA Euro qualification,7,5,3,2,0,5,2,0
Czechoslovakia,1992,FIFA World Cup qualification,6,3,1,1,1,3,3,0
Czechoslovakia,1992,Friendly,5,8,0,2,3,5,-3,0
Czechoslovakia,1993,FIFA World Cup qualification,15,6,3,0,4,7,9,0
DR Congo,1948,Friendly,2,3,0,1,0,1,-1,0
DR Congo,1950,Friendly,0,1,0,1,0,1,-1,0
DR Congo,1953,Friendly,2,3,0,1,0,1,-1,0
DR Congo,1956,Friendly,2,4,0,1,0,1,-2,0
DR Congo,1963,African Friendship Games,8,3,2,2,0,4,5,0
DR Congo,1964,Friendly,4,5,0,1,3,4,-1,0
DR Congo,1965,African Cup of Nations,2,8,0,2,0,2,-6,0
DR Congo,1965,African Cup of Nations qualification,8,8,2,2,0,4,0,0
DR Congo,1965,All-African Games,20,8,3,1,1,5,12,1
DR Congo,1965,Friendly,7,4,2,1,0,3,3,0
DR Congo,1966,Friendly,17,12,4,3,0,7,5,0
DR Congo,1967,African Cup of Nations qualification,7,4,4,1,0,5,3,0
DR Congo,1967,Friendly,32,23,6,5,3,14,9,0
DR Congo,1968,African Cup of Nations,10,5,4,1,0,5,5,0
DR Congo,1968,Friendly,1,1,1,1,0,2,0,0
DR Congo,1969,Friendly,21,2,4,0,0,4,19,0
DR Congo,1970,African Cup of Nations,2,5,0,2,1,3,-3,0
DR Congo,1970,African Cup of Nations qualification,5,1,2,0,0,2,4,0
DR Congo,1970,Friendly,3,0,1,0,0,1,3,0
DR Congo,1971,African Cup of Nations qualification,4,2,1,1,0,2,2,0
DR Congo,1971,Friendly,2,1,1,0,1,2,1,0
DR Congo,1972,African Cup of Nations,9,11,1,2,2,5,-2,0
DR Congo,1972,FIFA World Cup qualification,4,0,1,0,1,2,4,0
DR Congo,1972,Friendly,6,0,1,0,0,1,6,0
DR Congo,1973,African Cup of Nations qualification,12,3,3,1,0,4,9,0
DR Congo,1973,FIFA World Cup qualification,14,4,6,2,0,8,10,0
DR Congo,1974,African Cup of Nations,14,8,4,1,1,6,6,1
DR Congo,1974,FIFA World Cup,0,14,0,3,0,3,-14,0
DR Congo,1974,Friendly,2,0,1,0,0,1,2,0
DR Congo,1975,Friendly,7,8,1,2,1,4,-1,0
DR Congo,1976,African Cup of Nations,3,6,0,2,1,3,-3,0
DR Congo,1976,Friendly,9,4,2,1,1,4,5,0
DR Congo,1977,Beijing International Friendship Tournament,5,4,1,1,0,2,1,1
DR Congo,1979,African Cup of Nations qualification,10,10,2,2,0,4,0,0
DR Congo,1979,Friendly,12,9,3,2,1,6,3,0
DR Congo,1980,FIFA World Cup qualification,11,6,3,0,1,4,5,0
DR Congo,1980,Friendly,3,5,0,2,1,3,-2,0
DR Congo,1981,African Cup of Nations qualification,8,8,1,1,2,4,0,0
DR Congo,1981,FIFA World Cup qualification,2,6,1,1,0,2,-4,0
DR Congo,1981,Friendly,7,8,1,1,2,4,-1,0
DR Congo,1984,African Cup of Nations qualification,3,1,1,0,1,2,2,0
DR Congo,1985,African Cup of Nations qualification,5,3,1,1,2,4,2,0
DR Congo,1985,Friendly,9,8,4,3,0,7,1,0
DR Congo,1986,Friendly,3,2,1,0,1,2,1,0
DR Congo,1987,African Cup of Nations qualification,3,1,1,1,2,4,2,0
DR Congo,1987,Friendly,4,3,1,1,0,2,1,0
DR Congo,1988,African Cup of Nations,2,3,0,1,2,3,-1,0
DR Congo,1988,Friendly,1,0,1,0,1,2,1,0
DR Congo,1989,African Cup of Nations qualification,0,2,0,1,1,2,-2,0
DR Congo,1989,FIFA World Cup qualification,7,7,2,2,2,6,0,0
DR Congo,1989,Friendly,4,4,1,1,3,5,0,0
DR Congo,1990,African Cup of Nations qualification,3,2,1,1,0,2,1,0
DR Congo,1990,Friendly,0,2,0,2,2,4,-2,0
DR Congo,1991,African Cup of Nations qualification,3,2,2,1,1,4,1,0
DR Congo,1991,Friendly,0,0,0,0,2,2,0,0
DR Congo,1992,African Cup of Nations,2,3,0,1,2,3,-1,0
DR Congo,1992,African Cup of Nations qualification,5,1,2,0,0,2,4,0
DR Congo,1992,FIFA World Cup qualification,4,3,1,1,0,2,1,0
DR Congo,1992,Friendly,2,0,1,0,0,1,2,0
DR Congo,1993,African Cup of Nations qualification,8,2,1,1,2,4,6,0
DR Congo,1993,FIFA World Cup qualification,1,2,0,1,1,2,-1,0
DR Congo,1994,African Cup of Nations,2,3,1,1,1,3,-1,0
DR Congo,1994,African Cup of Nations qualification,2,4,0,2,1,3,-2,0
DR Congo,1994,Friendly,5,7,1,3,1,5,-2,0
DR Congo,1995,African Cup of Nations qualification,8,1,3,0,0,3,7,0
DR Congo,1995,Friendly,2,2,0,0,1,1,0,0
DR Congo,1996,African Cup of Nations,2,3,1,2,0,3,-1,0
DR Congo,1996,African Cup of Nations qualification,0,0,0,0,1,1,0,0
DR Congo,1996,FIFA World Cup qualification,7,2,2,1,0,3,5,0
DR Congo,1996,Friendly,4,10,1,2,0,3,-6,0
DR Congo,1997,African Cup of Nations qualification,6,5,2,1,2,5,1,0
DR Congo,1997,FIFA World Cup qualification,4,8,0,3,2,5,-4,0
DR Congo,1997,Friendly,0,0,0,0,1,1,0,0
DR Congo,1998,African Cup of Nations,10,9,3,2,1,6,1,0
DR Congo,1998,African Cup of Nations qualification,1,1,0,0,1,1,0,0
DR Congo,1999,African Cup of Nations qualification,6,5,3,2,0,5,1,0
DR Congo,1999,Friendly,2,1,1,0,1,2,1,0
DR Congo,2000,African Cup of Nations,0,1,0,1,2,3,-1,0
DR Congo,2000,African Cup of Nations qualification,6,5,1,1,2,4,1,0
DR Congo,2000,FIFA World Cup qualification,12,5,2,1,1,4,7,0
DR Congo,2000,Friendly,2,1,1,0,0,1,1,0
DR Congo,2001,African Cup of Nations qualification,4,5,2,1,1,4,-1,0
DR Congo,2001,FIFA World Cup qualification,5,13,2,3,1,6,-8,0
DR Congo,2001,Friendly,2,3,0,1,1,2,-1,0
DR Congo,2002,African Cup of Nations,3,4,1,2,1,4,-1,0
DR Congo,2002,African Cup of Nations qualification,4,3,1,1,0,2,1,0
DR Congo,2002,Friendly,4,2,1,0,1,2,2,0
DR Congo,2003,African Cup of Nations qualification,5,2,2,0,2,4,3,0
DR Congo,2003,Friendly,14,6,4,0,2,6,8,0
DR Congo,2004,African Cup of Nations,1,6,0,3,0,3,-5,0
DR Congo,2004,FIFA World Cup qualification,5,4,2,1,2,5,1,0
DR Congo,2004,Friendly,3,8,0,2,1,3,-5,0
DR Congo,2005,FIFA World Cup qualification,9,6,2,1,2,5,3,0
DR Congo,2005,Friendly,12,14,1,2,6,9,-2,0
DR Congo,2006,African Cup of Nations,3,6,1,2,1,4,-3,0
DR Congo,2006,African Cup of Nations qualification,4,3,1,0,1,2,1,0
DR Congo,2006,Friendly,1,7,0,3,1,4,-6,0
DR Congo,2007,African Cup of Nations qualification,4,3,1,1,2,4,1,0
DR Congo,2007,Friendly,4,3,1,1,1,3,1,0
DR Congo,2008,FIFA World Cup qualification,14,6,3,3,0,6,8,0
DR Congo,2008,Friendly,3,2,1,0,2,3,1,0
DR Congo,2009,Friendly,5,8,1,2,1,4,-3,0
DR Congo,2010,African Cup of Nations qualification,3,5,0,1,1,2,-2,0
DR Congo,2010,Friendly,6,16,0,4,0,4,-10,0
DR Congo,2011,African Cup of Nations qualification,7,6,2,2,0,4,1,0
DR Congo,2011,FIFA World Cup qualification,8,2,2,0,0,2,6,0
DR Congo,2011,Friendly,5,6,2,2,0,4,-1,0
DR Congo,2011,Nile Basin Tournament,4,2,3,1,0,4,2,0
DR Congo,2012,African Cup of Nations qualification,12,2,3,1,0,4,10,0
DR Congo,2012,FIFA World Cup qualification,2,1,1,1,0,2,1,0
DR Congo,2012,Friendly,2,3,0,1,3,4,-1,0
DR Congo,2013,African Cup of Nations,3,3,0,0,3,3,0,0
DR Congo,2013,FIFA World Cup qualification,1,2,0,1,3,4,-1,0
DR Congo,2014,African Cup of Nations qualification,10,9,3,3,0,6,1,0
DR Congo,2015,African Cup of Nations,7,7,1,1,4,6,0,0
DR Congo,2015,African Cup of Nations qualification,2,3,1,1,0,2,-1,0
DR Congo,2015,FIFA World Cup qualification,6,2,2,0,0,2,4,0
DR Congo,2015,Friendly,10,7,3,3,2,8,3,0
DR Congo,2016,African Cup of Nations qualification,14,3,4,0,0,4,11,0
DR Congo,2016,COSAFA Cup,1,1,1,1,1,3,0,0
DR Congo,2016,FIFA World Cup qualification,6,1,2,0,0,2,5,0
DR Congo,2016,Friendly,1,3,0,2,1,3,-2,0
DR Congo,2017,African Cup of Nations,7,5,2,1,1,4,2,0
DR Congo,2017,African Cup of Nations qualification,3,1,1,0,0,1,2,0
DR Congo,2017,FIFA World Cup qualification,8,6,2,1,1,4,2,0
DR Congo,2017,Friendly,3,4,1,2,0,3,-1,0
DR Congo,2018,African Cup of Nations qualification,4,5,0,1,3,4,-1,0
DR Congo,2018,Friendly,1,3,0,1,1,2,-2,0
DR Congo,2019,African Cup of Nations,6,6,1,2,1,4,0,0
DR Congo,2019,African Cup of Nations qualification,3,2,1,0,2,3,1,0
DR Congo,2019,Friendly,5,8,0,2,3,5,-3,0
DR Congo,2020,African Cup of Nations qualification,1,0,1,0,1,2,1,0
DR Congo,2020,Friendly,1,4,0,1,1,2,-3,0
DR Congo,2021,African Cup of Nations qualification,1,3,1,1,0,2,-2,0
DR Congo,2021,FIFA World Cup qualification,9,3,3,1,2,6,6,0
DR Congo,2021,Friendly,1,2,0,1,1,2,-1,0
DR Congo,2022,African Cup of Nations qualification,1,3,0,2,0,2,-2,0
DR Congo,2022,FIFA World Cup qualification,2,5,0,1,1,2,-3,0
DR Congo,2022,Friendly,3,2,1,2,0,3,1,0
DR Congo,2023,African Cup of Nations qualification,8,2,3,0,1,4,6,0
DR Congo,2023,FIFA World Cup qualification,2,1,1,1,0,2,1,0
DR Congo,2023,Friendly,2,2,1,1,2,4,0,0
DR Congo,2024,African Cup of Nations,6,5,1,1,5,7,1,0
DR Congo,2024,African Cup of Nations qualification,6,0,4,0,0,4,6,0
DR Congo,2024,FIFA World Cup qualification,2,1,1,0,1,2,1,0
DR Congo,2024,Friendly,1,2,0,1,1,2,-1,0
DR Congo,2025,FIFA World Cup qualification,3,0,2,0,0,2,3,0
Darfur,2012,Viva World Cup,1,38,0,3,0,3,-37,0
Darfur,2014,CONIFA World Football Cup,0,61,0,4,0,4,-61,0
Denmark,1908,Olympic Games,17,1,1,0,0,1,16,0
Denmark,1912,Friendly,3,1,1,0,0,1,2,0
Denmark,1912,Olympic Games,11,1,2,0,0,2,10,0
Denmark,1913,Friendly,22,1,3,0,0,3,21,0
Denmark,1914,Friendly,4,3,1,0,0,1,1,0
Denmark,1915,Friendly,12,1,3,0,0,3,11,0
Denmark,1916,Friendly,12,4,3,1,0,4,8,0
Denmark,1917,Friendly,17,3,3,0,1,4,14,0
Denmark,1918,Friendly,10,4,3,1,0,4,6,1
Denmark,1919,Friendly,10,7,2,2,0,4,3,0
Denmark,1920,Friendly,3,3,1,1,1,3,0,0
Denmark,1920,Olympic Games,0,1,0,1,0,1,-1,0
Denmark,1921,Friendly,4,2,1,0,2,3,2,0
Denmark,1922,Friendly,4,10,0,3,2,5,-6,0
Denmark,1923,Friendly,8,6,3,1,0,4,2,0
Denmark,1924,Friendly,2,3,1,1,0,2,-1,0
Denmark,1924,Nordic Championship,5,4,1,1,0,2,1,0
Denmark,1925,Friendly,5,7,0,1,1,2,-2,0
Denmark,1925,Nordic Championship,7,1,2,0,0,2,6,0
Denmark,1926,Friendly,6,4,1,1,0,2,2,0
Denmark,1926,Nordic Championship,4,2,1,0,1,2,2,1
Denmark,1927,Friendly,5,2,2,0,1,3,3,0
Denmark,1927,Nordic Championship,3,1,1,0,1,2,2,1
Denmark,1928,Friendly,1,4,0,2,0,2,-3,0
Denmark,1928,Nordic Championship,6,3,2,0,0,2,3,1
Denmark,1929,Nordic Championship,12,8,1,2,0,3,4,1
Denmark,1930,Friendly,6,3,1,0,0,1,3,0
Denmark,1930,Nordic Championship,12,3,2,1,0,3,9,0
Denmark,1931,Friendly,2,6,0,2,0,2,-4,0
Denmark,1931,Nordic Championship,6,7,1,2,0,3,-1,0
Denmark,1932,Friendly,3,4,0,1,0,1,-1,0
Denmark,1932,Nordic Championship,7,6,2,1,0,3,1,1
Denmark,1933,Friendly,2,2,0,0,1,1,0,0
Denmark,1933,Nordic Championship,7,4,2,0,1,3,3,1
Denmark,1934,Friendly,6,7,1,1,0,2,-1,0
Denmark,1934,Nordic Championship,5,10,0,3,0,3,-5,0
Denmark,1935,Friendly,0,3,0,1,0,1,-3,0
Denmark,1935,Nordic Championship,7,4,2,1,0,3,3,1
Denmark,1936,Friendly,2,1,1,0,0,1,1,0
Denmark,1936,Nordic Championship,11,7,2,0,1,3,4,0
Denmark,1937,Friendly,2,22,0,3,0,3,-20,0
Denmark,1937,Nordic Championship,9,3,3,0,0,3,6,1
Denmark,1938,Friendly,2,2,0,0,1,1,0,0
Denmark,1938,Nordic Championship,2,4,0,2,1,3,-2,0
Denmark,1939,Friendly,11,5,2,1,0,3,6,0
Denmark,1939,Nordic Championship,13,6,2,1,0,3,7,1
Denmark,1940,Friendly,4,5,0,1,2,3,-1,0
Denmark,1941,Friendly,5,4,1,0,2,3,1,0
Denmark,1942,Friendly,1,5,0,2,0,2,-4,0
Denmark,1943,Friendly,3,2,1,0,0,1,1,0
Denmark,1945,Friendly,14,13,2,3,0,5,1,0
Denmark,1946,Friendly,24,9,5,1,1,7,15,0
Denmark,1947,Friendly,3,8,0,1,1,2,-5,0
Denmark,1947,Nordic Championship,10,8,2,1,0,3,2,1
Denmark,1948,Friendly,8,0,1,0,1,2,8,0
Denmark,1948,Nordic Championship,4,3,1,2,0,3,1,0
Denmark,1949,Friendly,9,4,3,1,0,4,5,0
Denmark,1949,Nordic Championship,5,4,2,1,0,3,1,1
Denmark,1950,Friendly,4,18,0,4,0,4,-14,0
Denmark,1950,Nordic Championship,6,5,2,1,0,3,1,0
Denmark,1951,Friendly,4,6,0,1,1,2,-2,0
Denmark,1951,Nordic Championship,4,3,2,1,0,3,1,1
Denmark,1952,Friendly,4,6,1,2,0,3,-2,0
Denmark,1952,Nordic Championship,5,9,0,3,0,3,-4,0
Denmark,1953,Friendly,10,2,3,0,0,3,8,0
Denmark,1953,Nordic Championship,8,4,2,1,0,3,4,0
Denmark,1954,Friendly,2,3,0,1,1,2,-1,0
Denmark,1954,Nordic Championship,4,8,0,2,1,3,-4,0
Denmark,1955,Friendly,6,12,1,2,1,4,-6,0
Denmark,1955,Nordic Championship,6,5,1,0,2,3,1,0
Denmark,1956,FIFA World Cup qualification,3,7,0,2,0,2,-4,0
Denmark,1956,Friendly,5,12,0,2,1,3,-7,0
Denmark,1956,Nordic Championship,7,4,1,1,1,3,3,0
Denmark,1957,FIFA World Cup qualification,1,6,0,2,0,2,-5,0
Denmark,1957,Friendly,10,8,2,2,1,5,2,0
Denmark,1957,Nordic Championship,6,4,1,1,1,3,2,1
Denmark,1958,Friendly,8,13,2,2,1,5,-5,0
Denmark,1958,Nordic Championship,9,7,1,1,1,3,2,0
Denmark,1959,Friendly,4,3,1,1,0,2,1,0
Denmark,1959,Nordic Championship,4,6,1,1,0,2,-2,0
Denmark,1959,UEFA Euro qualification,3,7,0,1,1,2,-4,0
Denmark,1960,Friendly,10,6,1,1,0,2,4,0
Denmark,1960,Nordic Championship,5,3,2,1,0,3,2,0
Denmark,1961,Friendly,2,11,0,2,1,3,-9,0
Denmark,1961,Nordic Championship,14,3,2,1,0,3,11,0
Denmark,1962,Friendly,9,7,2,1,1,4,2,0
Denmark,1962,Nordic Championship,14,6,2,1,0,3,8,0
Denmark,1962,UEFA Euro qualification,9,2,2,0,0,2,7,0
Denmark,1963,Friendly,0,6,0,1,0,1,-6,0
Denmark,1963,Nordic Championship,7,3,1,0,2,3,4,0
Denmark,1963,UEFA Euro qualification,10,6,2,1,2,5,4,1
Denmark,1964,FIFA World Cup qualification,3,4,1,1,0,2,-1,0
Denmark,1964,Friendly,2,3,1,1,0,2,-1,0
Denmark,1964,Nordic Championship,4,6,1,2,0,3,-2,1
Denmark,1964,UEFA Euro,1,6,0,2,0,2,-5,0
Denmark,1965,FIFA World Cup qualification,4,14,0,3,1,4,-10,0
Denmark,1965,Friendly,3,1,1,0,0,1,2,0
Denmark,1965,Nordic Championship,7,4,2,0,1,3,3,0
Denmark,1966,Friendly,4,6,1,2,1,4,-2,0
Denmark,1966,Nordic Championship,2,5,0,3,0,3,-3,0
Denmark,1966,UEFA Euro qualification,0,8,0,2,0,2,-8,0
Denmark,1967,Friendly,14,2,1,0,0,1,12,0
Denmark,1967,Nordic Championship,9,1,2,0,1,3,8,1
Denmark,1967,UEFA Euro qualification,6,8,1,2,1,4,-2,0
Denmark,1968,FIFA World Cup qualification,0,4,0,2,0,2,-4,0
Denmark,1968,Friendly,6,3,1,1,1,3,3,0
Denmark,1968,Nordic Championship,9,4,2,1,0,3,5,0
Denmark,1969,FIFA World Cup qualification,6,6,2,1,1,4,0,0
Denmark,1969,Friendly,15,7,3,2,0,5,8,0
Denmark,1969,Nordic Championship,5,5,1,2,0,3,0,0
Denmark,1970,Friendly,0,7,0,2,1,3,-7,0
Denmark,1970,Nordic Championship,2,3,0,1,2,3,-1,0
Denmark,1970,UEFA Euro qualification,0,4,0,3,0,3,-4,0
Denmark,1971,Friendly,4,5,1,1,0,2,-1,0
Denmark,1971,Nordic Championship,5,4,1,1,1,3,1,1
Denmark,1971,UEFA Euro qualification,2,7,1,2,0,3,-5,0
Denmark,1972,FIFA World Cup qualification,1,6,0,2,0,2,-5,0
Denmark,1972,Friendly,6,3,1,0,1,2,3,0
Denmark,1972,Nordic Championship,3,2,1,1,0,2,1,0
Denmark,1973,FIFA World Cup qualification,1,7,0,1,1,2,-6,0
Denmark,1973,Friendly,3,7,0,2,1,3,-4,0
Denmark,1973,Nordic Championship,2,0,2,0,0,2,2,1
Denmark,1974,Friendly,13,3,3,1,0,4,10,0
Denmark,1974,Nordic Championship,1,3,0,1,1,2,-2,0
Denmark,1974,UEFA Euro qualification,1,2,0,1,1,2,-1,0
Denmark,1975,Nordic Championship,2,0,1,0,1,2,2,0
Denmark,1975,UEFA Euro qualification,2,12,0,4,0,4,-10,0
Denmark,1976,FIFA World Cup qualification,10,2,2,1,0,3,8,0
Denmark,1976,Friendly,4,3,2,1,1,4,1,0
Denmark,1976,Nordic Championship,3,0,1,0,1,2,3,0
Denmark,1977,FIFA World Cup qualification,4,10,0,3,0,3,-6,0
Denmark,1977,Friendly,10,7,3,2,0,5,3,0
Denmark,1977,Nordic Championship,4,2,2,0,0,2,2,0
Denmark,1978,Friendly,0,2,0,1,1,2,-2,0
Denmark,1978,Nordic Championship,4,2,2,0,0,2,2,1
Denmark,1978,UEFA Euro qualification,9,11,0,2,2,4,-2,0
Denmark,1979,Friendly,6,5,1,1,1,3,1,0
Denmark,1979,Nordic Championship,1,0,1,0,1,2,1,1
Denmark,1979,UEFA Euro qualification,4,6,1,3,0,4,-2,0
Denmark,1980,FIFA World Cup qualification,5,5,1,3,0,4,0,0
Denmark,1980,Friendly,3,5,0,1,2,3,-2,0
Denmark,1980,Nordic Championship,4,1,2,0,0,2,3,0
Denmark,1981,FIFA World Cup qualification,9,6,3,1,0,4,3,0
Denmark,1981,Friendly,5,1,2,0,0,2,4,0
Denmark,1981,Nordic Championship,6,3,3,0,0,3,3,1
Denmark,1982,Friendly,2,5,1,3,0,4,-3,0
Denmark,1982,Nordic Championship,5,5,1,1,1,3,0,0
Denmark,1982,UEFA Euro qualification,4,3,1,0,1,2,1,0
Denmark,1983,Friendly,3,1,1,0,0,1,2,0
Denmark,1983,UEFA Euro qualification,13,2,5,1,0,6,11,0
Denmark,1984,FIFA World Cup qualification,4,1,2,1,0,3,3,0
Denmark,1984,Friendly,6,11,2,3,1,6,-5,0
Denmark,1984,UEFA Euro,9,4,2,1,1,4,5,0
Denmark,1985,FIFA World Cup qualification,13,5,3,1,1,5,8,0
Denmark,1985,Friendly,4,5,1,2,0,3,-1,0
Denmark,1986,FIFA World Cup,10,6,3,1,0,4,4,0
Denmark,1986,Friendly,4,8,2,3,2,7,-4,0
Denmark,1986,UEFA Euro qualification,1,0,1,0,1,2,1,0
Denmark,1987,Friendly,0,2,0,2,0,2,-2,0
Denmark,1987,UEFA Euro qualification,3,2,2,1,1,4,1,0
Denmark,1988,FIFA World Cup qualification,2,2,0,0,2,2,0,0
Denmark,1988,Friendly,8,7,3,3,1,7,1,0
Denmark,1988,UEFA Euro,2,7,0,3,0,3,-5,0
Denmark,1989,FIFA World Cup qualification,13,4,3,1,0,4,9,0
Denmark,1989,Friendly,15,7,3,2,2,7,8,0
Denmark,1989,Malta International Tournament,2,0,1,0,2,3,2,0
Denmark,1990,Friendly,6,4,4,2,2,8,2,0
Denmark,1990,UEFA Euro qualification,5,4,1,1,1,3,1,0
Denmark,1991,Friendly,1,1,0,0,2,2,0,0
Denmark,1991,Scania 100 Tournament,0,6,0,2,0,2,-6,0
Denmark,1991,UEFA Euro qualification,13,3,5,0,0,5,10,0
Denmark,1992,FIFA World Cup qualification,1,0,1,0,3,4,1,0
Denmark,1992,Friendly,4,5,1,2,1,4,-1,0
Denmark,1992,UEFA Euro,6,4,2,1,2,5,2,1
Denmark,1993,CONMEBOL–UEFA Cup of Champions,1,1,0,0,1,1,0,0
Denmark,1993,FIFA World Cup qualification,14,2,6,1,1,8,12,0
Denmark,1993,Friendly,2,2,0,0,1,1,0,0
Denmark,1994,Friendly,7,5,3,2,0,5,2,0
Denmark,1994,UEFA Euro qualification,4,5,1,1,1,3,-1,0
Denmark,1995,Confederations Cup,5,1,2,0,1,3,4,1
Denmark,1995,Friendly,1,0,1,0,0,1,1,0
Denmark,1995,UEFA Euro qualification,15,4,5,0,2,7,11,0
Denmark,1996,FIFA World Cup qualification,4,1,2,0,0,2,3,0
Denmark,1996,Friendly,5,2,4,1,0,5,3,0
Denmark,1996,UEFA Euro,4,4,1,1,1,3,0,0
Denmark,1997,FIFA World Cup qualification,10,5,3,1,2,6,5,0
Denmark,1998,FIFA World Cup,9,7,2,2,1,5,2,0
Denmark,1998,Friendly,2,8,1,4,0,5,-6,0
Denmark,1998,UEFA Euro qualification,2,3,0,1,2,3,-1,0
Denmark,1999,Friendly,2,1,1,0,3,4,1,0
Denmark,1999,UEFA Euro qualification,17,5,6,1,0,7,12,0
Denmark,2000,FIFA World Cup qualification,4,3,1,0,2,3,1,0
Denmark,2000,Friendly,5,6,1,2,1,4,-1,0
Denmark,2000,Nordic Championship,2,0,1,0,0,1,2,0
Denmark,2000,UEFA Euro,0,8,0,3,0,3,-8,0
Denmark,2001,FIFA World Cup qualification,18,3,5,0,2,7,15,0
Denmark,2001,Friendly,4,2,1,1,1,3,2,0
Denmark,2002,FIFA World Cup,5,5,2,1,1,4,0,0
Denmark,2002,Friendly,11,6,6,1,0,7,5,0
Denmark,2002,UEFA Euro qualification,4,2,1,0,1,2,2,0
Denmark,2003,Friendly,9,4,3,0,1,4,5,0
Denmark,2003,UEFA Euro qualification,11,7,3,1,2,6,4,0
Denmark,2004,FIFA World Cup qualification,6,4,1,0,3,4,2,0
Denmark,2004,Friendly,9,7,2,2,1,5,2,0
Denmark,2004,UEFA Euro,4,5,1,1,2,4,-1,0
Denmark,2005,FIFA World Cup qualification,18,8,5,2,1,8,10,0
Denmark,2005,Friendly,5,1,2,0,0,2,4,0
Denmark,2006,Friendly,10,6,3,1,2,6,4,0
Denmark,2006,UEFA Euro qualification,6,0,2,0,1,3,6,0
Denmark,2007,Friendly,4,5,2,1,0,3,-1,0
Denmark,2007,UEFA Euro qualification,15,11,4,4,1,9,4,0
Denmark,2008,FIFA World Cup qualification,6,2,2,0,1,3,4,0
Denmark,2008,Friendly,5,8,1,2,3,6,-3,0
Denmark,2009,FIFA World Cup qualification,10,3,4,1,2,7,7,0
Denmark,2009,Friendly,5,4,1,1,2,4,1,0
Denmark,2010,FIFA World Cup,3,6,1,2,0,3,-3,0
Denmark,2010,Friendly,5,6,1,3,2,6,-1,0
Denmark,2010,UEFA Euro qualification,4,3,2,1,0,3,1,0
Denmark,2011,Friendly,8,6,3,2,0,5,2,0
Denmark,2011,UEFA Euro qualification,11,3,4,0,1,5,8,0
Denmark,2012,FIFA World Cup qualification,2,4,0,1,2,3,-2,0
Denmark,2012,Friendly,5,9,1,3,1,5,-4,0
Denmark,2012,UEFA Euro,4,5,1,2,0,3,-1,0
Denmark,2013,FIFA World Cup qualification,15,8,4,1,2,7,7,0
Denmark,2013,Friendly,6,8,2,2,0,4,-2,0
Denmark,2014,Friendly,4,7,1,3,1,5,-3,0
Denmark,2014,UEFA Euro qualification,6,4,2,1,1,4,2,0
Denmark,2015,Friendly,6,7,2,2,0,4,-1,0
Denmark,2015,UEFA Euro qualification,5,5,1,2,3,6,0,0
Denmark,2016,FIFA World Cup qualification,7,5,2,2,0,4,2,0
Denmark,2016,Friendly,8,3,2,1,1,4,5,0
Denmark,2016,Kirin Cup,6,2,1,0,1,2,4,1
Denmark,2017,FIFA World Cup qualification,18,4,5,0,3,8,14,0
Denmark,2017,Friendly,1,1,0,0,1,1,0,0
Denmark,2018,FIFA World Cup,3,2,1,0,3,4,1,0
Denmark,2018,Friendly,5,4,3,2,2,7,1,0
Denmark,2018,UEFA Nations League,4,1,2,0,2,4,3,0
Denmark,2019,Friendly,6,2,1,0,1,2,4,0
Denmark,2019,UEFA Euro qualification,23,6,4,0,4,8,17,0
Denmark,2020,Friendly,6,0,2,0,0,2,6,0
Denmark,2020,UEFA Nations League,8,7,3,2,1,6,1,0
Denmark,2021,FIFA World Cup qualification,30,3,9,1,0,10,27,0
Denmark,2021,Friendly,3,1,1,0,1,2,2,0
Denmark,2021,UEFA Euro,12,7,3,3,0,6,5,0
Denmark,2022,FIFA World Cup,1,3,0,2,1,3,-2,0
Denmark,2022,Friendly,5,4,1,1,0,2,1,0
Denmark,2022,UEFA Nations League,9,5,4,2,0,6,4,0
Denmark,2023,UEFA Euro qualification,19,10,7,2,1,10,9,0
Denmark,2024,Friendly,7,2,3,0,1,4,5,0
Denmark,2024,UEFA Euro,2,4,0,1,3,4,-2,0
Denmark,2024,UEFA Nations League,7,5,2,2,2,6,2,0
Denmark,2025,UEFA Nations League,3,5,1,1,0,2,-2,0
Djibouti,1947,Friendly,0,5,0,1,0,1,-5,0
Djibouti,1948,Friendly,1,2,0,1,0,1,-1,0
Djibouti,1949,Friendly,0,6,0,1,0,1,-6,0
Djibouti,1954,Friendly,3,14,0,3,0,3,-11,0
Djibouti,1960,African Friendship Games,2,9,0,1,0,1,-7,0
Djibouti,1960,Friendly,2,9,0,1,0,1,-7,0
Djibouti,1983,Friendly,3,12,0,2,0,2,-9,0
Djibouti,1984,Friendly,1,7,0,3,0,3,-6,0
Djibouti,1986,Friendly,2,8,0,2,1,3,-6,0
Djibouti,1988,Friendly,4,1,1,0,0,1,3,0
Djibouti,1994,CECAFA Cup,2,9,0,3,0,3,-7,0
Djibouti,1998,African Cup of Nations qualification,1,12,0,2,0,2,-11,0
Djibouti,1999,CECAFA Cup,2,6,0,2,0,2,-4,0
Djibouti,2000,African Cup of Nations qualification,1,4,0,2,0,2,-3,0
Djibouti,2000,CECAFA Cup,4,15,0,3,1,4,-11,0
Djibouti,2000,FIFA World Cup qualification,2,10,0,1,1,2,-8,0
Djibouti,2001,CECAFA Cup,3,17,0,3,0,3,-14,0
Djibouti,2005,CECAFA Cup,2,18,0,4,0,4,-16,0
Djibouti,2006,Arab Cup qualification,3,8,0,2,0,2,-5,0
Djibouti,2006,CECAFA Cup,0,10,0,3,0,3,-10,0
Djibouti,2007,CECAFA Cup,2,19,0,3,0,3,-17,0
Djibouti,2007,FIFA World Cup qualification,1,0,1,0,0,1,1,0
Djibouti,2008,CECAFA Cup,0,3,0,1,0,1,-3,0
Djibouti,2008,FIFA World Cup qualification,2,30,0,6,0,6,-28,0
Djibouti,2008,Friendly,2,3,0,1,0,1,-1,0
Djibouti,2009,CECAFA Cup,2,23,0,5,1,6,-21,0
Djibouti,2011,CECAFA Cup,2,10,0,3,0,3,-8,0
Djibouti,2011,FIFA World Cup qualification,0,8,0,2,0,2,-8,0
Djibouti,2015,African Cup of Nations qualification,1,10,0,2,0,2,-9,0
Djibouti,2015,CECAFA Cup,0,9,0,3,0,3,-9,0
Djibouti,2015,FIFA World Cup qualification,1,8,0,2,0,2,-7,0
Djibouti,2016,African Cup of Nations qualification,0,14,0,4,0,4,-14,0
Djibouti,2017,African Cup of Nations qualification,2,6,1,1,0,2,-4,0
Djibouti,2017,Friendly,0,8,0,2,0,2,-8,0
Djibouti,2019,African Cup of Nations qualification,2,2,0,0,2,2,0,0
Djibouti,2019,FIFA World Cup qualification,2,1,1,0,1,2,1,0
Djibouti,2021,Arab Cup qualification,0,1,0,1,0,1,-1,0
Djibouti,2021,FIFA World Cup qualification,4,29,0,6,0,6,-25,0
Djibouti,2021,Friendly,1,0,1,0,0,1,1,0
Djibouti,2022,African Cup of Nations qualification,2,5,0,2,0,2,-3,0
Djibouti,2023,FIFA World Cup qualification,0,7,0,2,0,2,-7,0
Djibouti,2023,Mauritius Four Nations Cup,6,2,2,0,0,2,4,0
Djibouti,2024,African Cup of Nations qualification,0,2,0,1,1,2,-2,0
Djibouti,2024,FIFA World Cup qualification,2,3,0,1,1,2,-1,0
Djibouti,2024,Friendly,1,1,0,0,1,1,0,0
Djibouti,2025,FIFA World Cup qualification,2,10,0,2,0,2,-8,0
Dominica,1932,Friendly,1,0,1,0,0,1,1,0
Dominica,1938,Friendly,6,4,2,1,0,3,2,0
Dominica,1939,Friendly,3,1,1,0,0,1,2,0
Dominica,1948,Friendly,0,11,0,2,0,2,-11,0
Dominica,1961,Windward Islands Tournament,3,13,0,2,1,3,-10,0
Dominica,1964,Windward Islands Tournament,5,12,0,2,2,4,-7,0
Dominica,1965,Windward Islands Tournament,4,3,2,1,0,3,1,0
Dominica,1966,Windward Islands Tournament,8,7,1,1,1,3,1,0
Dominica,1967,Windward Islands Tournament,5,10,0,3,0,3,-5,0
Dominica,1968,Windward Islands Tournament,3,11,0,2,1,3,-8,0
Dominica,1969,Friendly,2,12,0,2,0,2,-10,0
Dominica,1969,Windward Islands Tournament,1,5,0,3,0,3,-4,0
Dominica,1970,Windward Islands Tournament,2,4,0,2,1,3,-2,0
Dominica,1971,Windward Islands Tournament,8,2,2,0,1,3,6,1
Dominica,1972,Windward Islands Tournament,2,5,0,3,0,3,-3,0
Dominica,1973,Windward Islands Tournament,9,7,2,1,3,6,2,0
Dominica,1974,Windward Islands Tournament,4,2,1,1,1,3,2,0
Dominica,1981,CFU Caribbean Cup qualification,2,8,0,2,0,2,-6,0
Dominica,1983,CFU Caribbean Cup qualification,1,3,0,2,0,2,-2,0
Dominica,1984,Windward Islands Tournament,0,4,0,1,0,1,-4,0
Dominica,1985,CFU Caribbean Cup qualification,3,3,1,1,0,2,0,0
Dominica,1985,Friendly,1,3,0,2,0,2,-2,0
Dominica,1985,Windward Islands Tournament,0,0,0,0,2,2,0,0
Dominica,1988,CFU Caribbean Cup qualification,1,2,0,1,1,2,-1,0
Dominica,1989,CFU Caribbean Cup qualification,0,1,0,1,3,4,-1,0
Dominica,1990,CFU Caribbean Cup qualification,2,3,0,1,2,3,-1,0
Dominica,1992,CFU Caribbean Cup qualification,0,0,0,0,1,1,0,0
Dominica,1993,CFU Caribbean Cup qualification,3,7,0,2,1,3,-4,0
Dominica,1994,CFU Caribbean Cup qualification,6,4,2,0,0,2,2,0
Dominica,1995,Windward Islands Tournament,3,1,2,0,0,2,2,0
Dominica,1996,CFU Caribbean Cup qualification,1,2,0,1,1,2,-1,0
Dominica,1996,FIFA World Cup qualification,6,6,1,2,1,4,0,0
Dominica,1997,CFU Caribbean Cup qualification,13,10,3,2,0,5,3,0
Dominica,1998,CFU Caribbean Cup,2,15,0,3,0,3,-13,0
Dominica,1998,CFU Caribbean Cup qualification,7,3,2,0,1,3,4,0
Dominica,1998,Friendly,1,1,0,0,1,1,0,0
Dominica,1999,CFU Caribbean Cup qualification,2,5,0,2,1,3,-3,0
Dominica,1999,Friendly,6,9,2,3,0,5,-3,0
Dominica,2000,FIFA World Cup qualification,1,7,0,2,0,2,-6,0
Dominica,2000,Friendly,7,4,2,1,0,3,3,0
Dominica,2001,CFU Caribbean Cup qualification,3,8,0,3,0,3,-5,0
Dominica,2001,Windward Islands Tournament,4,12,0,3,1,4,-8,0
Dominica,2002,Friendly,0,4,0,1,0,1,-4,0
Dominica,2004,CFU Caribbean Cup qualification,1,16,0,3,0,3,-15,0
Dominica,2004,FIFA World Cup qualification,4,20,1,2,1,4,-16,0
Dominica,2004,Friendly,9,3,3,1,0,4,6,0
Dominica,2005,Friendly,0,6,0,2,0,2,-6,0
Dominica,2006,CFU Caribbean Cup qualification,0,5,0,2,1,3,-5,0
Dominica,2006,Friendly,0,6,0,2,0,2,-6,0
Dominica,2007,Friendly,1,3,0,1,1,2,-2,0
Dominica,2008,CFU Caribbean Cup qualification,1,6,0,2,0,2,-5,0
Dominica,2008,FIFA World Cup qualification,1,2,0,1,1,2,-1,0
Dominica,2008,Friendly,0,3,0,1,0,1,-3,0
Dominica,2009,Friendly,4,0,1,0,0,1,4,0
Dominica,2010,CFU Caribbean Cup qualification,13,9,2,2,1,5,4,0
Dominica,2010,Friendly,3,1,1,0,0,1,2,0
Dominica,2011,FIFA World Cup qualification,0,11,0,4,0,4,-11,0
Dominica,2011,Friendly,0,1,0,1,0,1,-1,0
Dominica,2012,CFU Caribbean Cup qualification,4,5,1,2,0,3,-1,0
Dominica,2013,Friendly,1,1,1,1,0,2,0,0
Dominica,2014,CFU Caribbean Cup qualification,1,7,0,2,1,3,-6,0
Dominica,2014,Windward Islands Tournament,3,5,0,1,0,1,-2,0
Dominica,2015,FIFA World Cup qualification,3,8,1,2,1,4,-5,0
Dominica,2015,Friendly,0,1,0,1,0,1,-1,0
Dominica,2015,Windward Islands Tournament,2,1,1,0,0,1,1,0
Dominica,2016,CFU Caribbean Cup qualification,9,6,1,2,0,3,3,0
Dominica,2017,Friendly,2,2,0,0,1,1,0,0
Dominica,2017,Windward Islands Tournament,4,3,1,0,2,3,1,0
Dominica,2018,CONCACAF Nations League qualification,2,5,1,1,1,3,-3,1
Dominica,2019,CONCACAF Nations League,3,14,1,5,0,6,-11,0
Dominica,2019,CONCACAF Nations League qualification,4,0,1,0,0,1,4,0
Dominica,2021,FIFA World Cup qualification,5,4,1,2,1,4,1,0
Dominica,2022,CONCACAF Nations League,1,2,0,1,2,3,-1,0
Dominica,2022,Friendly,5,2,2,0,0,2,3,0
Dominica,2023,CONCACAF Nations League,9,5,3,1,1,5,4,0
Dominica,2024,CONCACAF Nations League,6,18,1,4,1,6,-12,0
Dominica,2024,FIFA World Cup qualification,2,9,0,2,0,2,-7,0
Dominican Republic,1949,Friendly,1,0,1,0,0,1,1,0
Dominican Republic,1976,CONCACAF Championship qualification,0,6,0,2,0,2,-6,0
Dominican Republic,1986,Friendly,1,2,0,1,0,1,-1,0
Dominican Republic,1987,Friendly,2,6,0,3,1,4,-4,0
Dominican Republic,1991,CFU Caribbean Cup,1,11,0,2,1,3,-10,0
Dominican Republic,1991,CFU Caribbean Cup qualification,4,2,1,0,1,2,2,0
Dominican Republic,1992,FIFA World Cup qualification,2,3,0,1,1,2,-1,0
Dominican Republic,1993,CFU Caribbean Cup qualification,5,3,1,0,1,2,2,0
Dominican Republic,1994,CFU Caribbean Cup qualification,0,1,0,1,0,1,-1,0
Dominican Republic,1995,CFU Caribbean Cup qualification,4,6,1,2,0,3,-2,0
Dominican Republic,1996,CFU Caribbean Cup qualification,1,7,0,1,1,2,-6,0
Dominican Republic,1996,FIFA World Cup qualification,9,16,3,2,1,6,-7,0
Dominican Republic,1998,CFU Caribbean Cup qualification,3,6,1,1,0,2,-3,0
Dominican Republic,1999,CFU Caribbean Cup qualification,2,4,1,1,1,3,-2,0
Dominican Republic,2000,FIFA World Cup qualification,6,5,2,2,0,4,1,0
Dominican Republic,2000,Friendly,1,0,1,0,0,1,1,0
Dominican Republic,2001,CFU Caribbean Cup qualification,4,4,1,1,0,2,0,0
Dominican Republic,2002,Gold Cup qualification,12,9,2,3,0,5,3,0
Dominican Republic,2004,FIFA World Cup qualification,6,6,1,2,1,4,0,0
Dominican Republic,2004,Friendly,1,3,0,1,0,1,-2,0
Dominican Republic,2006,CFU Caribbean Cup qualification,9,11,2,3,0,5,-2,0
Dominican Republic,2006,Friendly,2,5,0,2,0,2,-3,0
Dominican Republic,2008,FIFA World Cup qualification,0,1,0,1,0,1,-1,0
Dominican Republic,2008,Friendly,1,13,0,3,0,3,-12,0
Dominican Republic,2010,CFU Caribbean Cup qualification,17,1,1,1,0,2,16,0
Dominican Republic,2011,FIFA World Cup qualification,18,8,4,2,2,8,10,0
Dominican Republic,2011,Friendly,2,0,2,0,0,2,2,0
Dominican Republic,2012,CFU Caribbean Cup,4,5,1,2,0,3,-1,0
Dominican Republic,2012,CFU Caribbean Cup qualification,11,5,4,0,2,6,6,0
Dominican Republic,2013,Friendly,3,5,1,1,0,2,-2,0
Dominican Republic,2014,CFU Caribbean Cup qualification,4,8,1,1,0,2,-4,0
Dominican Republic,2014,Friendly,0,2,0,1,0,1,-2,0
Dominican Republic,2015,FIFA World Cup qualification,1,5,0,2,0,2,-4,0
Dominican Republic,2015,Friendly,6,3,1,1,0,2,3,0
Dominican Republic,2016,CFU Caribbean Cup qualification,6,9,2,3,0,5,-3,0
Dominican Republic,2016,Friendly,5,0,1,0,0,1,5,0
Dominican Republic,2017,Friendly,4,0,2,0,0,2,4,0
Dominican Republic,2018,CONCACAF Nations League qualification,8,1,2,1,0,3,7,0
Dominican Republic,2018,Friendly,6,1,2,0,0,2,5,0
Dominican Republic,2019,CONCACAF Nations League,5,5,2,3,1,6,0,0
Dominican Republic,2019,CONCACAF Nations League qualification,1,3,0,1,0,1,-2,0
Dominican Republic,2019,Friendly,0,4,0,1,1,2,-4,0
Dominican Republic,2021,FIFA World Cup qualification,8,4,2,1,1,4,4,0
Dominican Republic,2021,Friendly,0,1,0,1,1,2,-1,0
Dominican Republic,2022,CONCACAF Nations League,5,6,1,2,1,4,-1,0
Dominican Republic,2022,Friendly,3,5,0,1,1,2,-2,0
Dominican Republic,2023,CONCACAF Nations League,17,7,4,2,2,8,10,0
Dominican Republic,2023,Friendly,0,5,0,1,0,1,-5,0
Dominican Republic,2024,CONCACAF Nations League,27,4,6,0,0,6,23,0
Dominican Republic,2024,FIFA World Cup qualification,4,1,1,1,0,2,3,0
Dominican Republic,2024,Friendly,3,4,1,1,0,2,-1,0
Dominican Republic,2025,Friendly,4,2,1,0,1,2,2,0
Donetsk PR,2015,Friendly,5,5,1,2,0,3,0,0
Donetsk PR,2016,Friendly,1,1,0,0,2,2,0,0
Donetsk PR,2017,Friendly,2,1,1,0,0,1,1,0
Délvidék,2016,Hungary Heritage Cup,4,3,1,1,0,2,1,0
Ecuador,1938,Bolivarian Games,10,15,2,2,1,5,-5,0
Ecuador,1939,Copa América,4,18,0,4,0,4,-14,0
Ecuador,1941,Copa América,1,21,0,4,0,4,-20,0
Ecuador,1942,Copa América,4,31,0,6,0,6,-27,0
Ecuador,1945,Copa América,9,27,0,5,1,6,-18,0
Ecuador,1947,Copa América,3,17,0,4,3,7,-14,0
Ecuador,1949,Copa América,7,21,1,6,0,7,-14,0
Ecuador,1953,Copa América,1,13,0,4,2,6,-12,0
Ecuador,1955,Copa América,4,22,0,5,0,5,-18,0
Ecuador,1957,Copa América,7,23,0,5,1,6,-16,0
Ecuador,1959,Copa América,5,9,1,2,1,4,-4,1
Ecuador,1959,Friendly,1,2,0,1,0,1,-1,0
Ecuador,1960,FIFA World Cup qualification,3,11,0,2,0,2,-8,0
Ecuador,1963,Copa América,14,18,1,3,2,6,-4,1
Ecuador,1965,FIFA World Cup qualification,7,7,2,2,1,5,0,0
Ecuador,1966,Copa América qualification,3,5,0,1,1,2,-2,0
Ecuador,1969,FIFA World Cup qualification,2,8,0,3,1,4,-6,0
Ecuador,1969,Friendly,4,1,1,0,0,1,3,0
Ecuador,1970,Friendly,2,6,0,2,0,2,-4,0
Ecuador,1972,Brazil Independence Cup,4,9,0,3,1,4,-5,0
Ecuador,1973,FIFA World Cup qualification,3,8,0,2,2,4,-5,0
Ecuador,1973,Friendly,7,7,1,1,4,6,0,0
Ecuador,1975,Copa América,4,10,0,3,1,4,-6,0
Ecuador,1975,Friendly,7,3,2,2,0,4,4,0
Ecuador,1976,Friendly,2,2,0,0,1,1,0,0
Ecuador,1977,FIFA World Cup qualification,1,9,0,3,1,4,-8,0
Ecuador,1977,Friendly,8,6,3,2,1,6,2,0
Ecuador,1979,Copa América,4,7,1,3,0,4,-3,0
Ecuador,1979,Friendly,5,4,2,1,1,4,1,0
Ecuador,1981,FIFA World Cup qualification,2,5,1,2,1,4,-3,0
Ecuador,1981,Friendly,1,9,0,2,0,2,-8,0
Ecuador,1983,Copa América,4,10,0,2,2,4,-6,0
Ecuador,1983,Friendly,0,0,0,0,2,2,0,0
Ecuador,1984,Friendly,4,6,0,2,4,6,-2,0
Ecuador,1985,FIFA World Cup qualification,4,11,0,3,1,4,-7,0
Ecuador,1985,Friendly,11,7,3,2,0,5,4,0
Ecuador,1987,Copa América,1,4,0,1,1,2,-3,0
Ecuador,1987,Friendly,5,8,1,4,1,6,-3,0
Ecuador,1988,Friendly,8,11,3,3,3,9,-3,0
Ecuador,1989,Copa América,2,2,1,1,2,4,0,0
Ecuador,1989,FIFA World Cup qualification,4,5,1,2,1,4,-1,0
Ecuador,1989,Friendly,6,9,1,3,2,6,-3,0
Ecuador,1991,Copa América,6,5,1,2,1,4,1,0
Ecuador,1991,Friendly,6,6,2,1,1,4,0,0
Ecuador,1992,Friendly,5,8,0,2,3,5,-3,0
Ecuador,1993,Copa América,13,5,4,2,0,6,8,0
Ecuador,1993,FIFA World Cup qualification,7,7,1,4,3,8,0,0
Ecuador,1993,Friendly,6,3,2,1,1,4,3,0
Ecuador,1994,Friendly,3,3,2,1,1,4,0,0
Ecuador,1995,Copa América,2,3,1,2,0,3,-1,0
Ecuador,1995,Friendly,2,3,0,1,1,2,-1,0
Ecuador,1995,Kirin Cup,1,5,0,2,0,2,-4,0
Ecuador,1995,Korea Cup,7,2,3,0,0,3,5,1
Ecuador,1996,FIFA World Cup qualification,8,7,3,3,0,6,1,0
Ecuador,1996,Friendly,16,5,7,1,2,10,11,0
Ecuador,1997,Copa América,5,2,2,0,2,4,3,0
Ecuador,1997,FIFA World Cup qualification,14,14,3,4,3,10,0,0
Ecuador,1997,Friendly,6,7,2,2,1,5,-1,0
Ecuador,1998,Friendly,1,5,0,1,0,1,-4,0
Ecuador,1999,Copa América,3,7,0,3,0,3,-4,0
Ecuador,1999,Friendly,11,9,3,2,5,10,2,0
Ecuador,2000,FIFA World Cup qualification,12,14,5,4,1,10,-2,0
Ecuador,2000,Friendly,6,5,1,2,1,4,1,0
Ecuador,2001,Copa América,5,5,1,2,0,3,0,0
Ecuador,2001,FIFA World Cup qualification,11,6,4,1,3,8,5,0
Ecuador,2001,Friendly,2,1,1,0,2,3,1,0
Ecuador,2002,FIFA World Cup,2,4,1,2,0,3,-2,0
Ecuador,2002,Friendly,9,7,4,3,3,10,2,0
Ecuador,2002,Gold Cup,2,2,1,1,0,2,0,0
Ecuador,2003,FIFA World Cup qualification,3,3,1,2,1,4,0,0
Ecuador,2003,Friendly,9,11,3,2,2,7,-2,0
Ecuador,2004,Copa América,3,10,0,3,0,3,-7,0
Ecuador,2004,FIFA World Cup qualification,9,8,4,3,0,7,1,0
Ecuador,2004,Friendly,5,10,0,3,2,5,-5,0
Ecuador,2005,FIFA World Cup qualification,11,8,3,1,3,7,3,0
Ecuador,2005,Friendly,13,13,5,4,1,10,0,0
Ecuador,2006,FIFA World Cup,5,4,2,2,0,4,1,0
Ecuador,2006,Friendly,6,9,1,4,3,8,-3,0
Ecuador,2007,Copa América,3,6,0,3,0,3,-3,0
Ecuador,2007,FIFA World Cup qualification,6,12,1,3,0,4,-6,1
Ecuador,2007,Friendly,18,18,4,5,2,11,0,0
Ecuador,2008,FIFA World Cup qualification,6,5,2,1,3,6,1,0
Ecuador,2008,Friendly,6,7,3,3,0,6,-1,0
Ecuador,2009,FIFA World Cup qualification,10,9,3,3,2,8,1,0
Ecuador,2009,Friendly,1,3,0,1,1,2,-2,0
Ecuador,2010,Friendly,8,8,2,3,2,7,0,0
Ecuador,2011,Copa América,2,5,0,2,1,3,-3,0
Ecuador,2011,FIFA World Cup qualification,5,2,2,1,0,3,3,0
Ecuador,2011,Friendly,19,11,4,1,6,11,8,0
Ecuador,2012,FIFA World Cup qualification,7,7,3,1,2,6,0,0
Ecuador,2012,Friendly,5,0,2,0,0,2,5,0
Ecuador,2013,FIFA World Cup qualification,8,7,2,3,2,7,1,0
Ecuador,2013,Friendly,12,10,2,2,2,6,2,0
Ecuador,2014,FIFA World Cup,3,3,1,1,1,3,0,0
Ecuador,2014,Friendly,8,9,1,1,2,4,-1,0
Ecuador,2015,Copa América,4,6,1,2,0,3,-2,0
Ecuador,2015,FIFA World Cup qualification,9,2,4,0,0,4,7,0
Ecuador,2015,Friendly,8,3,2,1,1,4,5,0
Ecuador,2016,Copa América,7,4,1,1,2,4,3,0
Ecuador,2016,FIFA World Cup qualification,13,14,2,4,2,8,-1,0
Ecuador,2017,FIFA World Cup qualification,4,13,0,6,0,6,-9,0
Ecuador,2017,Friendly,10,3,3,0,1,4,7,0
Ecuador,2018,Friendly,11,5,4,1,1,6,6,0
Ecuador,2019,Copa América,2,7,0,2,1,3,-5,0
Ecuador,2019,Friendly,11,12,3,4,2,9,-1,0
Ecuador,2020,FIFA World Cup qualification,13,6,3,1,0,4,7,0
Ecuador,2021,Copa América,5,9,0,2,3,5,-4,0
Ecuador,2021,FIFA World Cup qualification,10,7,4,4,2,10,3,0
Ecuador,2021,Friendly,6,4,2,0,1,3,2,0
Ecuador,2022,FIFA World Cup,4,3,1,1,1,3,1,0
Ecuador,2022,FIFA World Cup qualification,4,6,0,1,3,4,-2,0
Ecuador,2022,Friendly,2,0,2,0,3,5,2,0
Ecuador,2022,Kirin Challenge Cup,0,0,0,0,1,1,0,0
Ecuador,2023,FIFA World Cup qualification,5,3,3,1,2,6,2,0
Ecuador,2023,Friendly,7,5,3,1,0,4,2,0
Ecuador,2024,Copa América,5,4,1,1,2,4,1,0
Ecuador,2024,FIFA World Cup qualification,6,1,3,1,2,6,5,0
Ecuador,2024,Friendly,7,5,3,2,0,5,2,0
Ecuador,2025,FIFA World Cup qualification,2,1,1,0,1,2,1,0
Egypt,1920,Friendly,4,2,1,0,0,1,2,0
Egypt,1920,Olympic Games,1,2,0,1,0,1,-1,0
Egypt,1924,Friendly,11,8,1,2,0,3,3,0
Egypt,1924,Olympic Games,3,5,1,1,0,2,-2,0
Egypt,1928,Friendly,3,2,1,0,1,2,1,0
Egypt,1928,Olympic Games,12,19,2,2,0,4,-7,0
Egypt,1932,Friendly,0,0,0,0,1,1,0,0
Egypt,1934,FIFA World Cup,2,4,0,1,0,1,-2,0
Egypt,1934,FIFA World Cup qualification,11,2,2,0,0,2,9,0
Egypt,1936,Friendly,3,1,1,0,0,1,2,0
Egypt,1948,Friendly,1,1,0,0,1,1,0,0
Egypt,1949,Friendly,5,4,1,1,0,2,1,0
Egypt,1950,Friendly,2,0,1,0,0,1,2,0
Egypt,1951,Friendly,0,1,0,1,0,1,-1,0
Egypt,1952,Friendly,1,6,0,1,1,2,-5,0
Egypt,1953,FIFA World Cup qualification,1,2,0,1,0,1,-1,0
Egypt,1953,Friendly,1,3,0,1,0,1,-2,0
Egypt,1954,FIFA World Cup qualification,1,5,0,1,0,1,-4,0
Egypt,1954,Friendly,1,4,0,1,1,2,-3,0
Egypt,1955,Friendly,2,6,1,2,0,3,-4,0
Egypt,1957,African Cup of Nations,6,1,2,0,0,2,5,1
Egypt,1957,Friendly,5,5,1,1,0,2,0,0
Egypt,1958,Friendly,2,1,1,0,0,1,1,0
Egypt,1959,African Cup of Nations,6,1,2,0,0,2,5,1
Egypt,1960,Friendly,3,14,0,4,1,5,-11,0
Egypt,1961,Friendly,0,2,0,1,0,1,-2,0
Egypt,1962,African Cup of Nations,4,5,1,1,0,2,-1,0
Egypt,1962,Friendly,1,0,1,0,0,1,1,0
Egypt,1963,African Cup of Nations,11,5,2,0,1,3,6,0
Egypt,1963,Friendly,36,8,5,1,3,9,28,0
Egypt,1964,Friendly,1,0,1,0,0,1,1,0
Egypt,1966,African Cup of Nations qualification,2,2,0,0,1,1,0,0
Egypt,1966,Friendly,2,8,0,1,1,2,-6,0
Egypt,1967,African Cup of Nations qualification,4,2,2,0,0,2,2,0
Egypt,1967,Friendly,3,7,0,2,1,3,-4,0
Egypt,1969,African Cup of Nations qualification,2,1,1,0,1,2,1,0
Egypt,1969,Friendly,4,11,1,2,0,3,-7,0
Egypt,1970,African Cup of Nations,10,5,3,1,1,5,5,1
Egypt,1970,African Cup of Nations qualification,1,0,1,0,0,1,1,0
Egypt,1971,African Cup of Nations qualification,5,6,2,1,0,3,-1,0
Egypt,1971,Friendly,3,2,2,1,0,3,1,0
Egypt,1972,FIFA World Cup qualification,2,3,1,1,0,2,-1,0
Egypt,1972,Palestine Cup,10,4,3,0,2,5,6,1
Egypt,1973,All-African Games,12,12,3,2,0,5,0,0
Egypt,1973,Friendly,10,1,1,0,0,1,9,0
Egypt,1973,Palestine Cup,8,4,2,2,0,4,4,0
Egypt,1974,African Cup of Nations,13,5,4,1,0,5,8,0
Egypt,1975,African Cup of Nations qualification,5,0,2,0,0,2,5,0
Egypt,1975,Friendly,3,2,1,0,0,1,1,0
Egypt,1975,Palestine Cup,11,2,4,0,0,4,9,0
Egypt,1976,African Cup of Nations,9,12,1,3,2,6,-3,0
Egypt,1976,FIFA World Cup qualification,5,1,2,0,0,2,4,0
Egypt,1977,African Cup of Nations qualification,4,5,0,1,1,2,-1,0
Egypt,1977,FIFA World Cup qualification,10,11,4,2,2,8,-1,0
Egypt,1978,All-African Games,6,2,2,0,1,3,4,0
Egypt,1979,African Cup of Nations qualification,4,3,1,1,0,2,1,0
Egypt,1980,African Cup of Nations,6,7,2,2,1,5,-1,0
Egypt,1981,African Cup of Nations qualification,7,3,2,0,0,2,4,0
Egypt,1981,FIFA World Cup qualification,0,1,0,1,1,2,-1,0
Egypt,1982,Friendly,3,5,0,1,1,2,-2,0
Egypt,1983,African Cup of Nations qualification,3,2,2,1,1,4,1,0
Egypt,1983,Friendly,8,8,2,3,3,8,0,0
Egypt,1984,African Cup of Nations,6,6,2,1,2,5,0,0
Egypt,1984,FIFA World Cup qualification,2,1,1,0,1,2,1,0
Egypt,1984,Friendly,5,6,3,4,1,8,-1,0
Egypt,1985,FIFA World Cup qualification,1,3,1,2,1,4,-2,0
Egypt,1985,Friendly,10,10,5,4,1,10,0,0
Egypt,1986,African Cup of Nations,5,1,3,1,1,5,4,0
Egypt,1986,Friendly,2,7,0,2,1,3,-5,0
Egypt,1987,All-African Games,6,4,3,1,1,5,2,1
Egypt,1987,Friendly,2,0,1,0,0,1,2,0
Egypt,1987,Korea Cup,4,2,1,0,3,4,2,0
Egypt,1988,African Cup of Nations,3,1,1,1,1,3,2,0
Egypt,1988,Arab Cup,6,0,3,0,2,5,6,1
Egypt,1988,Friendly,10,9,3,1,5,9,1,0
Egypt,1989,African Cup of Nations qualification,8,2,2,1,1,4,6,0
Egypt,1989,FIFA World Cup qualification,7,2,4,1,3,8,5,0
Egypt,1989,Friendly,9,6,5,1,2,8,3,0
Egypt,1990,African Cup of Nations,1,6,0,3,0,3,-5,0
Egypt,1990,African Cup of Nations qualification,2,0,1,0,1,2,2,0
Egypt,1990,FIFA World Cup,1,2,0,1,2,3,-1,0
Egypt,1990,Friendly,9,16,3,5,4,12,-7,0
Egypt,1991,African Cup of Nations qualification,9,5,1,0,2,3,4,0
Egypt,1991,Friendly,12,7,3,2,3,8,5,0
Egypt,1991,Korea Cup,11,4,2,1,1,4,7,0
Egypt,1992,African Cup of Nations,0,2,0,2,0,2,-2,0
Egypt,1992,African Cup of Nations qualification,0,1,0,1,1,2,-1,0
Egypt,1992,Arab Cup,5,3,2,0,2,4,2,0
Egypt,1992,FIFA World Cup qualification,6,3,2,1,0,3,3,0
Egypt,1992,Friendly,7,6,2,1,4,7,1,0
Egypt,1993,African Cup of Nations qualification,6,4,2,1,1,4,2,0
Egypt,1993,FIFA World Cup qualification,3,0,1,0,2,3,3,0
Egypt,1993,Friendly,7,3,2,1,1,4,4,0
Egypt,1993,Korea Cup,3,1,2,0,0,2,2,1
Egypt,1994,African Cup of Nations,4,1,1,1,1,3,3,0
Egypt,1994,African Cup of Nations qualification,10,1,2,0,1,3,9,0
Egypt,1994,Friendly,5,8,2,3,1,6,-3,0
Egypt,1994,United Arab Emirates Friendship Tournament,3,1,2,0,1,3,2,1
Egypt,1995,African Cup of Nations qualification,14,4,4,1,2,7,10,0
Egypt,1995,Friendly,5,6,2,2,3,7,-1,0
Egypt,1995,Simba Tournament,5,5,1,1,1,3,0,1
Egypt,1996,African Cup of Nations,5,6,2,2,0,4,-1,0
Egypt,1996,FIFA World Cup qualification,7,1,1,0,0,1,6,0
Egypt,1996,Friendly,4,1,2,0,0,2,3,0
Egypt,1996,United Arab Emirates Friendship Tournament,1,3,0,1,2,3,-2,0
Egypt,1997,African Cup of Nations qualification,11,3,2,1,1,4,8,0
Egypt,1997,FIFA World Cup qualification,8,4,2,2,1,5,4,0
Egypt,1997,Friendly,16,10,4,3,0,7,6,0
Egypt,1997,Korea Cup,3,3,1,1,1,3,0,0
Egypt,1998,African Cup of Nations,10,1,4,1,1,6,9,1
Egypt,1998,Friendly,7,9,0,2,5,7,-2,0
Egypt,1998,King's Cup,2,4,0,1,2,3,-2,0
Egypt,1999,Confederations Cup,5,9,0,1,2,3,-4,0
Egypt,1999,Friendly,6,4,3,1,2,6,2,0
Egypt,1999,Korea Cup,2,4,0,1,2,3,-2,0
Egypt,1999,Lunar New Year Cup,3,4,1,1,0,2,-1,0
Egypt,2000,African Cup of Nations,7,3,3,1,0,4,4,0
Egypt,2000,African Cup of Nations qualification,2,0,2,0,0,2,2,0
Egypt,2000,FIFA World Cup qualification,6,2,2,0,1,3,4,0
Egypt,2000,Friendly,8,7,4,3,1,8,1,0
Egypt,2001,African Cup of Nations qualification,9,6,2,1,1,4,3,0
Egypt,2001,Cup of Ancient Civilizations,0,0,0,0,1,1,0,0
Egypt,2001,FIFA World Cup qualification,16,7,3,1,3,7,9,0
Egypt,2001,Friendly,16,11,4,2,3,9,5,0
Egypt,2002,African Cup of Nations,3,3,2,2,0,4,0,0
Egypt,2002,African Cup of Nations qualification,0,1,0,1,0,1,-1,0
Egypt,2002,Friendly,17,8,5,2,4,11,9,0
Egypt,2003,African Cup of Nations qualification,14,0,3,0,0,3,14,0
Egypt,2003,Friendly,11,10,4,2,0,6,1,0
Egypt,2003,Prime Minister's Cup,4,0,3,0,0,3,4,0
Egypt,2004,African Cup of Nations,3,3,1,1,1,3,0,0
Egypt,2004,FIFA World Cup qualification,11,9,2,2,1,5,2,0
Egypt,2004,Friendly,15,6,4,0,3,7,9,0
Egypt,2005,FIFA World Cup qualification,15,6,3,1,1,5,9,0
Egypt,2005,Friendly,17,6,7,2,1,10,11,0
Egypt,2006,African Cup of Nations,12,3,4,0,2,6,9,0
Egypt,2006,African Cup of Nations qualification,4,1,1,0,1,2,3,0
Egypt,2006,Friendly,4,6,2,3,0,5,-2,0
Egypt,2007,African Cup of Nations qualification,5,1,2,0,2,4,4,1
Egypt,2007,Friendly,4,5,1,1,2,4,-1,0
Egypt,2008,African Cup of Nations,15,5,5,0,1,6,10,1
Egypt,2008,FIFA World Cup qualification,13,2,5,1,0,6,11,0
Egypt,2008,Friendly,12,10,3,2,1,6,2,0
Egypt,2009,Confederations Cup,4,7,1,2,0,3,-3,0
Egypt,2009,FIFA World Cup qualification,9,5,4,2,1,7,4,0
Egypt,2009,Friendly,17,7,4,0,3,7,10,0
Egypt,2010,African Cup of Nations,15,2,6,0,0,6,13,1
Egypt,2010,African Cup of Nations qualification,1,2,0,1,1,2,-1,0
Egypt,2010,Friendly,12,8,3,2,0,5,4,0
Egypt,2011,African Cup of Nations qualification,4,3,1,2,1,4,1,0
Egypt,2011,Friendly,0,2,0,1,0,1,-2,0
Egypt,2011,Nile Basin Tournament,17,3,5,0,0,5,14,1
Egypt,2012,African Cup of Nations qualification,3,4,0,1,1,2,-1,0
Egypt,2012,FIFA World Cup qualification,5,2,2,0,0,2,3,0
Egypt,2012,Friendly,33,7,11,1,4,16,26,0
Egypt,2013,FIFA World Cup qualification,14,12,5,1,0,6,2,0
Egypt,2013,Friendly,22,13,4,4,1,9,9,0
Egypt,2014,African Cup of Nations qualification,5,6,2,4,0,6,-1,0
Egypt,2014,Friendly,5,2,2,0,1,3,3,0
Egypt,2015,African Cup of Nations qualification,3,0,1,0,0,1,3,0
Egypt,2015,FIFA World Cup qualification,4,1,1,1,0,2,3,0
Egypt,2015,Friendly,7,1,3,0,0,3,6,0
Egypt,2016,African Cup of Nations qualification,4,1,2,0,1,3,3,0
Egypt,2016,FIFA World Cup qualification,4,1,2,0,0,2,3,0
Egypt,2016,Friendly,5,3,2,2,1,5,2,0
Egypt,2017,African Cup of Nations,5,3,3,1,2,6,2,0
Egypt,2017,African Cup of Nations qualification,0,1,0,1,0,1,-1,0
Egypt,2017,FIFA World Cup qualification,4,3,2,1,1,4,1,0
Egypt,2017,Friendly,6,0,4,0,0,4,6,0
Egypt,2018,African Cup of Nations qualification,15,3,4,0,0,4,12,0
Egypt,2018,FIFA World Cup,2,6,0,3,0,3,-4,0
Egypt,2018,Friendly,2,7,0,3,2,5,-5,0
Egypt,2019,African Cup of Nations,5,1,3,1,0,4,4,0
Egypt,2019,African Cup of Nations qualification,2,2,0,0,3,3,0,0
Egypt,2019,Friendly,6,2,4,1,0,5,4,0
Egypt,2020,African Cup of Nations qualification,4,1,2,0,0,2,3,0
Egypt,2021,African Cup of Nations qualification,5,1,1,0,1,2,4,0
Egypt,2021,Arab Cup,10,3,3,1,2,6,7,0
Egypt,2021,FIFA World Cup qualification,10,4,4,0,2,6,6,0
Egypt,2021,Friendly,2,0,1,0,0,1,2,0
Egypt,2022,African Cup of Nations,4,2,3,1,3,7,2,0
Egypt,2022,African Cup of Nations qualification,1,2,1,1,0,2,-1,0
Egypt,2022,FIFA World Cup qualification,1,1,1,1,0,2,0,0
Egypt,2022,Friendly,9,5,3,1,0,4,4,0
Egypt,2023,African Cup of Nations qualification,9,1,4,0,0,4,8,0
Egypt,2023,FIFA World Cup qualification,8,0,2,0,0,2,8,0
Egypt,2023,Friendly,6,4,2,1,1,4,2,0
Egypt,2024,African Cup of Nations,7,7,0,0,4,4,0,0
Egypt,2024,African Cup of Nations qualification,10,0,4,0,0,4,10,0
Egypt,2024,FIFA Series,3,4,1,1,0,2,-1,0
Egypt,2024,FIFA World Cup qualification,3,2,1,0,1,2,1,0
Egypt,2024,Friendly,2,0,1,0,0,1,2,0
Egypt,2025,FIFA World Cup qualification,3,0,2,0,0,2,3,0
El Salvador,1921,Friendly,0,7,0,1,0,1,-7,0
El Salvador,1927,Friendly,0,1,0,1,1,2,-1,0
El Salvador,1928,Friendly,5,0,1,0,0,1,5,1
El Salvador,1929,Friendly,9,0,1,0,0,1,9,0
El Salvador,1930,Central American and Caribbean Games,13,25,1,4,0,5,-12,0
El Salvador,1935,Central American and Caribbean Games,15,20,2,3,0,5,-5,1
El Salvador,1937,Friendly,3,2,1,0,0,1,1,0
El Salvador,1938,Central American and Caribbean Games,7,19,2,3,0,5,-12,1
El Salvador,1941,CCCF Championship,15,8,2,1,1,4,7,0
El Salvador,1943,CCCF Championship,28,11,4,1,1,6,17,0
El Salvador,1946,CCCF Championship,15,11,3,2,0,5,4,0
El Salvador,1946,Friendly,5,6,0,1,1,2,-1,0
El Salvador,1948,CCCF Championship,6,17,2,5,1,8,-11,0
El Salvador,1949,Friendly,5,4,1,1,0,2,1,0
El Salvador,1950,Friendly,4,1,2,0,0,2,3,0
El Salvador,1953,CCCF Championship,10,14,2,3,1,6,-4,0
El Salvador,1955,CCCF Championship,8,13,3,3,0,6,-5,0
El Salvador,1955,Friendly,2,2,0,0,2,2,0,0
El Salvador,1959,Friendly,1,0,1,0,0,1,1,0
El Salvador,1961,CCCF Championship,0,0,0,0,1,1,0,0
El Salvador,1963,CONCACAF Championship,17,11,3,1,3,7,6,0
El Salvador,1963,Friendly,2,1,1,0,2,3,1,0
El Salvador,1965,CONCACAF Championship,7,9,2,2,1,5,-2,1
El Salvador,1965,CONCACAF Championship qualification,7,1,2,0,0,2,6,1
El Salvador,1966,Friendly,0,1,0,1,0,1,-1,0
El Salvador,1967,Friendly,6,5,2,2,0,4,1,0
El Salvador,1968,FIFA World Cup qualification,10,5,3,1,0,4,5,0
El Salvador,1968,Friendly,7,5,3,1,2,6,2,0
El Salvador,1969,FIFA World Cup qualification,9,7,4,2,0,6,2,0
El Salvador,1969,Friendly,3,5,1,1,0,2,-2,0
El Salvador,1970,FIFA World Cup,0,9,0,3,0,3,-9,0
El Salvador,1970,Friendly,0,7,0,3,0,3,-7,0
El Salvador,1971,CONCACAF Championship qualification,4,2,2,0,0,2,2,0
El Salvador,1971,Friendly,0,1,0,1,0,1,-1,0
El Salvador,1972,CONCACAF Championship qualification,0,2,0,2,0,2,-2,0
El Salvador,1972,Friendly,0,3,0,2,0,2,-3,0
El Salvador,1974,Friendly,0,1,0,1,0,1,-1,0
El Salvador,1976,CONCACAF Championship qualification,10,7,2,1,3,6,3,0
El Salvador,1976,Friendly,1,3,0,2,0,2,-2,0
El Salvador,1977,CONCACAF Championship,8,9,2,2,1,5,-1,0
El Salvador,1977,Friendly,1,2,0,1,1,2,-1,0
El Salvador,1978,Friendly,1,5,0,1,0,1,-4,0
El Salvador,1979,Friendly,1,3,0,1,1,2,-2,0
El Salvador,1980,CONCACAF Championship qualification,10,5,4,1,2,7,5,1
El Salvador,1980,Friendly,7,5,2,1,2,5,2,0
El Salvador,1981,CONCACAF Championship,2,1,2,1,2,5,1,0
El Salvador,1981,Friendly,4,0,1,0,2,3,4,0
El Salvador,1982,FIFA World Cup,1,13,0,3,0,3,-12,0
El Salvador,1982,Friendly,4,3,1,0,1,2,1,0
El Salvador,1983,Friendly,0,5,0,1,1,2,-5,0
El Salvador,1984,CONCACAF Championship qualification,8,0,2,0,0,2,8,0
El Salvador,1984,Friendly,8,9,3,3,1,7,-1,0
El Salvador,1985,CONCACAF Championship,7,2,2,1,1,4,5,0
El Salvador,1985,Friendly,2,2,1,1,0,2,0,0
El Salvador,1987,Friendly,5,9,2,4,0,6,-4,0
El Salvador,1988,CONCACAF Championship qualification,6,0,2,0,0,2,6,0
El Salvador,1988,Friendly,1,8,1,1,4,6,-7,0
El Salvador,1988,Marlboro Cup,1,2,0,1,0,1,-1,0
El Salvador,1989,CONCACAF Championship,2,8,0,4,2,6,-6,0
El Salvador,1989,Friendly,2,9,0,4,1,5,-7,0
El Salvador,1991,Friendly,1,1,0,0,1,1,0,0
El Salvador,1991,UNCAF Cup,5,11,1,2,1,4,-6,0
El Salvador,1992,FIFA World Cup qualification,22,7,6,1,1,8,15,0
El Salvador,1992,Friendly,9,16,2,5,3,10,-7,0
El Salvador,1993,FIFA World Cup qualification,6,11,2,4,0,6,-5,0
El Salvador,1993,Friendly,5,13,0,2,2,4,-8,0
El Salvador,1993,UNCAF Cup,1,5,0,2,1,3,-4,0
El Salvador,1994,Friendly,0,4,0,1,0,1,-4,0
El Salvador,1994,Miami Cup,3,4,1,1,0,2,-1,0
El Salvador,1995,Friendly,1,4,0,1,0,1,-3,0
El Salvador,1995,UNCAF Cup,7,3,3,1,0,4,4,0
El Salvador,1996,FIFA World Cup qualification,12,6,3,2,1,6,6,0
El Salvador,1996,Friendly,8,14,1,5,2,8,-6,0
El Salvador,1996,Gold Cup,3,4,1,1,0,2,-1,0
El Salvador,1997,FIFA World Cup qualification,11,16,2,4,4,10,-5,0
El Salvador,1997,Friendly,3,6,0,2,3,5,-3,0
El Salvador,1997,UNCAF Cup,2,5,1,3,1,5,-3,0
El Salvador,1998,Friendly,3,4,1,2,0,3,-1,0
El Salvador,1998,Gold Cup,0,6,0,2,1,3,-6,0
El Salvador,1999,Friendly,3,9,1,3,0,4,-6,0
El Salvador,1999,Gold Cup qualification,3,6,0,2,1,3,-3,0
El Salvador,1999,UNCAF Cup,3,9,1,3,1,5,-6,0
El Salvador,2000,FIFA World Cup qualification,23,15,6,3,1,10,8,0
El Salvador,2000,Friendly,9,17,2,5,0,7,-8,0
El Salvador,2001,Friendly,2,7,0,3,2,5,-5,0
El Salvador,2001,UNCAF Cup,8,4,2,0,4,6,4,0
El Salvador,2002,Friendly,0,2,0,1,0,1,-2,0
El Salvador,2002,Gold Cup,1,5,1,2,0,3,-4,0
El Salvador,2003,Friendly,4,8,1,3,3,7,-4,0
El Salvador,2003,Gold Cup,3,7,1,2,0,3,-4,0
El Salvador,2003,UNCAF Cup,6,4,3,2,0,5,2,0
El Salvador,2004,FIFA World Cup qualification,6,14,2,4,2,8,-8,0
El Salvador,2004,Friendly,4,16,0,5,2,7,-12,0
El Salvador,2005,Friendly,0,3,0,1,0,1,-3,0
El Salvador,2005,UNCAF Cup,1,3,0,2,0,2,-2,0
El Salvador,2006,Friendly,1,8,0,3,1,4,-7,0
El Salvador,2007,Friendly,5,15,1,5,2,8,-10,0
El Salvador,2007,Gold Cup,2,6,1,2,0,3,-4,0
El Salvador,2007,UNCAF Cup,4,5,2,2,1,5,-1,0
El Salvador,2008,FIFA World Cup qualification,30,6,6,3,1,10,24,0
El Salvador,2008,Friendly,6,7,2,3,6,11,-1,0
El Salvador,2009,FIFA World Cup qualification,9,15,2,6,2,10,-6,0
El Salvador,2009,Friendly,5,3,2,1,1,4,2,0
El Salvador,2009,Gold Cup,2,3,1,2,0,3,-1,0
El Salvador,2009,UNCAF Cup,5,8,1,3,1,5,-3,0
El Salvador,2010,Friendly,5,11,0,5,1,6,-6,0
El Salvador,2011,FIFA World Cup qualification,20,5,6,0,0,6,15,0
El Salvador,2011,Friendly,8,6,3,1,1,5,2,0
El Salvador,2011,Gold Cup,8,8,1,1,2,4,0,0
El Salvador,2011,UNCAF Cup,7,6,2,2,1,5,1,0
El Salvador,2012,FIFA World Cup qualification,8,11,1,3,2,6,-3,0
El Salvador,2012,Friendly,5,9,2,3,1,6,-4,0
El Salvador,2013,Friendly,1,7,0,2,0,2,-6,0
El Salvador,2013,Gold Cup,4,8,1,2,1,4,-4,0
El Salvador,2013,UNCAF Cup,2,2,1,1,2,4,0,0
El Salvador,2014,Friendly,5,4,2,2,0,4,1,0
El Salvador,2015,FIFA World Cup qualification,8,6,3,1,1,5,2,0
El Salvador,2015,Friendly,1,5,0,2,1,3,-4,0
El Salvador,2015,Gold Cup,1,2,0,1,2,3,-1,0
El Salvador,2016,FIFA World Cup qualification,4,10,0,3,1,4,-6,0
El Salvador,2016,Friendly,1,7,0,2,0,2,-6,0
El Salvador,2017,Friendly,4,6,1,1,2,4,-2,0
El Salvador,2017,Gold Cup,4,6,1,2,1,4,-2,0
El Salvador,2017,UNCAF Cup,5,3,2,1,0,3,2,0
El Salvador,2018,CONCACAF Nations League qualification,5,2,2,1,0,3,3,0
El Salvador,2018,Friendly,2,5,2,1,0,3,-3,0
El Salvador,2019,CONCACAF Nations League,10,1,5,1,0,6,9,0
El Salvador,2019,CONCACAF Nations League qualification,2,0,1,0,0,1,2,0
El Salvador,2019,Friendly,6,1,3,0,0,3,5,0
El Salvador,2019,Gold Cup,1,4,1,1,1,3,-3,0
El Salvador,2019,Kirin Challenge Cup,0,2,0,1,0,1,-2,0
El Salvador,2020,Friendly,0,7,0,2,0,2,-7,0
El Salvador,2021,FIFA World Cup qualification,23,11,6,4,4,14,12,0
El Salvador,2021,Friendly,1,6,0,4,3,7,-5,0
El Salvador,2021,Gold Cup,6,4,2,2,0,4,2,0
El Salvador,2022,CONCACAF Nations League,6,4,1,0,2,3,2,0
El Salvador,2022,FIFA World Cup qualification,4,8,1,4,1,6,-4,0
El Salvador,2022,Friendly,1,9,0,3,0,3,-8,0
El Salvador,2023,CONCACAF Nations League,2,7,0,4,1,5,-5,0
El Salvador,2023,Friendly,3,10,0,2,3,5,-7,0
El Salvador,2023,Gold Cup,3,4,0,1,2,3,-1,0
El Salvador,2024,CONCACAF Nations League,12,6,5,1,0,6,6,0
El Salvador,2024,FIFA World Cup qualification,3,1,1,0,1,2,2,0
El Salvador,2024,Friendly,3,8,1,3,2,6,-5,0
Elba Island,2022,Friendly,5,0,1,0,0,1,5,0
Ellan Vannin,2014,CONIFA World Football Cup,12,6,3,0,2,5,6,0
Ellan Vannin,2014,Friendly,11,5,1,1,0,2,6,0
Ellan Vannin,2015,CONIFA European Football Cup,5,6,1,2,1,4,-1,0
Ellan Vannin,2015,Niamh Challenge Cup,11,2,2,0,0,2,9,1
Ellan Vannin,2017,CONIFA European Football Cup,6,8,1,2,1,4,-2,0
Ellan Vannin,2018,CONIFA World Football Cup,6,3,2,1,0,3,3,0
Ellan Vannin,2018,Friendly,3,2,1,0,1,2,1,0
England,1872,Friendly,0,0,0,0,1,1,0,0
England,1873,Friendly,4,2,1,0,0,1,2,1
England,1874,Friendly,1,2,0,1,0,1,-1,0
England,1875,Friendly,2,2,0,0,1,1,0,0
England,1876,Friendly,0,3,0,1,0,1,-3,0
England,1877,Friendly,1,3,0,1,0,1,-2,0
England,1878,Friendly,2,7,0,1,0,1,-5,0
England,1879,Friendly,7,5,2,0,0,2,2,0
England,1880,Friendly,7,7,1,1,0,2,0,0
England,1881,Friendly,1,7,0,2,0,2,-6,0
England,1882,Friendly,17,10,1,2,0,3,7,0
England,1883,Friendly,14,3,2,1,0,3,11,0
England,1884,British Home Championship,12,2,2,1,0,3,10,0
England,1885,British Home Championship,6,2,1,0,2,3,4,0
England,1886,British Home Championship,10,3,2,0,1,3,7,0
England,1887,British Home Championship,13,3,2,1,0,3,10,0
England,1888,British Home Championship,15,2,3,0,0,3,13,1
England,1889,British Home Championship,12,5,2,1,0,3,7,0
England,1890,British Home Championship,13,3,2,0,1,3,10,0
England,1891,British Home Championship,12,3,3,0,0,3,9,1
England,1892,British Home Championship,8,1,3,0,0,3,7,1
England,1893,British Home Championship,17,3,3,0,0,3,14,1
England,1894,British Home Championship,9,5,1,0,2,3,4,0
England,1895,British Home Championship,13,1,2,0,1,3,12,1
England,1896,British Home Championship,12,3,2,1,0,3,9,0
England,1897,British Home Championship,11,2,2,1,0,3,9,0
England,1898,British Home Championship,9,3,3,0,0,3,6,1
England,1899,British Home Championship,19,3,3,0,0,3,16,1
England,1900,British Home Championship,4,5,1,1,1,3,-1,0
England,1901,British Home Championship,11,2,2,0,1,3,9,0
England,1902,British Home Championship,3,2,1,0,2,3,1,0
England,1903,British Home Championship,7,3,2,1,0,3,4,0
England,1904,British Home Championship,6,3,2,0,1,3,3,1
England,1905,British Home Championship,5,2,2,0,1,3,3,0
England,1906,British Home Championship,7,2,2,1,0,3,5,0
England,1907,British Home Championship,3,2,1,0,2,3,1,0
England,1908,British Home Championship,11,3,2,0,1,3,8,0
England,1908,Friendly,28,2,4,0,0,4,26,0
England,1909,British Home Championship,8,0,3,0,0,3,8,1
England,1909,Friendly,20,5,3,0,0,3,15,0
England,1910,British Home Championship,2,3,1,1,1,3,-1,0
England,1911,British Home Championship,6,2,2,0,1,3,4,0
England,1912,British Home Championship,9,2,2,0,1,3,7,0
England,1913,British Home Championship,6,5,2,1,0,3,1,1
England,1914,British Home Championship,3,6,1,2,0,3,-3,0
England,1919,British Home Championship,1,1,0,0,1,1,0,0
England,1920,British Home Championship,8,6,2,1,0,3,2,1
England,1921,British Home Championship,1,4,0,1,2,3,-3,0
England,1921,Friendly,2,0,1,0,0,1,2,0
England,1922,British Home Championship,3,1,2,1,0,3,2,1
England,1923,British Home Championship,5,6,0,1,2,3,-1,0
England,1923,Friendly,19,7,4,0,1,5,12,0
England,1924,British Home Championship,5,4,1,1,1,3,1,1
England,1924,Friendly,7,1,2,0,0,2,6,0
England,1925,British Home Championship,2,3,1,1,1,3,-1,0
England,1925,Friendly,3,2,1,0,0,1,1,0
England,1926,British Home Championship,4,7,0,2,1,3,-3,0
England,1926,Friendly,5,3,1,0,0,1,2,0
England,1927,British Home Championship,6,8,1,2,1,4,-2,0
England,1927,Friendly,20,3,3,0,0,3,17,0
England,1928,British Home Championship,6,8,2,1,0,3,-2,1
England,1928,Friendly,8,2,2,0,0,2,6,0
England,1929,British Home Championship,9,1,2,1,0,3,8,1
England,1929,Friendly,12,6,2,1,0,3,6,0
England,1930,British Home Championship,14,3,3,0,0,3,11,1
England,1930,Friendly,3,3,0,0,2,2,0,0
England,1931,British Home Championship,9,5,2,1,0,3,4,0
England,1931,Friendly,13,7,2,1,0,3,6,0
England,1932,British Home Championship,4,0,2,0,1,3,4,0
England,1932,Friendly,4,3,1,0,0,1,1,0
England,1933,British Home Championship,5,4,1,2,0,3,1,0
England,1933,Friendly,9,2,2,0,1,3,7,0
England,1934,British Home Championship,7,0,2,0,0,2,7,0
England,1934,Friendly,5,6,1,2,0,3,-1,0
England,1935,British Home Championship,5,4,2,1,0,3,1,0
England,1935,Friendly,4,0,2,0,0,2,4,0
England,1936,British Home Championship,6,6,1,2,1,4,0,0
England,1936,Friendly,9,7,1,2,0,3,2,0
England,1937,British Home Championship,8,5,2,1,0,3,3,1
England,1937,Friendly,23,4,4,0,0,4,19,0
England,1938,British Home Championship,9,5,1,2,0,3,4,1
England,1938,Friendly,15,7,3,1,0,4,8,0
England,1939,British Home Championship,2,1,1,0,0,1,1,1
England,1939,Friendly,5,4,1,1,1,3,1,0
England,1945,Friendly,4,6,1,2,1,4,-2,0
England,1946,British Home Championship,10,2,2,0,0,2,8,0
England,1946,Friendly,18,8,4,2,1,7,10,0
England,1947,British Home Championship,6,3,1,0,2,3,3,0
England,1947,Friendly,22,5,4,1,0,5,17,0
England,1948,British Home Championship,9,2,3,0,0,3,7,0
England,1948,Friendly,10,0,2,0,1,3,10,0
England,1949,British Home Championship,1,3,0,1,0,1,-2,0
England,1949,FIFA World Cup qualification,13,3,2,0,0,2,10,0
England,1949,Friendly,10,7,3,2,0,5,3,0
England,1950,British Home Championship,8,3,2,0,0,2,5,1
England,1950,FIFA World Cup,2,2,1,2,0,3,0,0
England,1950,FIFA World Cup qualification,1,0,1,0,0,1,1,1
England,1950,Friendly,11,6,2,0,1,3,5,0
England,1951,British Home Championship,5,4,1,1,1,3,1,1
England,1951,Friendly,11,7,2,0,2,4,4,0
England,1952,British Home Championship,9,5,2,0,1,3,4,1
England,1952,Friendly,12,3,3,0,1,4,9,0
England,1953,British Home Championship,9,4,2,0,1,3,5,1
England,1953,Friendly,13,15,2,3,1,6,-2,0
England,1954,British Home Championship,9,4,3,0,0,3,5,1
England,1954,FIFA World Cup,8,8,1,1,1,3,0,0
England,1954,Friendly,4,9,1,2,0,3,-5,0
England,1955,British Home Championship,11,4,2,1,0,3,7,0
England,1955,Friendly,11,7,2,2,1,5,4,0
England,1956,British Home Championship,5,3,1,0,2,3,2,1
England,1956,FIFA World Cup qualification,5,2,1,0,0,1,3,1
England,1956,Friendly,15,4,4,0,1,5,11,0
England,1957,British Home Championship,8,4,2,1,0,3,4,0
England,1957,FIFA World Cup qualification,10,3,2,0,1,3,7,0
England,1957,Friendly,4,0,1,0,0,1,4,0
England,1958,British Home Championship,9,5,1,0,2,3,4,0
England,1958,FIFA World Cup,4,5,0,1,3,4,-1,0
England,1958,Friendly,8,7,2,1,1,4,1,0
England,1959,British Home Championship,4,2,2,0,1,3,2,1
England,1959,Friendly,14,14,1,4,1,6,0,0
England,1960,British Home Championship,11,4,2,0,1,3,7,1
England,1960,FIFA World Cup qualification,9,0,1,0,0,1,9,0
England,1960,Friendly,7,10,1,2,1,4,-3,0
England,1961,British Home Championship,11,5,1,0,2,3,6,0
England,1961,FIFA World Cup qualification,7,2,2,0,1,3,5,0
England,1961,Friendly,12,5,2,1,0,3,7,0
England,1962,British Home Championship,7,3,2,1,0,3,4,1
England,1962,FIFA World Cup,5,6,1,2,1,4,-1,0
England,1962,Friendly,10,2,3,0,0,3,8,0
England,1962,UEFA Euro qualification,1,1,0,0,1,1,0,0
England,1963,British Home Championship,13,5,2,1,0,3,8,0
England,1963,Friendly,15,5,3,0,1,4,10,0
England,1963,UEFA Euro qualification,2,5,0,1,0,1,-3,0
England,1964,British Home Championship,6,5,2,1,0,3,1,0
England,1964,Friendly,24,15,4,2,3,9,9,0
England,1965,British Home Championship,4,3,1,0,2,3,1,0
England,1965,Friendly,9,5,4,1,1,6,4,0
England,1966,British Home Championship,11,4,3,0,0,3,7,0
England,1966,FIFA World Cup,11,3,5,0,1,6,8,1
England,1966,Friendly,16,2,6,0,2,8,14,0
England,1967,British Home Championship,7,3,2,1,0,3,4,0
England,1967,Friendly,5,2,2,0,1,3,3,0
England,1968,British Home Championship,1,1,0,0,1,1,0,0
England,1968,Friendly,4,3,1,1,2,4,1,0
England,1968,UEFA Euro,2,1,1,1,0,2,1,0
England,1968,UEFA Euro qualification,3,1,2,0,0,2,2,0
England,1969,British Home Championship,9,3,3,0,0,3,6,0
England,1969,Friendly,15,4,5,1,2,8,11,0
England,1970,British Home Championship,4,2,1,0,2,3,2,0
England,1970,FIFA World Cup,4,4,2,2,0,4,0,0
England,1970,Friendly,12,2,4,0,1,5,10,0
England,1971,British Home Championship,4,1,2,0,1,3,3,0
England,1971,UEFA Euro qualification,15,3,5,0,1,6,12,0
England,1972,British Home Championship,4,1,2,1,0,3,3,1
England,1972,FIFA World Cup qualification,1,0,1,0,0,1,1,0
England,1972,Friendly,1,1,0,0,1,1,0,0
England,1972,UEFA Euro qualification,1,3,0,1,1,2,-2,0
England,1973,British Home Championship,6,1,3,0,0,3,5,1
England,1973,FIFA World Cup qualification,2,4,0,1,2,3,-2,0
England,1973,Friendly,15,5,3,2,1,6,10,0
England,1974,British Home Championship,3,2,2,1,0,3,1,0
England,1974,Friendly,6,5,1,0,4,5,1,0
England,1974,UEFA Euro qualification,3,0,1,0,1,2,3,0
England,1975,British Home Championship,7,3,1,0,2,3,4,1
England,1975,Friendly,4,1,2,0,0,2,3,0
England,1975,UEFA Euro qualification,8,3,2,1,1,4,5,0
England,1976,British Home Championship,6,2,2,1,0,3,4,0
England,1976,FIFA World Cup qualification,6,4,2,1,0,3,2,0
England,1976,Friendly,6,5,2,1,1,4,1,0
England,1977,British Home Championship,3,4,1,2,0,3,-1,0
England,1977,FIFA World Cup qualification,9,0,3,0,0,3,9,0
England,1977,Friendly,1,3,0,1,4,5,-2,0
England,1978,British Home Championship,5,1,3,0,0,3,4,1
England,1978,Friendly,7,4,2,1,1,4,3,0
England,1978,UEFA Euro qualification,5,4,1,0,1,2,1,0
England,1979,British Home Championship,5,1,2,0,1,3,4,0
England,1979,Friendly,3,4,0,1,1,2,-1,0
England,1979,UEFA Euro qualification,15,1,5,0,0,5,14,0
England,1980,British Home Championship,4,5,1,1,1,3,-1,1
England,1980,FIFA World Cup qualification,7,3,2,1,0,3,4,0
England,1980,Friendly,7,2,3,0,0,3,5,0
England,1980,UEFA Euro,3,3,1,1,1,3,0,0
England,1980,UEFA Euro qualification,2,0,1,0,0,1,2,0
England,1981,British Home Championship,0,1,0,1,1,2,-1,0
England,1981,FIFA World Cup qualification,6,5,2,2,1,5,1,0
England,1981,Friendly,1,3,0,2,0,2,-2,0
England,1982,British Home Championship,6,0,3,0,0,3,6,1
England,1982,FIFA World Cup,6,1,3,0,2,5,5,0
England,1982,Friendly,8,4,2,1,1,4,4,0
England,1982,UEFA Euro qualification,14,2,2,0,1,3,12,0
England,1983,British Home Championship,4,1,2,0,1,3,3,0
England,1983,Friendly,2,1,1,0,2,3,1,0
England,1983,UEFA Euro qualification,9,1,3,1,1,5,8,0
England,1984,British Home Championship,2,2,1,1,1,3,0,0
England,1984,FIFA World Cup qualification,13,0,2,0,0,2,13,0
England,1984,Friendly,3,6,2,3,1,6,-3,0
England,1985,FIFA World Cup qualification,8,2,2,0,4,6,6,0
England,1985,Friendly,11,4,3,2,0,5,7,0
England,1985,Rous Cup,0,1,0,1,0,1,-1,0
England,1986,FIFA World Cup,7,3,2,2,1,5,4,0
England,1986,Friendly,11,2,5,1,0,6,9,0
England,1986,Rous Cup,2,1,1,0,0,1,1,1
England,1986,UEFA Euro qualification,5,0,2,0,0,2,5,0
England,1987,Friendly,5,5,1,1,0,2,0,0
England,1987,Rous Cup,1,1,0,0,2,2,0,0
England,1987,UEFA Euro qualification,14,1,3,0,1,4,13,0
England,1988,FIFA World Cup qualification,0,0,0,0,1,1,0,0
England,1988,Friendly,5,3,2,0,4,6,2,0
England,1988,Rous Cup,2,1,1,0,1,2,1,0
England,1988,UEFA Euro,2,7,0,3,0,3,-5,0
England,1989,FIFA World Cup qualification,10,0,3,0,2,5,10,0
England,1989,Friendly,5,3,2,0,2,4,2,0
England,1989,Rous Cup,2,0,1,0,1,2,2,0
England,1990,FIFA World Cup,8,6,3,1,3,7,2,0
England,1990,Friendly,9,5,4,1,1,6,4,0
England,1990,UEFA Euro qualification,3,1,1,0,1,2,2,0
England,1991,Friendly,15,6,6,1,1,8,9,0
England,1991,UEFA Euro qualification,4,2,2,0,2,4,2,0
England,1992,FIFA World Cup qualification,5,1,1,0,1,2,4,0
England,1992,Friendly,10,7,3,1,3,7,3,0
England,1992,UEFA Euro,1,2,0,1,2,3,-1,0
England,1993,FIFA World Cup qualification,21,8,4,2,2,8,13,0
England,1993,USA Cup,2,5,0,2,1,3,-3,0
England,1994,Friendly,10,1,4,0,2,6,9,0
England,1995,Friendly,10,10,2,2,5,9,0,0
England,1996,FIFA World Cup qualification,7,1,3,0,0,3,6,0
England,1996,Friendly,7,0,3,0,1,4,7,0
England,1996,UEFA Euro,8,3,2,0,3,5,5,0
England,1997,FIFA World Cup qualification,8,1,3,1,1,5,7,0
England,1997,Friendly,6,1,3,0,0,3,5,0
England,1997,Tournoi de France,3,1,2,1,0,3,2,0
England,1998,FIFA World Cup,7,4,2,1,1,4,3,0
England,1998,Friendly,6,3,2,1,2,5,3,0
England,1998,King Hassan II Tournament,1,0,1,0,1,2,1,0
England,1998,UEFA Euro qualification,4,2,1,1,1,3,2,0
England,1999,Friendly,3,4,1,1,1,3,-1,0
England,1999,UEFA Euro qualification,12,3,3,1,3,7,9,0
England,2000,FIFA World Cup qualification,0,1,0,1,1,2,-1,0
England,2000,Friendly,6,4,2,1,3,6,2,0
England,2000,UEFA Euro,5,6,1,2,0,3,-1,0
England,2001,FIFA World Cup qualification,16,5,5,0,1,6,11,0
England,2001,Friendly,8,3,2,1,1,4,5,0
England,2002,FIFA World Cup,6,3,2,1,2,5,3,0
England,2002,Friendly,10,7,1,1,4,6,3,0
England,2002,UEFA Euro qualification,4,3,1,0,1,2,1,0
England,2003,Friendly,10,9,3,2,0,5,1,0
England,2003,UEFA Euro qualification,10,2,5,0,1,6,8,0
England,2004,FIFA World Cup qualification,7,3,3,0,1,4,4,0
England,2004,Friendly,11,5,2,2,2,6,6,0
England,2004,UEFA Euro,10,6,2,1,1,4,4,0
England,2005,FIFA World Cup qualification,10,2,5,1,0,6,8,0
England,2005,Friendly,9,9,3,1,1,5,0,0
England,2006,FIFA World Cup,6,2,3,0,2,5,4,0
England,2006,Friendly,16,3,4,0,1,5,13,0
England,2006,UEFA Euro qualification,6,2,2,1,1,4,4,0
England,2007,Friendly,3,4,1,2,1,4,-1,0
England,2007,UEFA Euro qualification,18,5,5,2,1,8,13,0
England,2008,FIFA World Cup qualification,14,3,4,0,0,4,11,0
England,2008,Friendly,11,5,4,1,1,6,6,0
England,2009,FIFA World Cup qualification,20,3,5,1,0,6,17,0
England,2009,Friendly,8,6,2,2,1,5,2,0
England,2010,FIFA World Cup,3,5,1,1,2,4,-2,0
England,2010,Friendly,11,6,4,1,0,5,5,0
England,2010,UEFA Euro qualification,7,1,2,0,1,3,6,0
England,2011,Friendly,5,2,3,0,1,4,3,0
England,2011,UEFA Euro qualification,10,4,3,0,2,5,6,0
England,2012,FIFA World Cup qualification,12,2,2,0,2,4,10,0
England,2012,Friendly,8,8,3,2,0,5,0,0
England,2012,UEFA Euro,5,3,2,0,2,4,2,0
England,2013,FIFA World Cup qualification,19,2,4,0,2,6,17,0
England,2013,Friendly,8,9,2,2,2,6,-1,0
England,2014,FIFA World Cup,2,4,0,2,1,3,-2,0
England,2014,Friendly,10,3,4,0,2,6,7,0
England,2014,UEFA Euro qualification,11,1,4,0,0,4,10,0
England,2015,Friendly,3,3,1,1,2,4,0,0
England,2015,UEFA Euro qualification,20,2,6,0,0,6,18,0
England,2016,FIFA World Cup qualification,6,0,3,0,1,4,6,0
England,2016,Friendly,11,8,4,1,1,6,3,0
England,2016,UEFA Euro,4,4,1,1,2,4,0,0
England,2017,FIFA World Cup qualification,12,3,5,0,1,6,9,0
England,2017,Friendly,2,4,0,2,2,4,-2,0
England,2018,FIFA World Cup,12,8,3,3,1,7,4,0
England,2018,Friendly,10,2,5,0,1,6,8,0
England,2018,UEFA Nations League,6,5,2,1,1,4,1,0
England,2019,UEFA Euro qualification,37,6,7,1,0,8,31,0
England,2019,UEFA Nations League,1,3,0,1,1,2,-2,0
England,2020,Friendly,6,0,2,0,0,2,6,0
England,2020,UEFA Nations League,7,4,3,2,1,6,3,0
England,2021,FIFA World Cup qualification,39,3,8,0,2,10,36,0
England,2021,Friendly,2,0,2,0,0,2,2,0
England,2021,UEFA Euro,11,2,5,0,2,7,9,0
England,2022,FIFA World Cup,13,4,3,1,1,5,9,0
England,2022,Friendly,5,1,2,0,0,2,4,0
England,2022,UEFA Nations League,4,10,0,3,3,6,-6,0
England,2023,Friendly,4,1,2,0,0,2,3,0
England,2023,UEFA Euro qualification,22,4,6,0,2,8,18,0
England,2024,Friendly,5,4,1,2,1,4,1,0
England,2024,UEFA Euro,8,6,3,1,3,7,2,0
England,2024,UEFA Nations League,16,3,5,1,0,6,13,0
England,2025,FIFA World Cup qualification,5,0,2,0,0,2,5,0
Equatorial Guinea,1975,Friendly,2,6,0,1,0,1,-4,0
Equatorial Guinea,1981,Friendly,1,1,0,0,1,1,0,0
Equatorial Guinea,1984,UDEAC Cup,2,7,0,1,2,3,-5,0
Equatorial Guinea,1985,UDEAC Cup,1,3,0,1,1,2,-2,0
Equatorial Guinea,1986,UDEAC Cup,0,3,0,2,0,2,-3,0
Equatorial Guinea,1987,UDEAC Cup,0,5,0,2,2,4,-5,0
Equatorial Guinea,1988,African Cup of Nations qualification,1,0,1,0,1,2,1,0
Equatorial Guinea,1988,UDEAC Cup,1,5,0,2,0,2,-4,0
Equatorial Guinea,1990,UDEAC Cup,3,10,0,2,1,3,-7,0
Equatorial Guinea,1998,African Cup of Nations qualification,0,5,0,2,0,2,-5,0
Equatorial Guinea,1999,UNIFFAC Cup,5,11,1,4,0,5,-6,0
Equatorial Guinea,2000,African Cup of Nations qualification,1,5,0,2,0,2,-4,0
Equatorial Guinea,2000,FIFA World Cup qualification,2,5,0,2,0,2,-3,0
Equatorial Guinea,2002,African Cup of Nations qualification,1,8,0,2,0,2,-7,0
Equatorial Guinea,2003,African Cup of Nations qualification,2,8,1,3,0,4,-6,0
Equatorial Guinea,2003,FIFA World Cup qualification,1,2,1,1,0,2,-1,0
Equatorial Guinea,2003,Friendly,4,3,1,1,0,2,1,0
Equatorial Guinea,2006,African Cup of Nations qualification,2,4,1,1,0,2,-2,0
Equatorial Guinea,2006,Friendly,2,0,1,0,0,1,2,0
Equatorial Guinea,2007,African Cup of Nations qualification,4,3,2,1,1,4,1,0
Equatorial Guinea,2007,Friendly,1,1,0,0,1,1,0,0
Equatorial Guinea,2008,FIFA World Cup qualification,4,10,1,5,0,6,-6,0
Equatorial Guinea,2009,Friendly,0,8,0,2,0,2,-8,0
Equatorial Guinea,2010,Friendly,1,4,0,2,0,2,-3,0
Equatorial Guinea,2011,FIFA World Cup qualification,3,2,1,1,0,2,1,0
Equatorial Guinea,2011,Friendly,7,8,3,3,1,7,-1,0
Equatorial Guinea,2012,African Cup of Nations,3,5,2,2,0,4,-2,0
Equatorial Guinea,2012,African Cup of Nations qualification,2,5,1,1,0,2,-3,0
Equatorial Guinea,2012,FIFA World Cup qualification,3,5,0,1,1,2,-2,0
Equatorial Guinea,2012,Friendly,1,0,1,0,1,2,1,0
Equatorial Guinea,2013,FIFA World Cup qualification,3,10,0,3,1,4,-7,0
Equatorial Guinea,2013,Friendly,2,3,0,1,1,2,-1,0
Equatorial Guinea,2014,African Cup of Nations qualification,3,1,1,1,0,2,2,0
Equatorial Guinea,2015,African Cup of Nations,5,5,2,1,3,6,0,0
Equatorial Guinea,2015,African Cup of Nations qualification,1,2,0,1,1,2,-1,0
Equatorial Guinea,2015,FIFA World Cup qualification,1,2,1,1,0,2,-1,0
Equatorial Guinea,2015,Friendly,2,5,1,2,1,4,-3,0
Equatorial Guinea,2016,African Cup of Nations qualification,5,4,1,3,0,4,1,0
Equatorial Guinea,2016,Friendly,1,1,0,0,1,1,0,0
Equatorial Guinea,2017,African Cup of Nations qualification,0,3,0,1,0,1,-3,0
Equatorial Guinea,2017,Friendly,4,3,1,1,0,2,1,0
Equatorial Guinea,2018,African Cup of Nations qualification,1,3,1,3,0,4,-2,0
Equatorial Guinea,2018,Friendly,0,1,0,1,0,1,-1,0
Equatorial Guinea,2019,African Cup of Nations qualification,5,4,1,2,0,3,1,0
Equatorial Guinea,2019,FIFA World Cup qualification,2,1,1,0,1,2,1,0
Equatorial Guinea,2019,Friendly,4,5,0,1,2,3,-1,0
Equatorial Guinea,2020,African Cup of Nations qualification,4,2,2,0,0,2,2,0
Equatorial Guinea,2021,African Cup of Nations qualification,2,2,1,1,0,2,0,0
Equatorial Guinea,2021,FIFA World Cup qualification,6,5,3,1,2,6,1,0
Equatorial Guinea,2022,African Cup of Nations,3,4,2,2,1,5,-1,0
Equatorial Guinea,2022,African Cup of Nations qualification,2,4,1,1,0,2,-2,0
Equatorial Guinea,2022,Friendly,2,5,0,1,3,4,-3,0
Equatorial Guinea,2023,African Cup of Nations qualification,7,3,3,0,1,4,4,0
Equatorial Guinea,2023,FIFA World Cup qualification,2,0,2,0,0,2,2,0
Equatorial Guinea,2023,Friendly,0,0,0,0,1,1,0,0
Equatorial Guinea,2024,African Cup of Nations,9,4,2,1,1,4,5,0
Equatorial Guinea,2024,African Cup of Nations qualification,5,5,2,1,1,4,0,0
Equatorial Guinea,2024,FIFA Series,2,1,1,1,0,2,1,0
Equatorial Guinea,2024,FIFA World Cup qualification,1,1,1,1,0,2,0,0
Equatorial Guinea,2024,Friendly,1,1,0,0,1,1,0,0
Equatorial Guinea,2025,FIFA World Cup qualification,3,1,1,0,1,2,2,0
Eritrea,1992,Friendly,2,1,1,0,1,2,1,0
Eritrea,1994,CECAFA Cup,0,2,0,2,1,3,-2,0
Eritrea,1998,African Cup of Nations qualification,1,3,0,1,0,1,-2,0
Eritrea,1999,African Cup of Nations qualification,3,11,1,3,1,5,-8,0
Eritrea,1999,CECAFA Cup,0,1,0,1,0,1,-1,0
Eritrea,2000,African Cup of Nations qualification,3,6,1,1,0,2,-3,0
Eritrea,2000,CECAFA Cup,1,1,0,0,1,1,0,0
Eritrea,2000,FIFA World Cup qualification,0,4,0,1,1,2,-4,0
Eritrea,2000,Friendly,0,1,0,1,0,1,-1,0
Eritrea,2001,CECAFA Cup,1,4,0,3,1,4,-3,0
Eritrea,2002,African Cup of Nations qualification,0,2,0,2,0,2,-2,0
Eritrea,2002,CECAFA Cup,5,7,1,1,2,4,-2,0
Eritrea,2003,African Cup of Nations qualification,1,5,1,3,0,4,-4,0
Eritrea,2003,CECAFA Cup,3,5,0,2,0,2,-2,0
Eritrea,2003,FIFA World Cup qualification,0,3,0,1,1,2,-3,0
Eritrea,2005,CECAFA Cup,2,7,0,3,1,4,-5,0
Eritrea,2006,African Cup of Nations qualification,2,1,1,0,1,2,1,0
Eritrea,2007,African Cup of Nations qualification,3,7,1,1,2,4,-4,0
Eritrea,2007,CECAFA Cup,8,8,2,2,0,4,0,0
Eritrea,2007,Friendly,3,7,1,3,1,5,-4,0
Eritrea,2009,CECAFA Cup,4,7,1,2,0,3,-3,0
Eritrea,2011,FIFA World Cup qualification,2,4,0,1,1,2,-2,0
Eritrea,2011,Friendly,0,3,0,1,0,1,-3,0
Eritrea,2012,CECAFA Cup,2,5,0,2,1,3,-3,0
Eritrea,2013,CECAFA Cup,0,7,0,3,0,3,-7,0
Eritrea,2015,FIFA World Cup qualification,1,5,0,2,0,2,-4,0
Eritrea,2019,FIFA World Cup qualification,1,4,0,2,0,2,-3,0
Estonia,1920,Friendly,0,6,0,1,0,1,-6,0
Estonia,1921,Friendly,0,3,0,1,1,2,-3,0
Estonia,1922,Friendly,3,11,0,1,1,2,-8,0
Estonia,1923,Friendly,11,10,2,2,1,5,1,0
Estonia,1924,Friendly,4,17,0,5,0,5,-13,0
Estonia,1924,Olympic Games,0,1,0,1,0,1,-1,0
Estonia,1925,Friendly,5,2,2,0,2,4,3,0
Estonia,1926,Friendly,6,11,2,2,1,5,-5,0
Estonia,1927,Friendly,13,9,3,2,0,5,4,0
Estonia,1928,Baltic Cup,6,1,1,1,0,2,5,0
Estonia,1928,Friendly,3,4,0,1,2,3,-1,0
Estonia,1929,Baltic Cup,7,4,1,0,1,2,3,1
Estonia,1929,Friendly,7,8,1,2,1,4,-1,0
Estonia,1930,Baltic Cup,3,5,0,2,0,2,-2,0
Estonia,1930,Friendly,6,10,1,2,1,4,-4,0
Estonia,1931,Baltic Cup,5,1,2,0,0,2,4,1
Estonia,1931,Friendly,8,9,2,3,0,5,-1,0
Estonia,1932,Baltic Cup,1,3,0,2,0,2,-2,0
Estonia,1932,Friendly,4,10,1,4,0,5,-6,0
Estonia,1933,Baltic Cup,1,2,0,1,1,2,-1,0
Estonia,1933,FIFA World Cup qualification,2,6,0,1,0,1,-4,0
Estonia,1933,Friendly,10,6,3,2,0,5,4,0
Estonia,1934,Friendly,4,4,0,0,3,3,0,0
Estonia,1935,Baltic Cup,2,3,0,1,1,2,-1,0
Estonia,1935,Friendly,8,14,0,2,4,6,-6,0
Estonia,1936,Baltic Cup,3,3,1,1,0,2,0,0
Estonia,1936,Friendly,5,8,0,2,1,3,-3,0
Estonia,1937,Baltic Cup,5,3,1,1,1,3,2,0
Estonia,1937,FIFA World Cup qualification,4,11,1,2,0,3,-7,0
Estonia,1937,Friendly,5,5,2,1,0,3,0,0
Estonia,1938,Baltic Cup,4,2,1,0,1,2,2,0
Estonia,1938,Friendly,5,9,1,4,0,5,-4,0
Estonia,1939,Friendly,5,10,0,3,1,4,-5,0
Estonia,1940,Baltic Cup,3,3,0,0,2,2,0,0
Estonia,1940,Friendly,2,3,1,1,0,2,-1,0
Estonia,1942,Friendly,1,12,0,2,0,2,-11,0
Estonia,1945,Friendly,4,4,1,1,0,2,0,0
Estonia,1947,Friendly,0,0,0,0,1,1,0,0
Estonia,1948,Baltic Cup,2,3,0,1,1,2,-1,0
Estonia,1949,Baltic Cup,2,4,0,2,0,2,-2,0
Estonia,1956,Friendly,0,3,0,2,0,2,-3,0
Estonia,1991,Baltic Cup,1,6,0,2,0,2,-5,0
Estonia,1992,Baltic Cup,2,3,0,1,1,2,-1,0
Estonia,1992,FIFA World Cup qualification,0,6,0,1,1,2,-6,0
Estonia,1992,Friendly,1,1,0,0,1,1,0,0
Estonia,1993,Baltic Cup,2,3,1,1,0,2,-1,1
Estonia,1993,FIFA World Cup qualification,1,21,0,8,0,8,-20,0
Estonia,1993,Four Nations Tournament,0,2,0,1,1,2,-2,0
Estonia,1993,Friendly,2,2,1,1,0,2,0,0
Estonia,1994,Baltic Cup,0,5,0,2,0,2,-5,0
Estonia,1994,Friendly,1,21,0,6,1,7,-20,0
Estonia,1994,UEFA Euro qualification,0,7,0,3,0,3,-7,0
Estonia,1995,Baltic Cup,0,9,0,2,0,2,-9,0
Estonia,1995,Friendly,1,11,0,3,0,3,-10,0
Estonia,1995,UEFA Euro qualification,3,24,0,7,0,7,-21,0
Estonia,1996,Baltic Cup,2,2,0,0,2,2,0,0
Estonia,1996,FIFA World Cup qualification,1,1,1,1,0,2,0,0
Estonia,1996,Friendly,14,12,2,3,4,9,2,0
Estonia,1997,Baltic Cup,2,4,0,2,0,2,-2,0
Estonia,1997,FIFA World Cup qualification,3,15,0,7,1,8,-12,0
Estonia,1997,Friendly,8,5,4,2,0,6,3,0
Estonia,1998,Baltic Cup,0,2,0,1,1,2,-2,0
Estonia,1998,Friendly,7,17,1,5,2,8,-10,0
Estonia,1998,UEFA Euro qualification,9,8,1,2,1,4,1,0
Estonia,1999,Friendly,11,18,2,3,3,8,-7,0
Estonia,1999,UEFA Euro qualification,6,9,2,3,1,6,-3,0
Estonia,1999,United Arab Emirates Friendship Tournament,4,4,0,0,3,3,0,0
Estonia,2000,FIFA World Cup qualification,4,6,2,2,0,4,-2,0
Estonia,2000,Friendly,7,2,4,0,1,5,5,0
Estonia,2000,King's Cup,3,6,0,2,0,2,-3,0
Estonia,2001,Baltic Cup,3,8,0,2,0,2,-5,0
Estonia,2001,FIFA World Cup qualification,6,20,0,4,2,6,-14,0
Estonia,2001,Friendly,6,8,0,1,4,5,-2,0
Estonia,2002,Friendly,12,5,6,1,2,9,7,0
Estonia,2002,UEFA Euro qualification,0,1,0,1,1,2,-1,0
Estonia,2003,Baltic Cup,1,5,0,1,1,2,-4,0
Estonia,2003,Friendly,7,13,2,6,1,9,-6,0
Estonia,2003,UEFA Euro qualification,4,5,2,3,1,6,-1,0
Estonia,2004,FIFA World Cup qualification,8,11,2,2,1,5,-3,0
Estonia,2004,Friendly,7,12,1,4,2,7,-5,0
Estonia,2004,King's Cup,0,5,0,1,1,2,-5,0
Estonia,2004,Malta International Tournament,3,5,1,1,0,2,-2,1
Estonia,2005,FIFA World Cup qualification,8,6,3,3,1,7,2,0
Estonia,2005,Friendly,5,10,1,3,1,5,-5,0
Estonia,2006,Friendly,4,4,1,1,2,4,0,0
Estonia,2006,UEFA Euro qualification,0,4,0,3,0,3,-4,0
Estonia,2007,Friendly,0,8,0,4,1,5,-8,0
Estonia,2007,UEFA Euro qualification,5,17,2,6,1,9,-12,0
Estonia,2008,Baltic Cup,0,2,0,2,0,2,-2,0
Estonia,2008,FIFA World Cup qualification,2,13,0,3,1,4,-11,0
Estonia,2008,Friendly,12,9,4,1,3,8,3,0
Estonia,2009,FIFA World Cup qualification,7,11,2,3,1,6,-4,0
Estonia,2009,Friendly,4,4,2,3,2,7,0,0
Estonia,2010,Baltic Cup,0,2,0,1,1,2,-2,0
Estonia,2010,Friendly,7,11,1,3,3,7,-4,0
Estonia,2010,UEFA Euro qualification,6,5,2,2,0,4,1,0
Estonia,2011,Friendly,3,14,1,5,0,6,-11,0
Estonia,2011,UEFA Euro qualification,10,14,3,3,2,8,-4,0
Estonia,2012,Baltic Cup,2,2,1,1,0,2,0,1
Estonia,2012,FIFA World Cup qualification,1,6,1,3,0,4,-5,0
Estonia,2012,Friendly,7,14,3,4,0,7,-7,0
Estonia,2013,FIFA World Cup qualification,5,14,1,4,1,6,-9,0
Estonia,2013,Friendly,8,6,3,2,2,7,2,0
Estonia,2014,Baltic Cup,0,2,0,1,1,2,-2,0
Estonia,2014,Friendly,7,8,4,3,1,8,-1,0
Estonia,2014,UEFA Euro qualification,1,2,1,2,1,4,-1,0
Estonia,2015,Friendly,9,1,3,0,1,4,8,0
Estonia,2015,UEFA Euro qualification,3,7,2,4,0,6,-4,0
Estonia,2016,Baltic Cup,0,2,0,1,1,2,-2,0
Estonia,2016,FIFA World Cup qualification,5,15,1,3,0,4,-10,0
Estonia,2016,Friendly,6,11,2,2,4,8,-5,0
Estonia,2017,FIFA World Cup qualification,8,4,2,2,2,6,4,0
Estonia,2017,Friendly,12,5,5,1,1,7,7,0
Estonia,2018,Baltic Cup,2,1,1,1,0,2,1,0
Estonia,2018,Friendly,2,6,0,2,2,4,-4,0
Estonia,2018,UEFA Nations League,4,8,1,4,1,6,-4,0
Estonia,2019,Friendly,3,2,2,1,1,4,1,0
Estonia,2019,UEFA Euro qualification,2,26,0,7,1,8,-24,0
Estonia,2020,Friendly,1,7,0,2,0,2,-6,0
Estonia,2020,UEFA Nations League,5,9,0,3,3,6,-4,0
Estonia,2021,Baltic Cup,3,1,2,0,0,2,2,1
Estonia,2021,FIFA World Cup qualification,9,21,1,6,1,8,-12,0
Estonia,2021,Friendly,1,2,1,2,0,3,-1,0
Estonia,2022,Baltic Cup,3,1,1,0,1,2,2,1
Estonia,2022,Friendly,0,5,0,1,1,2,-5,0
Estonia,2022,UEFA Nations League,10,4,4,1,1,6,6,0
Estonia,2023,Friendly,3,3,1,1,2,4,0,0
Estonia,2023,UEFA Euro qualification,2,22,0,7,1,8,-20,0
Estonia,2024,Baltic Cup,5,2,1,0,1,2,3,0
Estonia,2024,Friendly,2,8,0,3,0,3,-6,0
Estonia,2024,UEFA Euro qualification,1,5,0,1,0,1,-4,0
Estonia,2024,UEFA Nations League,3,9,1,4,1,6,-6,0
Estonia,2025,FIFA World Cup qualification,4,4,1,1,0,2,0,0
Eswatini,1968,Friendly,4,0,2,0,0,2,4,0
Eswatini,1969,Friendly,0,3,0,1,0,1,-3,0
Eswatini,1973,Friendly,0,1,0,1,0,1,-1,0
Eswatini,1975,Friendly,0,2,0,1,1,2,-2,0
Eswatini,1978,Friendly,5,22,0,3,0,3,-17,0
Eswatini,1981,Friendly,2,9,0,2,2,4,-7,0
Eswatini,1984,African Cup of Nations qualification,1,8,0,2,0,2,-7,0
Eswatini,1984,Friendly,3,1,1,0,0,1,2,0
Eswatini,1986,Friendly,0,1,0,1,0,1,-1,0
Eswatini,1988,African Cup of Nations qualification,2,2,0,0,2,2,0,0
Eswatini,1989,African Cup of Nations qualification,1,3,0,1,1,2,-2,0
Eswatini,1990,African Cup of Nations qualification,1,6,0,1,1,2,-5,0
Eswatini,1990,Friendly,9,9,1,2,2,5,0,0
Eswatini,1991,African Cup of Nations qualification,3,3,1,1,1,3,0,0
Eswatini,1991,Friendly,2,4,0,2,0,2,-2,0
Eswatini,1992,FIFA World Cup qualification,1,5,1,1,0,2,-4,0
Eswatini,1992,Friendly,1,4,0,1,0,1,-3,0
Eswatini,1993,FIFA World Cup qualification,0,0,0,0,1,1,0,0
Eswatini,1993,Friendly,3,10,1,4,1,6,-7,0
Eswatini,1994,Friendly,0,1,0,1,0,1,-1,0
Eswatini,1996,FIFA World Cup qualification,0,3,0,2,0,2,-3,0
Eswatini,1996,Friendly,0,1,0,1,0,1,-1,0
Eswatini,1997,COSAFA Cup qualification,0,4,0,1,0,1,-4,0
Eswatini,1997,Friendly,3,2,1,1,3,5,1,0
Eswatini,1998,African Cup of Nations qualification,2,3,0,1,1,2,-1,0
Eswatini,1998,COSAFA Cup qualification,0,1,0,1,0,1,-1,0
Eswatini,1998,Friendly,1,2,0,1,1,2,-1,0
Eswatini,1999,COSAFA Cup,2,2,0,0,2,2,0,0
Eswatini,1999,COSAFA Cup qualification,3,1,1,0,0,1,2,0
Eswatini,1999,Friendly,10,3,3,0,1,4,7,0
Eswatini,2000,African Cup of Nations qualification,3,5,1,1,0,2,-2,0
Eswatini,2000,COSAFA Cup,0,2,0,1,0,1,-2,0
Eswatini,2000,FIFA World Cup qualification,1,8,0,2,0,2,-7,0
Eswatini,2000,Friendly,1,6,0,3,2,5,-5,0
Eswatini,2001,COSAFA Cup,1,2,0,1,1,2,-1,0
Eswatini,2001,Friendly,10,10,3,3,2,8,0,0
Eswatini,2002,African Cup of Nations qualification,2,1,1,0,1,2,1,1
Eswatini,2002,COSAFA Cup,5,5,2,1,0,3,0,0
Eswatini,2002,Friendly,5,10,1,3,3,7,-5,0
Eswatini,2003,African Cup of Nations qualification,6,11,1,2,1,4,-5,0
Eswatini,2003,COSAFA Cup,2,2,1,1,0,2,0,0
Eswatini,2003,FIFA World Cup qualification,1,4,0,1,1,2,-3,0
Eswatini,2003,Friendly,4,12,1,4,0,5,-8,0
Eswatini,2004,COSAFA Cup,0,5,0,1,0,1,-5,0
Eswatini,2004,Friendly,4,5,1,1,2,4,-1,0
Eswatini,2005,COSAFA Cup,0,3,0,1,0,1,-3,0
Eswatini,2005,Friendly,4,3,1,0,0,1,1,0
Eswatini,2006,African Cup of Nations qualification,0,2,0,1,1,2,-2,0
Eswatini,2006,COSAFA Cup,2,1,1,1,0,2,1,0
Eswatini,2006,Friendly,6,17,1,5,1,7,-11,0
Eswatini,2007,African Cup of Nations qualification,0,5,0,2,2,4,-5,0
Eswatini,2007,COSAFA Cup,1,0,1,0,1,2,1,0
Eswatini,2007,Friendly,1,4,1,2,0,3,-3,0
Eswatini,2008,COSAFA Cup qualification,3,2,1,0,2,3,1,0
Eswatini,2008,FIFA World Cup qualification,2,8,1,2,1,4,-6,0
Eswatini,2008,Friendly,4,10,0,2,2,4,-6,0
Eswatini,2009,COSAFA Cup,5,2,2,1,0,3,3,0
Eswatini,2009,Friendly,4,7,0,2,3,5,-3,0
Eswatini,2010,African Cup of Nations qualification,1,6,0,2,0,2,-5,0
Eswatini,2010,Friendly,1,4,0,2,0,2,-3,0
Eswatini,2011,African Cup of Nations qualification,1,8,0,4,0,4,-7,0
Eswatini,2011,FIFA World Cup qualification,2,8,0,2,0,2,-6,0
Eswatini,2011,Friendly,2,7,1,2,3,6,-5,0
Eswatini,2012,Friendly,2,2,1,1,1,3,0,0
Eswatini,2013,COSAFA Cup,0,4,0,2,1,3,-4,0
Eswatini,2013,Friendly,0,16,0,3,0,3,-16,0
Eswatini,2014,African Cup of Nations qualification,1,2,0,1,1,2,-1,0
Eswatini,2014,Friendly,2,3,1,1,2,4,-1,0
Eswatini,2015,African Cup of Nations qualification,4,3,1,0,1,2,1,0
Eswatini,2015,COSAFA Cup,4,1,2,0,1,3,3,0
Eswatini,2015,FIFA World Cup qualification,8,3,2,1,1,4,5,0
Eswatini,2015,Friendly,2,8,0,2,0,2,-6,0
Eswatini,2016,African Cup of Nations qualification,2,6,1,2,1,4,-4,0
Eswatini,2016,COSAFA Cup,9,7,3,1,2,6,2,1
Eswatini,2017,African Cup of Nations qualification,0,0,0,0,1,1,0,0
Eswatini,2017,COSAFA Cup,1,3,0,2,0,2,-2,0
Eswatini,2018,African Cup of Nations qualification,2,10,0,4,0,4,-8,0
Eswatini,2018,COSAFA Cup,0,3,0,2,0,2,-3,0
Eswatini,2018,Friendly,1,0,1,0,1,2,1,0
Eswatini,2019,African Cup of Nations qualification,1,11,0,3,0,3,-10,0
Eswatini,2019,COSAFA Cup,4,4,0,0,2,2,0,0
Eswatini,2019,FIFA World Cup qualification,1,2,0,1,1,2,-1,0
Eswatini,2020,African Cup of Nations qualification,0,2,0,1,1,2,-2,0
Eswatini,2021,African Cup of Nations qualification,2,4,0,1,1,2,-2,0
Eswatini,2021,COSAFA Cup,8,6,2,1,3,6,2,0
Eswatini,2021,Friendly,1,1,0,0,1,1,0,0
Eswatini,2022,African Cup of Nations qualification,8,6,2,1,1,4,2,0
Eswatini,2022,COSAFA Cup,7,4,2,1,2,5,3,0
Eswatini,2022,Friendly,1,0,1,0,0,1,1,0
Eswatini,2023,African Cup of Nations qualification,0,3,0,2,2,4,-3,0
Eswatini,2023,COSAFA Cup,3,4,1,2,0,3,-1,0
Eswatini,2023,FIFA World Cup qualification,0,3,0,2,0,2,-3,0
Eswatini,2023,Friendly,1,2,0,1,1,2,-1,0
Eswatini,2024,African Cup of Nations qualification,6,8,1,3,2,6,-2,0
Eswatini,2024,FIFA World Cup qualification,1,3,0,2,0,2,-2,0
Eswatini,2025,FIFA World Cup qualification,3,3,0,0,2,2,0,0
Ethiopia,1947,Friendly,5,0,1,0,0,1,5,0
Ethiopia,1948,Friendly,2,1,1,0,0,1,1,0
Ethiopia,1949,Friendly,6,0,1,0,0,1,6,0
Ethiopia,1954,Friendly,14,3,3,0,0,3,11,0
Ethiopia,1956,Friendly,2,1,1,0,0,1,1,0
Ethiopia,1957,African Cup of Nations,0,4,0,1,0,1,-4,0
Ethiopia,1959,African Cup of Nations,0,5,0,2,0,2,-5,0
Ethiopia,1961,FIFA World Cup qualification,2,4,0,2,0,2,-2,0
Ethiopia,1961,Friendly,4,3,1,0,0,1,1,1
Ethiopia,1962,African Cup of Nations,8,4,2,0,0,2,4,1
Ethiopia,1962,Friendly,10,12,1,3,1,5,-2,0
Ethiopia,1963,African Cup of Nations,4,7,1,2,0,3,-3,0
Ethiopia,1963,Friendly,21,3,6,0,0,6,18,0
Ethiopia,1964,Friendly,3,6,0,2,0,2,-3,0
Ethiopia,1965,African Cup of Nations,1,9,0,2,0,2,-8,0
Ethiopia,1965,African Cup of Nations qualification,6,3,3,1,0,4,3,0
Ethiopia,1966,Friendly,6,1,1,0,1,2,5,0
Ethiopia,1967,Friendly,15,10,5,2,1,8,5,1
Ethiopia,1968,African Cup of Nations,8,6,3,2,0,5,2,0
Ethiopia,1968,Friendly,6,3,1,1,0,2,3,0
Ethiopia,1969,African Cup of Nations qualification,9,1,2,0,0,2,8,0
Ethiopia,1969,FIFA World Cup qualification,7,7,1,2,1,4,0,0
Ethiopia,1969,Friendly,11,5,2,2,0,4,6,0
Ethiopia,1970,African Cup of Nations,3,12,0,3,0,3,-9,0
Ethiopia,1970,African Cup of Nations qualification,0,3,0,2,0,2,-3,0
Ethiopia,1970,Friendly,1,5,0,1,0,1,-4,0
Ethiopia,1971,Friendly,1,5,0,1,0,1,-4,0
Ethiopia,1972,FIFA World Cup qualification,4,1,1,0,2,3,3,0
Ethiopia,1972,Friendly,0,1,0,1,0,1,-1,0
Ethiopia,1973,African Cup of Nations qualification,2,4,1,1,0,2,-2,0
Ethiopia,1973,FIFA World Cup qualification,2,4,0,1,1,2,-2,0
Ethiopia,1973,Friendly,0,1,0,1,0,1,-1,0
Ethiopia,1975,Friendly,1,2,0,1,0,1,-1,0
Ethiopia,1976,African Cup of Nations,4,3,1,1,1,3,1,0
Ethiopia,1976,FIFA World Cup qualification,1,5,0,2,0,2,-4,0
Ethiopia,1976,Friendly,4,4,1,1,0,2,0,0
Ethiopia,1977,African Cup of Nations qualification,5,4,2,1,1,4,1,0
Ethiopia,1977,Friendly,0,0,0,0,1,1,0,0
Ethiopia,1979,African Cup of Nations qualification,2,3,0,1,1,2,-1,0
Ethiopia,1980,FIFA World Cup qualification,0,4,0,1,1,2,-4,0
Ethiopia,1980,Friendly,3,2,1,0,0,1,1,0
Ethiopia,1981,African Cup of Nations qualification,4,4,1,1,2,4,0,0
Ethiopia,1981,Friendly,4,2,1,0,3,4,2,0
Ethiopia,1982,African Cup of Nations,0,4,0,2,1,3,-4,0
Ethiopia,1982,Friendly,2,4,1,2,1,4,-2,0
Ethiopia,1983,African Cup of Nations qualification,3,5,2,2,0,4,-2,0
Ethiopia,1983,CECAFA Cup,2,7,0,3,1,4,-5,0
Ethiopia,1983,Friendly,20,14,4,5,3,12,6,0
Ethiopia,1984,FIFA World Cup qualification,4,5,0,1,1,2,-1,0
Ethiopia,1984,Friendly,6,0,3,0,0,3,6,0
Ethiopia,1986,African Cup of Nations qualification,4,2,1,0,0,1,2,0
Ethiopia,1986,Friendly,8,2,2,0,1,3,6,0
Ethiopia,1987,CECAFA Cup,6,2,2,0,3,5,4,0
Ethiopia,1988,CECAFA Cup,3,3,1,1,1,3,0,0
Ethiopia,1989,African Cup of Nations qualification,2,6,1,1,0,2,-4,0
Ethiopia,1989,Friendly,4,4,1,1,2,4,0,0
Ethiopia,1990,African Cup of Nations qualification,0,4,0,2,0,2,-4,0
Ethiopia,1992,African Cup of Nations qualification,4,3,1,1,0,2,1,0
Ethiopia,1992,CECAFA Cup,7,7,1,3,0,4,0,0
Ethiopia,1992,FIFA World Cup qualification,3,6,1,1,1,3,-3,0
Ethiopia,1992,Friendly,5,1,1,0,0,1,4,0
Ethiopia,1992,Jordan International Tournament,0,16,0,2,0,2,-16,0
Ethiopia,1993,African Cup of Nations qualification,3,9,1,2,1,4,-6,0
Ethiopia,1993,FIFA World Cup qualification,0,5,0,3,0,3,-5,0
Ethiopia,1993,Friendly,1,1,0,0,1,1,0,0
Ethiopia,1994,African Cup of Nations qualification,1,9,0,2,1,3,-8,0
Ethiopia,1995,African Cup of Nations qualification,3,9,2,4,1,7,-6,0
Ethiopia,1995,CECAFA Cup,9,5,1,1,2,4,4,0
Ethiopia,1996,African Cup of Nations qualification,3,4,0,1,2,3,-1,0
Ethiopia,1996,Friendly,2,0,1,0,0,1,2,0
Ethiopia,1997,African Cup of Nations qualification,2,17,0,4,1,5,-15,0
Ethiopia,1999,CECAFA Cup,2,0,1,0,1,2,2,0
Ethiopia,1999,Friendly,2,2,0,0,1,1,0,0
Ethiopia,2000,African Cup of Nations qualification,1,2,1,1,0,2,-1,0
Ethiopia,2000,CECAFA Cup,9,5,3,0,1,4,4,0
Ethiopia,2000,FIFA World Cup qualification,2,4,1,1,0,2,-2,0
Ethiopia,2000,Friendly,3,3,1,1,1,3,0,0
Ethiopia,2001,CECAFA Cup,8,1,3,0,0,3,7,1
Ethiopia,2001,Friendly,3,4,0,1,1,2,-1,0
Ethiopia,2002,African Cup of Nations qualification,2,3,1,1,0,2,-1,0
Ethiopia,2002,CECAFA Cup,0,5,0,3,1,4,-5,0
Ethiopia,2002,Friendly,4,11,0,3,2,5,-7,0
Ethiopia,2003,African Cup of Nations qualification,3,4,2,2,0,4,-1,0
Ethiopia,2003,FIFA World Cup qualification,1,3,0,1,1,2,-2,0
Ethiopia,2004,CECAFA Cup,12,3,4,0,2,6,9,0
Ethiopia,2005,CECAFA Cup,17,2,5,0,1,6,15,0
Ethiopia,2005,Friendly,6,4,1,1,0,2,2,0
Ethiopia,2006,African Cup of Nations qualification,1,1,1,1,0,2,0,0
Ethiopia,2006,CECAFA Cup,6,3,2,2,0,4,3,0
Ethiopia,2006,Friendly,5,0,4,0,0,4,5,0
Ethiopia,2007,African Cup of Nations qualification,4,8,1,3,0,4,-4,0
Ethiopia,2007,CECAFA Cup,1,3,0,1,1,2,-2,0
Ethiopia,2009,CECAFA Cup,5,3,1,2,0,3,2,0
Ethiopia,2010,African Cup of Nations qualification,2,4,1,1,0,2,-2,0
Ethiopia,2010,CECAFA Cup,8,8,2,2,0,4,0,0
Ethiopia,2010,Friendly,1,3,1,1,0,2,-2,0
Ethiopia,2011,African Cup of Nations qualification,6,9,1,2,1,4,-3,0
Ethiopia,2011,CECAFA Cup,2,4,0,1,2,3,-2,0
Ethiopia,2011,FIFA World Cup qualification,5,0,1,0,1,2,5,0
Ethiopia,2011,Friendly,2,4,0,2,1,3,-2,0
Ethiopia,2012,African Cup of Nations qualification,6,6,1,1,2,4,0,0
Ethiopia,2012,CECAFA Cup,2,6,1,3,0,4,-4,0
Ethiopia,2012,FIFA World Cup qualification,3,1,1,0,1,2,2,0
Ethiopia,2012,Friendly,1,0,1,0,0,1,1,1
Ethiopia,2013,African Cup of Nations,1,7,0,2,1,3,-6,0
Ethiopia,2013,CECAFA Cup,5,3,2,1,1,4,2,0
Ethiopia,2013,FIFA World Cup qualification,6,9,3,3,0,6,-3,0
Ethiopia,2013,Friendly,5,2,2,0,1,3,3,0
Ethiopia,2014,African Cup of Nations qualification,7,12,1,4,1,6,-5,0
Ethiopia,2014,Friendly,1,5,0,2,0,2,-4,0
Ethiopia,2015,African Cup of Nations qualification,3,2,1,0,1,2,1,0
Ethiopia,2015,CECAFA Cup,5,4,1,1,4,6,1,0
Ethiopia,2015,FIFA World Cup qualification,7,7,1,3,0,4,0,0
Ethiopia,2015,Friendly,4,6,1,2,0,3,-2,0
Ethiopia,2016,African Cup of Nations qualification,8,12,2,1,1,4,-4,0
Ethiopia,2017,African Cup of Nations qualification,0,5,0,1,0,1,-5,0
Ethiopia,2017,CECAFA Cup,5,5,1,1,1,3,0,0
Ethiopia,2017,Friendly,0,0,0,0,2,2,0,0
Ethiopia,2018,African Cup of Nations qualification,0,5,0,2,1,3,-5,0
Ethiopia,2018,Friendly,1,1,0,0,1,1,0,0
Ethiopia,2019,African Cup of Nations qualification,2,2,1,1,0,2,0,1
Ethiopia,2019,FIFA World Cup qualification,1,1,0,0,2,2,0,0
Ethiopia,2019,Friendly,0,1,0,1,0,1,-1,0
Ethiopia,2020,African Cup of Nations qualification,3,1,1,1,0,2,2,0
Ethiopia,2020,Friendly,2,2,0,0,1,1,0,0
Ethiopia,2021,African Cup of Nations qualification,5,3,1,1,0,2,2,0
Ethiopia,2021,FIFA World Cup qualification,4,7,1,3,2,6,-3,0
Ethiopia,2021,Friendly,9,3,3,0,1,4,6,0
Ethiopia,2022,African Cup of Nations,2,6,0,2,1,3,-4,0
Ethiopia,2022,African Cup of Nations qualification,3,2,1,1,0,2,1,0
Ethiopia,2022,Friendly,5,6,0,1,3,4,-1,0
Ethiopia,2023,African Cup of Nations qualification,2,6,0,3,1,4,-4,0
Ethiopia,2023,FIFA World Cup qualification,0,3,0,1,1,2,-3,0
Ethiopia,2023,Friendly,3,0,2,0,0,2,3,0
Ethiopia,2024,African Cup of Nations qualification,1,9,0,3,1,4,-8,0
Ethiopia,2024,FIFA World Cup qualification,1,1,0,0,2,2,0,0
Ethiopia,2024,Friendly,3,3,1,1,0,2,0,0
Ethiopia,2025,FIFA World Cup qualification,6,3,1,1,0,2,3,0
Falkland Islands,2001,Island Games,4,17,1,3,0,4,-13,1
Falkland Islands,2005,Island Games,3,18,1,4,0,5,-15,0
Falkland Islands,2009,Island Games,3,14,0,4,0,4,-11,0
Falkland Islands,2011,Island Games,4,17,1,3,0,4,-13,0
Falkland Islands,2013,Island Games,8,18,2,2,0,4,-10,0
Falkland Islands,2015,Island Games,3,11,1,3,0,4,-8,0
Falkland Islands,2017,Island Games,3,13,0,4,0,4,-10,0
Falkland Islands,2023,Island Games,3,13,0,3,1,4,-10,0
Faroe Islands,1972,Friendly,0,3,0,1,0,1,-3,0
Faroe Islands,1973,Friendly,0,4,0,1,0,1,-4,0
Faroe Islands,1974,Friendly,2,3,0,1,0,1,-1,0
Faroe Islands,1975,Friendly,0,6,0,1,0,1,-6,0
Faroe Islands,1976,Friendly,1,6,0,1,0,1,-5,0
Faroe Islands,1980,Friendly,7,2,1,1,0,2,5,0
Faroe Islands,1982,Friendly,1,8,0,2,0,2,-7,0
Faroe Islands,1983,Friendly,3,8,1,1,1,3,-5,0
Faroe Islands,1984,Friendly,5,2,2,0,1,3,3,0
Faroe Islands,1985,Friendly,0,10,0,2,0,2,-10,0
Faroe Islands,1988,Friendly,0,1,0,1,0,1,-1,0
Faroe Islands,1989,Friendly,1,1,1,1,0,2,0,0
Faroe Islands,1989,Island Games,20,1,4,0,0,4,19,0
Faroe Islands,1990,Friendly,2,3,0,1,0,1,-1,0
Faroe Islands,1990,UEFA Euro qualification,2,4,1,1,0,2,-2,0
Faroe Islands,1991,Friendly,1,1,0,0,1,1,0,0
Faroe Islands,1991,Island Games,13,5,4,0,0,4,8,1
Faroe Islands,1991,UEFA Euro qualification,1,22,0,5,1,6,-21,0
Faroe Islands,1992,FIFA World Cup qualification,0,22,0,5,0,5,-22,0
Faroe Islands,1992,Friendly,1,3,0,1,1,2,-2,0
Faroe Islands,1993,FIFA World Cup qualification,1,16,0,5,0,5,-15,0
Faroe Islands,1993,Friendly,0,7,0,1,0,1,-7,0
Faroe Islands,1994,UEFA Euro qualification,2,15,0,3,0,3,-13,0
Faroe Islands,1995,Friendly,0,2,0,1,0,1,-2,0
Faroe Islands,1995,UEFA Euro qualification,8,20,2,5,0,7,-12,0
Faroe Islands,1996,FIFA World Cup qualification,5,22,0,5,0,5,-17,0
Faroe Islands,1996,Friendly,2,5,0,1,1,2,-3,0
Faroe Islands,1997,FIFA World Cup qualification,5,9,2,3,0,5,-4,0
Faroe Islands,1997,Friendly,2,1,1,1,0,2,1,0
Faroe Islands,1998,UEFA Euro qualification,1,9,0,4,1,5,-8,0
Faroe Islands,1999,Friendly,0,1,0,1,0,1,-1,0
Faroe Islands,1999,UEFA Euro qualification,3,8,0,3,2,5,-5,0
Faroe Islands,2000,FIFA World Cup qualification,3,7,0,1,1,2,-4,0
Faroe Islands,2000,Friendly,1,0,1,0,0,1,1,0
Faroe Islands,2000,Nordic Championship,2,6,0,3,0,3,-4,0
Faroe Islands,2001,FIFA World Cup qualification,3,16,2,6,0,8,-13,0
Faroe Islands,2001,Nordic Championship,0,0,0,0,1,1,0,0
Faroe Islands,2002,Friendly,5,3,2,1,0,3,2,0
Faroe Islands,2002,UEFA Euro qualification,3,6,0,2,1,3,-3,0
Faroe Islands,2003,Friendly,5,3,2,0,0,2,2,0
Faroe Islands,2003,UEFA Euro qualification,4,12,0,5,0,5,-8,0
Faroe Islands,2004,FIFA World Cup qualification,2,12,0,3,1,4,-10,0
Faroe Islands,2004,Friendly,7,13,2,2,0,4,-6,0
Faroe Islands,2005,FIFA World Cup qualification,2,15,0,6,0,6,-13,0
Faroe Islands,2006,Friendly,0,4,0,1,0,1,-4,0
Faroe Islands,2006,UEFA Euro qualification,0,18,0,4,0,4,-18,0
Faroe Islands,2007,UEFA Euro qualification,4,25,0,8,0,8,-21,0
Faroe Islands,2008,FIFA World Cup qualification,1,5,0,3,1,4,-4,0
Faroe Islands,2008,Friendly,3,12,0,3,0,3,-9,0
Faroe Islands,2009,FIFA World Cup qualification,4,15,1,5,0,6,-11,0
Faroe Islands,2009,Friendly,2,1,1,0,0,1,1,0
Faroe Islands,2010,Friendly,0,5,0,2,1,3,-5,0
Faroe Islands,2010,UEFA Euro qualification,3,16,0,4,1,5,-13,0
Faroe Islands,2011,Friendly,0,3,0,1,0,1,-3,0
Faroe Islands,2011,UEFA Euro qualification,3,10,1,4,0,5,-7,0
Faroe Islands,2012,FIFA World Cup qualification,2,9,0,3,0,3,-7,0
Faroe Islands,2012,Friendly,0,2,0,1,0,1,-2,0
Faroe Islands,2013,FIFA World Cup qualification,2,20,0,6,1,7,-18,0
Faroe Islands,2013,Friendly,2,4,0,2,0,2,-2,0
Faroe Islands,2014,Friendly,4,1,1,0,0,1,3,0
Faroe Islands,2014,UEFA Euro qualification,2,6,1,3,0,4,-4,0
Faroe Islands,2015,UEFA Euro qualification,4,11,1,5,0,6,-7,0
Faroe Islands,2016,FIFA World Cup qualification,2,8,1,2,1,4,-6,0
Faroe Islands,2016,Friendly,3,4,1,1,0,2,-1,0
Faroe Islands,2017,FIFA World Cup qualification,2,8,1,3,2,6,-6,0
Faroe Islands,2018,Friendly,4,1,1,0,1,2,3,0
Faroe Islands,2018,UEFA Nations League,5,10,1,3,2,6,-5,0
Faroe Islands,2019,UEFA Euro qualification,4,30,1,9,0,10,-26,0
Faroe Islands,2020,Friendly,1,6,0,2,0,2,-5,0
Faroe Islands,2020,UEFA Nations League,9,5,3,0,3,6,4,0
Faroe Islands,2021,FIFA World Cup qualification,7,23,1,8,1,10,-16,0
Faroe Islands,2021,Friendly,5,2,1,1,0,2,3,0
Faroe Islands,2022,Friendly,2,6,1,1,2,4,-4,0
Faroe Islands,2022,UEFA Nations League,7,10,2,2,2,6,-3,0
Faroe Islands,2023,Friendly,0,3,0,2,0,2,-3,0
Faroe Islands,2023,UEFA Euro qualification,2,13,0,6,2,8,-11,0
Faroe Islands,2024,Baltic Cup,1,5,0,2,0,2,-4,0
Faroe Islands,2024,Friendly,4,2,1,1,0,2,2,0
Faroe Islands,2024,UEFA Nations League,5,6,1,2,3,6,-1,0
Faroe Islands,2025,FIFA World Cup qualification,1,3,0,2,0,2,-2,0
Felvidék,2015,CONIFA European Football Cup,5,11,1,2,1,4,-6,0
Felvidék,2015,Niamh Challenge Cup,3,4,1,1,0,2,-1,0
Felvidék,2016,Hungary Heritage Cup,3,2,1,0,1,2,1,1
Felvidék,2017,CONIFA European Football Cup,3,3,2,2,0,4,0,0
Fiji,1951,Friendly,4,6,0,1,0,1,-2,0
Fiji,1952,Friendly,2,16,0,3,0,3,-14,0
Fiji,1963,South Pacific Games,10,9,2,1,0,3,1,0
Fiji,1968,Friendly,1,7,0,2,0,2,-6,0
Fiji,1969,South Pacific Games,12,19,2,3,1,6,-7,0
Fiji,1971,Friendly,2,5,0,1,0,1,-3,0
Fiji,1971,South Pacific Games,20,12,1,2,0,3,8,0
Fiji,1973,Oceania Nations Cup,2,13,0,4,0,4,-11,0
Fiji,1975,Friendly,1,4,0,1,0,1,-3,0
Fiji,1975,South Pacific Games,14,7,1,2,1,4,7,0
Fiji,1977,Friendly,1,0,1,0,0,1,1,0
Fiji,1979,Friendly,0,9,0,2,0,2,-9,0
Fiji,1979,South Pacific Games,31,3,3,1,1,5,28,0
Fiji,1980,Friendly,2,6,0,2,2,4,-4,0
Fiji,1980,Oceania Nations Cup,11,9,2,2,0,4,2,0
Fiji,1981,FIFA World Cup qualification,6,35,1,4,2,7,-29,0
Fiji,1981,Friendly,1,3,0,2,0,2,-2,0
Fiji,1981,South Pacific Mini Games,9,14,2,3,1,6,-5,0
Fiji,1983,Friendly,2,1,1,1,0,2,1,0
Fiji,1983,South Pacific Games,26,4,5,1,0,6,22,0
Fiji,1984,Friendly,2,3,0,1,1,2,-1,0
Fiji,1985,Friendly,1,14,0,6,0,6,-13,0
Fiji,1986,Friendly,3,6,0,2,0,2,-3,0
Fiji,1988,FIFA World Cup qualification,2,5,1,1,0,2,-3,0
Fiji,1988,Friendly,18,3,5,0,2,7,15,0
Fiji,1989,Friendly,7,2,3,0,1,4,5,0
Fiji,1990,Friendly,2,1,1,0,3,4,1,0
Fiji,1991,South Pacific Games,24,4,4,0,1,5,20,0
Fiji,1992,FIFA World Cup qualification,6,3,2,1,0,3,3,0
Fiji,1992,Friendly,6,3,2,0,1,3,3,0
Fiji,1993,Friendly,0,10,0,3,0,3,-10,0
Fiji,1993,South Pacific Mini Games,15,4,3,2,0,5,11,0
Fiji,1994,Friendly,4,3,1,1,1,3,1,0
Fiji,1994,Oceania Nations Cup qualification,8,4,3,1,0,4,4,0
Fiji,1995,Friendly,3,6,0,1,1,2,-3,0
Fiji,1995,South Pacific Games,19,6,3,0,2,5,13,0
Fiji,1997,FIFA World Cup qualification,4,7,2,2,0,4,-3,0
Fiji,1997,Friendly,9,5,2,1,0,3,4,0
Fiji,1998,Oceania Nations Cup,8,6,2,2,0,4,2,0
Fiji,1998,Oceania Nations Cup qualification,8,2,3,0,1,4,6,0
Fiji,2000,Oceania Nations Cup qualification,13,4,3,0,1,4,9,0
Fiji,2001,FIFA World Cup qualification,27,4,3,1,0,4,23,0
Fiji,2001,Friendly,7,3,2,1,0,3,4,0
Fiji,2002,Oceania Nations Cup,2,10,1,2,0,3,-8,0
Fiji,2003,Friendly,9,0,1,0,0,1,9,0
Fiji,2003,South Pacific Games,22,2,5,0,1,6,20,1
Fiji,2004,FIFA World Cup qualification,19,5,3,1,0,4,14,0
Fiji,2004,Oceania Nations Cup,3,10,1,3,1,5,-7,0
Fiji,2005,Friendly,3,1,2,0,0,2,2,0
Fiji,2007,Oceania Nations Cup,3,9,0,2,1,3,-6,0
Fiji,2007,South Pacific Games,28,2,4,1,1,6,26,0
Fiji,2008,Oceania Nations Cup,5,2,2,1,0,3,3,1
Fiji,2011,Friendly,9,3,2,1,0,3,6,0
Fiji,2011,Pacific Games,20,5,4,2,0,6,15,0
Fiji,2012,Oceania Nations Cup,1,2,0,1,2,3,-1,0
Fiji,2015,Friendly,13,3,2,1,1,4,10,0
Fiji,2016,Friendly,1,1,0,0,1,1,0,0
Fiji,2016,Oceania Nations Cup,4,6,1,2,0,3,-2,0
Fiji,2017,FIFA World Cup qualification,3,8,0,3,1,4,-5,0
Fiji,2017,Friendly,2,3,1,1,2,4,-1,0
Fiji,2017,Pacific Mini Games,17,2,3,0,2,5,15,0
Fiji,2018,Friendly,3,7,0,3,1,4,-4,0
Fiji,2019,Friendly,5,1,2,0,2,4,4,0
Fiji,2019,Pacific Games,26,8,3,1,2,6,18,0
Fiji,2022,FIFA World Cup qualification,3,7,1,2,0,3,-4,0
Fiji,2022,Friendly,2,1,1,0,0,1,1,0
Fiji,2022,MSG Prime Minister's Cup,4,3,2,1,1,4,1,1
Fiji,2023,Friendly,1,4,0,2,0,2,-3,0
Fiji,2023,Pacific Games,14,4,2,1,1,4,10,0
Fiji,2024,FIFA World Cup qualification,5,4,1,0,2,3,1,0
Fiji,2024,Friendly,3,2,1,1,0,2,1,0
Fiji,2024,Oceania Nations Cup,17,6,3,2,0,5,11,0
Fiji,2024,Tri-Nations Series,2,1,1,0,1,2,1,0
Fiji,2025,FIFA World Cup qualification,0,7,0,1,0,1,-7,0
Finland,1911,Friendly,2,5,0,1,0,1,-3,0
Finland,1912,Friendly,2,8,0,1,1,2,-6,0
Finland,1912,Olympic Games,5,12,2,1,0,3,-7,0
Finland,1914,Friendly,3,4,0,1,0,1,-1,0
Finland,1919,Friendly,3,4,0,1,1,2,-1,0
Finland,1920,Friendly,7,4,2,1,0,3,3,0
Finland,1921,Friendly,13,9,2,2,1,5,4,0
Finland,1922,Friendly,13,14,1,3,0,4,-1,0
Finland,1923,Friendly,14,19,2,5,0,7,-5,0
Finland,1924,Friendly,15,12,3,3,0,6,3,0
Finland,1925,Friendly,12,20,1,5,2,8,-8,0
Finland,1926,Friendly,13,19,2,3,1,6,-6,0
Finland,1927,Friendly,7,12,1,3,0,4,-5,0
Finland,1928,Friendly,7,14,1,3,1,5,-7,0
Finland,1929,Friendly,6,7,2,1,1,4,-1,0
Finland,1929,Nordic Championship,1,15,0,3,0,3,-14,0
Finland,1930,Friendly,0,7,0,2,0,2,-7,0
Finland,1930,Nordic Championship,7,16,0,2,1,3,-9,0
Finland,1931,Friendly,7,1,2,0,0,2,6,0
Finland,1931,Nordic Championship,9,14,1,1,1,3,-5,1
Finland,1932,Friendly,5,11,1,2,0,3,-6,0
Finland,1932,Nordic Championship,6,7,1,2,0,3,-1,0
Finland,1933,Friendly,11,3,2,0,0,2,8,0
Finland,1933,Nordic Championship,1,9,0,3,0,3,-8,0
Finland,1934,Friendly,2,3,0,1,2,3,-1,0
Finland,1934,Nordic Championship,9,9,2,1,0,3,0,1
Finland,1935,Friendly,2,8,0,1,1,2,-6,0
Finland,1935,Nordic Championship,4,12,0,2,1,3,-8,0
Finland,1936,Friendly,2,2,0,0,1,1,0,0
Finland,1936,Nordic Championship,4,6,1,2,0,3,-2,0
Finland,1937,FIFA World Cup qualification,0,7,0,3,0,3,-7,0
Finland,1937,Friendly,0,8,0,1,0,1,-8,0
Finland,1937,Nordic Championship,1,4,0,2,0,2,-3,0
Finland,1938,Friendly,6,4,2,1,0,3,2,0
Finland,1938,Nordic Championship,4,14,1,2,0,3,-10,0
Finland,1939,Friendly,6,13,1,3,0,4,-7,0
Finland,1939,Nordic Championship,3,15,0,3,0,3,-12,0
Finland,1940,Friendly,2,21,0,3,0,3,-19,0
Finland,1941,Friendly,0,6,0,1,0,1,-6,0
Finland,1943,Friendly,1,4,0,1,1,2,-3,0
Finland,1945,Friendly,3,13,0,2,0,2,-10,0
Finland,1946,Friendly,2,24,0,3,0,3,-22,0
Finland,1947,Friendly,2,6,0,2,0,2,-4,0
Finland,1947,Nordic Championship,4,14,0,2,1,3,-10,0
Finland,1948,Friendly,0,3,0,2,0,2,-3,0
Finland,1948,Nordic Championship,2,7,0,2,1,3,-5,0
Finland,1949,FIFA World Cup qualification,1,4,0,1,1,2,-3,0
Finland,1949,Friendly,1,4,0,1,0,1,-3,0
Finland,1949,Nordic Championship,4,9,1,1,1,3,-5,0
Finland,1950,Friendly,7,3,2,0,0,2,4,0
Finland,1950,Nordic Championship,2,7,0,3,0,3,-5,0
Finland,1951,Friendly,4,15,0,2,1,3,-11,0
Finland,1951,Nordic Championship,3,5,0,2,1,3,-2,0
Finland,1952,Friendly,10,8,3,1,0,4,2,0
Finland,1952,Nordic Championship,5,16,1,2,0,3,-11,0
Finland,1953,FIFA World Cup qualification,7,13,0,2,2,4,-6,0
Finland,1953,Nordic Championship,2,10,0,2,0,2,-8,0
Finland,1954,Friendly,1,8,0,2,0,2,-7,0
Finland,1954,Nordic Championship,4,15,0,2,1,3,-11,0
Finland,1955,Friendly,2,12,0,2,0,2,-10,0
Finland,1955,Nordic Championship,2,8,0,3,0,3,-6,0
Finland,1956,Friendly,3,11,1,2,0,3,-8,0
Finland,1956,Nordic Championship,2,8,0,2,1,3,-6,0
Finland,1957,FIFA World Cup qualification,2,19,0,4,0,4,-17,0
Finland,1957,Friendly,3,5,1,1,0,2,-2,0
Finland,1957,Nordic Championship,1,12,0,3,0,3,-11,0
Finland,1958,Nordic Championship,2,13,0,3,0,3,-11,0
Finland,1959,Friendly,3,2,1,0,0,1,1,0
Finland,1959,Nordic Championship,3,11,0,3,0,3,-8,0
Finland,1960,FIFA World Cup qualification,1,2,0,1,0,1,-1,0
Finland,1960,Friendly,1,5,0,1,0,1,-4,0
Finland,1960,Nordic Championship,4,11,0,3,0,3,-7,0
Finland,1961,FIFA World Cup qualification,2,10,0,3,0,3,-8,0
Finland,1961,Nordic Championship,5,14,1,2,0,3,-9,0
Finland,1962,Nordic Championship,2,11,0,3,0,3,-9,0
Finland,1963,Nordic Championship,3,1,1,0,2,3,2,0
Finland,1964,FIFA World Cup qualification,2,9,0,2,0,2,-7,0
Finland,1964,Friendly,3,4,1,1,0,2,-1,0
Finland,1964,Nordic Championship,3,3,2,1,0,3,0,0
Finland,1965,FIFA World Cup qualification,3,11,1,3,0,4,-8,0
Finland,1965,Nordic Championship,7,5,1,1,1,3,2,0
Finland,1966,Friendly,1,13,0,3,0,3,-12,0
Finland,1966,Nordic Championship,4,2,2,0,1,3,2,0
Finland,1966,UEFA Euro qualification,1,2,0,1,1,2,-1,0
Finland,1967,Nordic Championship,0,7,0,3,0,3,-7,0
Finland,1967,UEFA Euro qualification,4,10,0,3,1,4,-6,0
Finland,1968,FIFA World Cup qualification,3,17,0,3,0,3,-14,0
Finland,1968,Nordic Championship,2,10,0,3,0,3,-8,0
Finland,1969,FIFA World Cup qualification,3,11,1,2,0,3,-8,0
Finland,1969,Friendly,3,1,1,0,0,1,2,0
Finland,1969,Nordic Championship,4,11,0,2,1,3,-7,0
Finland,1970,Nordic Championship,2,5,0,2,1,3,-3,0
Finland,1970,UEFA Euro qualification,1,4,0,1,1,2,-3,0
Finland,1971,Nordic Championship,2,5,0,1,2,3,-3,0
Finland,1971,UEFA Euro qualification,0,12,0,4,0,4,-12,0
Finland,1972,FIFA World Cup qualification,2,6,1,1,1,3,-4,0
Finland,1972,Friendly,1,1,0,0,1,1,0,0
Finland,1972,Nordic Championship,0,3,0,1,1,2,-3,0
Finland,1973,FIFA World Cup qualification,1,15,0,3,0,3,-14,0
Finland,1973,Nordic Championship,2,3,0,1,1,2,-1,0
Finland,1974,Friendly,2,2,0,0,1,1,0,0
Finland,1974,Nordic Championship,3,2,1,0,1,2,1,1
Finland,1974,UEFA Euro qualification,2,8,0,3,0,3,-6,0
Finland,1975,Nordic Championship,3,7,0,2,0,2,-4,0
Finland,1975,UEFA Euro qualification,1,5,0,2,1,3,-4,0
Finland,1976,FIFA World Cup qualification,9,7,1,2,0,3,2,0
Finland,1976,Friendly,4,7,3,1,0,4,-3,0
Finland,1976,Nordic Championship,0,8,0,2,0,2,-8,0
Finland,1977,FIFA World Cup qualification,2,9,1,2,0,3,-7,0
Finland,1977,Friendly,2,4,1,2,0,3,-2,0
Finland,1977,Nordic Championship,2,3,0,1,1,2,-1,0
Finland,1978,Friendly,2,12,0,3,0,3,-10,0
Finland,1978,Nordic Championship,2,3,0,1,1,2,-1,0
Finland,1978,UEFA Euro qualification,6,9,2,1,0,3,-3,0
Finland,1979,Friendly,3,3,2,2,0,4,0,0
Finland,1979,Nordic Championship,0,1,0,1,1,2,-1,0
Finland,1979,UEFA Euro qualification,4,6,0,1,2,3,-2,0
Finland,1980,FIFA World Cup qualification,0,6,0,3,0,3,-6,0
Finland,1980,Friendly,3,12,0,2,2,4,-9,0
Finland,1980,Nordic Championship,1,8,0,2,0,2,-7,0
Finland,1981,FIFA World Cup qualification,4,21,1,4,0,5,-17,0
Finland,1981,Friendly,2,1,1,0,0,1,1,0
Finland,1981,Nordic Championship,4,4,1,2,0,3,0,0
Finland,1982,Friendly,8,9,2,1,1,4,-1,0
Finland,1982,Nordic Championship,3,4,0,1,1,2,-1,0
Finland,1982,UEFA Euro qualification,2,7,0,3,0,3,-5,0
Finland,1983,Friendly,1,3,0,1,0,1,-2,0
Finland,1983,Nordic Championship,0,3,0,1,0,1,-3,0
Finland,1983,UEFA Euro qualification,1,7,0,2,1,3,-6,0
Finland,1984,FIFA World Cup qualification,4,8,2,2,0,4,-4,0
Finland,1984,Friendly,5,14,0,5,2,7,-9,0
Finland,1985,FIFA World Cup qualification,3,4,1,1,2,4,-1,0
Finland,1985,Friendly,5,14,0,6,0,6,-9,0
Finland,1986,Friendly,8,7,3,2,3,8,1,0
Finland,1986,UEFA Euro qualification,1,5,0,2,1,3,-4,0
Finland,1987,Friendly,3,6,0,2,0,2,-3,0
Finland,1987,UEFA Euro qualification,3,5,1,2,0,3,-2,0
Finland,1988,FIFA World Cup qualification,2,6,0,1,1,2,-4,0
Finland,1988,Friendly,4,5,1,2,4,7,-1,0
Finland,1988,Malta International Tournament,3,2,1,1,0,2,1,1
Finland,1989,FIFA World Cup qualification,2,10,1,3,0,4,-8,0
Finland,1989,Friendly,6,9,1,3,2,6,-3,0
Finland,1989,Malta International Tournament,0,2,0,1,2,3,-2,0
Finland,1990,Friendly,7,12,2,2,3,7,-5,0
Finland,1990,UEFA Euro qualification,1,1,0,0,2,2,0,0
Finland,1991,Friendly,1,1,0,0,1,1,0,0
Finland,1991,UEFA Euro qualification,4,7,1,3,2,6,-3,0
Finland,1992,FIFA World Cup qualification,1,6,0,3,0,3,-5,0
Finland,1992,Friendly,5,8,0,2,4,6,-3,0
Finland,1993,FIFA World Cup qualification,8,12,2,4,1,7,-4,0
Finland,1993,Four Nations Tournament,3,0,1,0,1,2,3,1
Finland,1993,Friendly,1,2,0,1,0,1,-1,0
Finland,1993,Nehru Cup,4,5,1,2,2,5,-1,0
Finland,1994,Friendly,12,10,2,5,3,10,2,0
Finland,1994,UEFA Euro qualification,9,7,2,2,0,4,2,0
Finland,1995,Friendly,4,9,0,3,2,5,-5,0
Finland,1995,UEFA Euro qualification,9,11,3,3,0,6,-2,0
Finland,1996,FIFA World Cup qualification,2,4,0,2,0,2,-2,0
Finland,1996,Friendly,4,6,1,2,2,5,-2,0
Finland,1996,King's Cup,2,6,0,2,0,2,-4,0
Finland,1997,Dunhill Cup,3,4,1,2,0,3,-1,0
Finland,1997,FIFA World Cup qualification,9,8,3,1,2,6,1,0
Finland,1997,Friendly,1,1,0,0,1,1,0,0
Finland,1998,Cyprus International Tournament,1,3,0,1,1,2,-2,0
Finland,1998,Friendly,3,2,1,1,3,5,1,0
Finland,1998,UEFA Euro qualification,6,4,2,1,0,3,2,0
Finland,1999,Cyprus International Tournament,2,4,0,2,0,2,-2,0
Finland,1999,Friendly,6,5,1,0,2,3,1,0
Finland,1999,UEFA Euro qualification,7,9,1,3,1,5,-2,0
Finland,2000,FIFA World Cup qualification,2,2,1,1,1,3,0,0
Finland,2000,Friendly,2,5,1,2,1,4,-3,0
Finland,2000,King's Cup,5,7,1,1,1,3,-2,0
Finland,2000,Nordic Championship,4,2,2,1,0,3,2,1
Finland,2001,FIFA World Cup qualification,10,5,2,1,2,5,5,0
Finland,2001,Friendly,13,7,4,1,2,7,6,0
Finland,2001,Nordic Championship,1,0,1,0,0,1,1,1
Finland,2002,Friendly,6,8,2,3,0,5,-2,0
Finland,2002,Prime Minister's Cup,6,1,2,0,1,3,5,0
Finland,2002,UEFA Euro qualification,3,4,1,2,0,3,-1,0
Finland,2003,Friendly,13,9,5,2,2,9,4,0
Finland,2003,UEFA Euro qualification,6,6,2,2,1,5,0,0
Finland,2004,FIFA World Cup qualification,10,6,3,2,0,5,4,0
Finland,2004,Friendly,5,10,1,5,0,6,-5,0
Finland,2004,Prime Minister's Cup,2,1,1,0,1,2,1,0
Finland,2005,Cyprus International Tournament,4,2,2,0,0,2,2,1
Finland,2005,FIFA World Cup qualification,11,13,2,4,1,7,-2,0
Finland,2005,Friendly,7,4,2,1,1,4,3,0
Finland,2006,Cyprus International Tournament,2,2,0,0,2,2,0,0
Finland,2006,Friendly,2,6,0,3,2,5,-4,0
Finland,2006,UEFA Euro qualification,7,2,3,0,2,5,5,1
Finland,2007,Friendly,0,0,0,0,1,1,0,0
Finland,2007,UEFA Euro qualification,6,5,3,2,4,9,1,0
Finland,2008,FIFA World Cup qualification,4,6,1,1,1,3,-2,0
Finland,2008,Friendly,5,8,1,4,1,6,-3,0
Finland,2009,FIFA World Cup qualification,10,8,4,1,2,7,2,0
Finland,2009,Friendly,3,10,0,4,0,4,-7,0
Finland,2010,Friendly,3,5,2,2,1,5,-2,0
Finland,2010,UEFA Euro qualification,10,6,1,3,0,4,4,1
Finland,2011,Friendly,4,5,1,2,1,4,-1,0
Finland,2011,UEFA Euro qualification,6,10,2,3,1,6,-4,0
Finland,2012,Baltic Cup,3,2,1,0,1,2,1,0
Finland,2012,FIFA World Cup qualification,1,2,0,1,1,2,-1,0
Finland,2012,Friendly,14,10,4,1,1,6,4,0
Finland,2013,FIFA World Cup qualification,4,7,2,2,2,6,-3,0
Finland,2013,Friendly,7,3,2,1,1,4,4,0
Finland,2013,King's Cup,3,4,1,1,0,2,-1,0
Finland,2014,Baltic Cup,2,1,1,1,0,2,1,1
Finland,2014,Friendly,5,5,1,1,2,4,0,0
Finland,2014,UEFA Euro qualification,4,5,1,2,1,4,-1,0
Finland,2015,Friendly,1,2,1,1,1,3,-1,0
Finland,2015,UEFA Euro qualification,5,5,2,2,2,6,0,0
Finland,2016,FIFA World Cup qualification,3,6,0,3,1,4,-3,0
Finland,2016,Friendly,1,16,0,6,1,7,-15,0
Finland,2017,FIFA World Cup qualification,6,7,2,2,2,6,-1,0
Finland,2017,Friendly,6,2,2,0,2,4,4,0
Finland,2018,Friendly,9,3,3,1,1,5,6,0
Finland,2018,UEFA Nations League,5,3,4,2,0,6,2,0
Finland,2019,Friendly,2,2,1,1,0,2,0,0
Finland,2019,UEFA Euro qualification,16,10,6,4,0,10,6,0
Finland,2020,Friendly,3,5,1,1,0,2,-2,0
Finland,2020,UEFA Nations League,7,5,4,2,0,6,2,0
Finland,2021,FIFA World Cup qualification,10,10,3,3,2,8,0,0
Finland,2021,Friendly,2,6,0,3,1,4,-4,0
Finland,2021,UEFA Euro,1,3,1,2,0,3,-2,0
Finland,2022,Friendly,3,5,0,1,3,4,-2,0
Finland,2022,UEFA Nations League,8,6,2,2,2,6,2,0
Finland,2023,Friendly,0,3,0,2,0,2,-3,0
Finland,2023,UEFA Euro qualification,18,10,6,4,0,10,8,0
Finland,2024,Friendly,6,7,1,1,1,3,-1,0
Finland,2024,UEFA Euro qualification,1,4,0,1,0,1,-3,0
Finland,2024,UEFA Nations League,2,13,0,6,0,6,-11,0
Finland,2025,FIFA World Cup qualification,3,2,1,0,1,2,1,0
France,1904,Évence Coppée Trophy,3,3,0,0,1,1,0,0
France,1905,Friendly,1,7,1,1,0,2,-6,0
France,1906,Friendly,0,5,0,1,0,1,-5,0
France,1907,Friendly,2,1,1,0,0,1,1,0
France,1908,Friendly,4,7,1,2,0,3,-3,0
France,1908,Olympic Games,1,17,0,1,0,1,-16,0
France,1909,Friendly,2,5,0,1,0,1,-3,0
France,1910,Friendly,2,10,0,2,0,2,-8,0
France,1911,Friendly,9,18,1,3,1,5,-9,0
France,1912,Friendly,16,6,3,1,1,5,10,0
France,1913,Friendly,13,4,3,1,0,4,9,0
France,1914,Friendly,11,17,1,3,1,5,-6,0
France,1919,Friendly,2,2,0,0,1,1,0,0
France,1919,Inter-Allied Games,19,3,3,1,0,4,16,0
France,1920,Friendly,8,10,2,1,0,3,-2,0
France,1920,Olympic Games,4,5,1,1,0,2,-1,0
France,1921,Friendly,2,10,0,3,0,3,-8,0
France,1922,Friendly,2,12,1,2,0,3,-10,0
France,1923,Friendly,5,23,0,5,1,6,-18,0
France,1924,Friendly,3,10,1,4,0,5,-7,0
France,1924,Olympic Games,8,5,1,1,0,2,3,0
France,1925,Friendly,2,14,0,3,0,3,-12,0
France,1926,Friendly,16,12,4,1,1,6,4,0
France,1927,Friendly,5,30,0,4,1,5,-25,0
France,1928,Friendly,11,15,1,4,1,6,-4,0
France,1928,Olympic Games,3,4,0,1,0,1,-1,0
France,1929,Friendly,9,19,2,4,0,6,-10,0
France,1930,FIFA World Cup,4,3,1,2,0,3,1,0
France,1930,Friendly,12,22,1,5,2,8,-10,0
France,1931,Friendly,10,13,2,3,0,5,-3,0
France,1932,Friendly,16,24,1,5,1,7,-8,0
France,1933,Friendly,9,16,2,3,2,7,-7,0
France,1934,FIFA World Cup,2,3,0,1,0,1,-1,0
France,1934,FIFA World Cup qualification,6,1,1,0,0,1,5,0
France,1934,Friendly,12,11,3,2,0,5,1,1
France,1935,Friendly,8,10,2,4,1,7,-2,0
France,1936,Friendly,5,9,2,2,0,4,-4,0
France,1937,Friendly,7,14,2,4,1,7,-7,0
France,1938,FIFA World Cup,4,4,1,1,0,2,0,0
France,1938,Friendly,13,9,2,2,0,4,4,0
France,1939,Friendly,11,4,3,0,1,4,7,0
France,1940,Friendly,3,2,1,0,0,1,1,0
France,1942,Friendly,0,6,0,2,0,2,-6,0
France,1944,Friendly,3,1,1,0,0,1,2,1
France,1945,Friendly,4,9,0,3,1,4,-5,0
France,1946,Friendly,9,4,3,1,0,4,5,0
France,1947,Friendly,15,8,5,1,0,6,7,0
France,1948,Friendly,13,10,2,2,1,5,3,0
France,1949,FIFA World Cup qualification,4,5,0,1,2,3,-1,0
France,1949,Friendly,8,16,2,4,0,6,-8,0
France,1950,Friendly,9,10,1,2,1,4,-1,0
France,1951,Friendly,11,13,2,2,3,7,-2,0
France,1952,Friendly,14,7,5,2,1,8,7,0
France,1953,FIFA World Cup qualification,20,4,4,0,0,4,16,0
France,1953,Friendly,9,9,1,3,0,4,0,0
France,1954,FIFA World Cup,3,3,1,1,0,2,0,0
France,1954,Friendly,9,9,1,1,2,4,0,0
France,1955,Friendly,11,7,4,1,2,7,4,0
France,1956,FIFA World Cup qualification,6,3,1,0,0,1,3,0
France,1956,Friendly,6,6,2,2,0,4,0,0
France,1957,FIFA World Cup qualification,13,1,2,0,1,3,12,0
France,1957,Friendly,2,8,0,2,1,3,-6,0
France,1958,FIFA World Cup,23,15,4,2,0,6,8,0
France,1958,Friendly,8,7,1,0,4,5,1,0
France,1958,UEFA Euro qualification,8,2,1,0,1,2,6,0
France,1959,Friendly,11,9,2,1,1,4,2,0
France,1959,UEFA Euro qualification,5,2,1,0,0,1,3,1
France,1960,FIFA World Cup qualification,5,1,2,0,0,2,4,0
France,1960,Friendly,10,10,1,3,1,5,0,0
France,1960,UEFA Euro,4,7,0,2,0,2,-3,0
France,1960,UEFA Euro qualification,4,2,1,0,0,1,2,0
France,1961,FIFA World Cup qualification,5,3,1,2,0,3,2,0
France,1961,Friendly,2,7,0,2,2,4,-5,0
France,1962,Friendly,6,10,0,3,1,4,-4,0
France,1962,UEFA Euro qualification,1,1,0,0,1,1,0,0
France,1963,African Friendship Games,13,4,4,1,0,5,9,0
France,1963,Friendly,5,8,0,3,2,5,-3,0
France,1963,UEFA Euro qualification,8,4,2,1,0,3,4,0
France,1964,FIFA World Cup qualification,3,0,2,0,0,2,3,0
France,1964,Friendly,0,3,0,1,0,1,-3,0
France,1964,UEFA Euro qualification,2,5,0,2,0,2,-3,0
France,1965,FIFA World Cup qualification,6,2,3,1,0,4,4,0
France,1965,Friendly,1,2,0,1,1,2,-1,0
France,1966,FIFA World Cup,2,5,0,2,1,3,-3,0
France,1966,Friendly,5,10,0,2,2,4,-5,0
France,1966,UEFA Euro qualification,6,3,2,1,0,3,3,0
France,1967,Friendly,4,13,0,4,0,4,-9,0
France,1967,UEFA Euro qualification,8,3,2,0,1,3,5,0
France,1968,FIFA World Cup qualification,0,1,0,1,0,1,-1,0
France,1968,Friendly,2,4,0,1,1,2,-2,0
France,1968,UEFA Euro qualification,2,6,0,1,1,2,-4,0
France,1969,FIFA World Cup qualification,6,3,2,1,0,3,3,0
France,1969,Friendly,3,7,1,1,1,3,-4,0
France,1970,Friendly,9,5,3,2,1,6,4,0
France,1970,UEFA Euro qualification,3,1,1,0,0,1,2,0
France,1971,Friendly,6,7,1,1,1,3,-1,0
France,1971,UEFA Euro qualification,7,7,2,2,1,5,0,0
France,1972,Brazil Independence Cup,3,2,1,0,1,2,1,0
France,1972,FIFA World Cup qualification,2,2,1,1,0,2,0,0
France,1972,Friendly,3,3,1,1,0,2,0,0
France,1973,FIFA World Cup qualification,1,3,0,1,1,2,-2,0
France,1973,Friendly,8,5,2,2,0,4,3,0
France,1974,Friendly,6,4,2,1,1,4,2,0
France,1974,UEFA Euro qualification,3,4,0,1,1,2,-1,0
France,1975,Friendly,2,2,1,1,0,2,0,0
France,1975,UEFA Euro qualification,4,2,1,1,2,4,2,0
France,1976,FIFA World Cup qualification,4,2,1,0,1,2,2,0
France,1976,Friendly,5,4,1,1,2,4,1,0
France,1977,FIFA World Cup qualification,3,2,1,1,0,2,1,0
France,1977,Friendly,9,2,3,0,3,6,7,0
France,1978,FIFA World Cup,5,5,1,2,0,3,0,0
France,1978,Friendly,10,3,5,0,1,6,7,0
France,1978,UEFA Euro qualification,5,3,1,0,1,2,2,0
France,1979,Friendly,9,0,2,0,0,2,9,0
France,1979,UEFA Euro qualification,8,4,3,1,0,4,4,0
France,1980,FIFA World Cup qualification,9,0,2,0,0,2,9,0
France,1980,Friendly,6,6,1,2,1,4,0,0
France,1981,FIFA World Cup qualification,11,8,3,3,0,6,3,0
France,1981,Friendly,1,4,0,2,0,2,-3,0
France,1982,FIFA World Cup,16,12,3,2,2,7,4,0
France,1982,Friendly,9,7,4,3,0,7,2,0
France,1983,Friendly,11,6,2,1,4,7,5,0
France,1984,FIFA World Cup qualification,7,0,3,0,0,3,7,0
France,1984,Friendly,6,0,4,0,0,4,6,0
France,1984,UEFA Euro,14,4,5,0,0,5,10,1
France,1985,CONMEBOL–UEFA Cup of Champions,2,0,1,0,0,1,2,1
France,1985,FIFA World Cup qualification,8,4,2,2,1,5,4,0
France,1986,FIFA World Cup,12,6,4,1,2,7,6,0
France,1986,Friendly,2,2,1,1,1,3,0,0
France,1986,UEFA Euro qualification,0,2,0,1,2,3,-2,0
France,1987,Friendly,1,2,0,1,0,1,-1,0
France,1987,UEFA Euro qualification,4,5,1,2,2,5,-1,0
France,1988,FIFA World Cup qualification,4,4,1,1,1,3,0,0
France,1988,Friendly,4,3,1,0,3,4,1,0
France,1988,Tournoi de France,4,2,2,0,0,2,2,1
France,1989,FIFA World Cup qualification,6,3,2,1,2,5,3,0
France,1989,Friendly,4,2,1,0,1,2,2,0
France,1990,Friendly,9,2,4,0,1,5,7,0
France,1990,UEFA Euro qualification,5,2,3,0,0,3,3,0
France,1991,Friendly,5,1,1,0,0,1,4,0
France,1991,UEFA Euro qualification,15,4,5,0,0,5,11,0
France,1992,FIFA World Cup qualification,4,3,2,1,0,3,1,0
France,1992,Friendly,5,10,0,3,2,5,-5,0
France,1992,UEFA Euro,2,3,0,1,2,3,-1,0
France,1993,FIFA World Cup qualification,13,7,4,2,1,7,6,0
France,1993,Friendly,3,1,1,0,0,1,2,0
France,1994,Friendly,6,3,2,0,1,3,3,0
France,1994,Kirin Cup,5,1,2,0,0,2,4,1
France,1994,UEFA Euro qualification,2,0,1,0,3,4,2,0
France,1995,Friendly,1,0,1,0,1,2,1,0
France,1995,UEFA Euro qualification,20,2,4,0,2,6,18,0
France,1996,Friendly,16,2,7,1,0,8,14,0
France,1996,UEFA Euro,5,2,2,0,3,5,3,0
France,1997,Friendly,9,3,5,0,0,5,6,0
France,1997,Tournoi de France,3,4,0,1,2,3,-1,0
France,1998,FIFA World Cup,15,2,6,0,1,7,13,1
France,1998,Friendly,7,6,2,1,3,6,1,0
France,1998,King Hassan II Tournament,3,2,1,0,1,2,1,0
France,1998,UEFA Euro qualification,6,3,2,0,1,3,3,0
France,1999,Friendly,7,0,4,0,0,4,7,0
France,1999,UEFA Euro qualification,11,7,4,1,2,7,4,0
France,2000,Friendly,14,4,5,0,3,8,10,0
France,2000,King Hassan II Tournament,7,3,1,0,1,2,4,1
France,2000,UEFA Euro,13,7,5,1,0,6,6,1
France,2001,Confederations Cup,12,2,4,1,0,5,10,1
France,2001,Friendly,18,6,5,2,1,8,12,0
France,2002,FIFA World Cup,0,3,0,2,1,3,-3,0
France,2002,Friendly,15,6,4,1,2,7,9,0
France,2002,UEFA Euro qualification,11,1,3,0,0,3,10,0
France,2003,Confederations Cup,12,3,5,0,0,5,9,1
France,2003,Friendly,10,2,3,1,0,4,8,0
France,2003,UEFA Euro qualification,18,1,5,0,0,5,17,0
France,2004,FIFA World Cup qualification,4,0,2,0,2,4,4,0
France,2004,Friendly,8,1,3,0,4,7,7,0
France,2004,UEFA Euro,7,5,2,1,1,4,2,0
France,2005,FIFA World Cup qualification,10,2,3,0,3,6,8,0
France,2005,Friendly,9,4,3,0,2,5,5,0
France,2006,FIFA World Cup,9,3,4,0,3,7,6,0
France,2006,Friendly,10,4,5,1,0,6,6,0
France,2006,UEFA Euro qualification,11,2,3,1,0,4,9,0
France,2007,Friendly,4,3,2,1,1,4,1,0
France,2007,UEFA Euro qualification,14,3,5,1,2,8,11,0
France,2008,FIFA World Cup qualification,5,6,1,1,1,3,-1,0
France,2008,Friendly,10,4,5,1,2,8,6,0
France,2008,UEFA Euro,1,6,0,2,1,3,-5,0
France,2009,FIFA World Cup qualification,15,4,6,0,3,9,11,0
France,2009,Friendly,1,3,1,2,0,3,-2,0
France,2010,FIFA World Cup,1,4,0,2,1,3,-3,0
France,2010,Friendly,6,8,2,3,1,6,-2,0
France,2010,UEFA Euro qualification,6,1,3,1,0,4,5,0
France,2011,Friendly,8,2,4,0,3,7,6,0
France,2011,UEFA Euro qualification,9,3,3,0,3,6,6,0
France,2012,FIFA World Cup qualification,5,2,2,0,1,3,3,0
France,2012,Friendly,13,5,5,1,1,7,8,0
France,2012,UEFA Euro,3,5,1,2,1,4,-2,0
France,2013,FIFA World Cup qualification,13,6,4,2,1,7,7,0
France,2013,Friendly,7,6,1,3,1,5,1,0
France,2014,FIFA World Cup,10,3,3,1,1,5,7,0
France,2014,Friendly,24,4,7,0,3,10,20,0
France,2015,Friendly,17,12,6,4,0,10,5,0
France,2016,FIFA World Cup qualification,7,2,3,0,1,4,5,0
France,2016,Friendly,16,7,5,0,1,6,9,0
France,2016,UEFA Euro,13,5,5,1,1,7,8,0
France,2017,FIFA World Cup qualification,11,4,4,1,1,6,7,0
France,2017,Friendly,12,6,3,1,1,5,6,0
France,2018,FIFA World Cup,14,6,6,0,1,7,8,1
France,2018,Friendly,14,8,4,1,2,7,6,0
France,2018,UEFA Nations League,4,4,2,1,1,4,0,0
France,2019,Friendly,2,0,1,0,0,1,2,0
France,2019,UEFA Euro qualification,25,6,8,1,1,10,19,0
France,2020,Friendly,7,3,1,1,0,2,4,0
France,2020,UEFA Nations League,12,5,5,0,1,6,7,0
France,2021,FIFA World Cup qualification,18,3,5,0,3,8,15,0
France,2021,Friendly,6,0,2,0,0,2,6,0
France,2021,UEFA Euro,7,6,1,0,3,4,1,0
France,2021,UEFA Nations League,5,3,2,0,0,2,2,1
France,2022,FIFA World Cup,16,8,5,1,1,7,8,0
France,2022,Friendly,7,1,2,0,0,2,6,0
France,2022,UEFA Nations League,5,7,1,3,2,6,-2,0
France,2023,Friendly,5,3,1,1,0,2,2,0
France,2023,UEFA Euro qualification,29,3,7,0,1,8,26,0
France,2024,Friendly,6,4,2,1,1,4,2,0
France,2024,UEFA Euro,4,3,2,1,3,6,1,0
France,2024,UEFA Nations League,12,6,4,1,1,6,6,0
France,2025,UEFA Nations League,2,2,1,1,0,2,0,0
Franconia,2014,Friendly,4,2,1,0,0,1,2,0
Franconia,2015,Benedikt Fontana Cup,0,6,0,1,0,1,-6,0
Franconia,2019,Friendly,4,3,1,0,0,1,1,0
French Guiana,1936,Friendly,1,3,0,1,0,1,-2,0
French Guiana,1947,Friendly,1,9,0,1,0,1,-8,0
French Guiana,1948,Friendly,7,13,1,2,0,3,-6,0
French Guiana,1949,Friendly,1,7,0,2,0,2,-6,0
French Guiana,1962,Friendly,2,4,0,1,0,1,-2,0
French Guiana,1964,Friendly,6,4,1,0,1,2,2,0
French Guiana,1965,Friendly,0,12,0,2,0,2,-12,0
French Guiana,1966,Friendly,3,6,0,1,1,2,-3,0
French Guiana,1967,Friendly,2,11,0,3,0,3,-9,0
French Guiana,1968,Friendly,1,2,0,1,0,1,-1,0
French Guiana,1969,Friendly,5,5,1,1,2,4,0,0
French Guiana,1970,Friendly,2,3,0,1,0,1,-1,0
French Guiana,1975,Friendly,1,2,0,1,0,1,-1,0
French Guiana,1978,CFU Caribbean Cup qualification,5,6,1,1,0,2,-1,0
French Guiana,1978,Friendly,4,2,1,0,0,1,2,0
French Guiana,1981,CFU Caribbean Cup qualification,4,5,1,2,0,3,-1,0
French Guiana,1983,CFU Caribbean Cup,1,1,1,1,1,3,0,0
French Guiana,1985,CFU Caribbean Cup qualification,0,2,0,2,0,2,-2,0
French Guiana,1986,Friendly,0,0,0,0,1,1,0,0
French Guiana,1987,CFU Caribbean Cup qualification,1,2,0,1,1,2,-1,0
French Guiana,1987,Friendly,1,4,0,1,0,1,-3,0
French Guiana,1989,CFU Caribbean Cup qualification,5,4,1,2,1,4,1,0
French Guiana,1990,CFU Caribbean Cup qualification,3,7,0,1,2,3,-4,0
French Guiana,1991,CFU Caribbean Cup qualification,2,2,1,1,0,2,0,0
French Guiana,1991,Friendly,0,3,0,1,0,1,-3,0
French Guiana,1992,CFU Caribbean Cup qualification,5,4,1,1,1,3,1,0
French Guiana,1993,CFU Caribbean Cup qualification,3,3,1,1,0,2,0,0
French Guiana,1994,CFU Caribbean Cup qualification,1,2,0,1,1,2,-1,0
French Guiana,1995,CFU Caribbean Cup,2,6,0,3,0,3,-4,0
French Guiana,1995,CFU Caribbean Cup qualification,7,5,1,1,1,3,2,0
French Guiana,1996,CFU Caribbean Cup qualification,2,3,0,1,1,2,-1,0
French Guiana,1997,CFU Caribbean Cup qualification,2,4,0,1,1,2,-2,0
French Guiana,1998,CFU Caribbean Cup qualification,3,5,0,2,1,3,-2,0
French Guiana,1999,CFU Caribbean Cup qualification,1,3,0,1,0,1,-2,0
French Guiana,2002,Friendly,1,2,0,1,1,2,-1,0
French Guiana,2003,Friendly,3,5,0,2,1,3,-2,0
French Guiana,2004,CFU Caribbean Cup qualification,5,0,2,0,1,3,5,0
French Guiana,2004,Friendly,2,1,1,0,0,1,1,0
French Guiana,2005,CFU Caribbean Cup qualification,0,5,0,1,1,2,-5,0
French Guiana,2007,Friendly,2,3,0,1,0,1,-1,0
French Guiana,2008,Coupe de l'Outre-Mer,4,8,1,2,0,3,-4,0
French Guiana,2008,Friendly,2,4,0,2,0,2,-2,0
French Guiana,2009,Friendly,9,9,3,2,1,6,0,0
French Guiana,2010,Coupe de l'Outre-Mer,9,3,1,1,1,3,6,0
French Guiana,2010,Friendly,1,2,0,1,0,1,-1,0
French Guiana,2012,CFU Caribbean Cup,4,6,1,2,0,3,-2,0
French Guiana,2012,CFU Caribbean Cup qualification,13,10,3,2,1,6,3,0
French Guiana,2012,Coupe de l'Outre-Mer,15,8,2,2,0,4,7,0
French Guiana,2012,Friendly,4,5,2,2,0,4,-1,0
French Guiana,2014,CFU Caribbean Cup,7,6,1,1,1,3,1,0
French Guiana,2014,CFU Caribbean Cup qualification,22,6,5,1,3,9,16,1
French Guiana,2014,Friendly,2,5,0,3,1,4,-3,0
French Guiana,2015,Gold Cup qualification,3,4,1,1,0,2,-1,0
French Guiana,2016,CFU Caribbean Cup qualification,14,6,4,2,0,6,8,0
French Guiana,2016,Friendly,2,3,0,1,0,1,-1,0
French Guiana,2017,CFU Caribbean Cup,2,1,1,0,1,2,1,0
French Guiana,2017,Friendly,3,0,1,0,0,1,3,0
French Guiana,2017,Gold Cup,2,7,0,2,1,3,-5,0
French Guiana,2018,CONCACAF Nations League qualification,7,2,2,1,0,3,5,0
French Guiana,2018,Friendly,2,3,1,1,0,2,-1,0
French Guiana,2019,CONCACAF Nations League,8,6,2,2,2,6,2,0
French Guiana,2019,CONCACAF Nations League qualification,1,4,0,1,0,1,-3,0
French Guiana,2021,Gold Cup qualification,4,1,1,0,1,2,3,0
French Guiana,2022,CONCACAF Nations League,7,3,3,0,1,4,4,0
French Guiana,2023,CONCACAF Nations League,11,11,3,3,2,8,0,0
French Guiana,2023,Gold Cup qualification,5,2,1,0,1,2,3,0
French Guiana,2024,CONCACAF Nations League,7,11,0,4,2,6,-4,0
Frøya,1997,Island Games,8,12,2,3,0,5,-4,0
Frøya,1999,Island Games,10,19,1,4,0,5,-9,0
Frøya,2003,Island Games,19,10,1,2,1,4,9,0
Frøya,2007,Island Games,5,11,1,3,0,4,-6,0
Frøya,2009,Island Games,3,20,1,3,0,4,-17,0
Frøya,2013,Island Games,1,28,0,4,0,4,-27,0
Frøya,2017,Island Games,7,17,0,3,1,4,-10,0
Frøya,2023,Island Games,6,7,1,2,0,3,-1,0
Gabon,1960,African Friendship Games,4,5,0,1,0,1,-1,0
Gabon,1960,Friendly,4,5,0,1,0,1,-1,0
Gabon,1961,African Friendship Games,2,9,0,2,0,2,-7,0
Gabon,1962,Friendly,5,5,1,1,1,3,0,0
Gabon,1963,African Friendship Games,6,5,1,1,1,3,1,0
Gabon,1965,Friendly,3,6,0,1,1,2,-3,0
Gabon,1966,Friendly,3,4,0,1,0,1,-1,0
Gabon,1967,Friendly,1,3,1,1,0,2,-2,0
Gabon,1969,Friendly,0,1,0,1,0,1,-1,0
Gabon,1970,African Cup of Nations qualification,1,3,0,2,0,2,-2,0
Gabon,1970,Friendly,4,1,1,0,1,2,3,0
Gabon,1976,Friendly,10,11,2,3,1,6,-1,0
Gabon,1977,African Cup of Nations qualification,5,6,0,1,1,2,-1,0
Gabon,1977,Friendly,3,8,0,2,1,3,-5,0
Gabon,1978,Friendly,2,3,0,1,1,2,-1,0
Gabon,1979,Friendly,5,7,1,2,1,4,-2,0
Gabon,1980,Friendly,2,8,0,2,1,3,-6,0
Gabon,1982,African Cup of Nations qualification,2,6,0,1,1,2,-4,0
Gabon,1983,Friendly,2,3,0,1,1,2,-1,0
Gabon,1984,African Cup of Nations qualification,1,3,0,1,1,2,-2,0
Gabon,1984,Friendly,1,1,0,0,1,1,0,0
Gabon,1984,UDEAC Cup,5,8,0,1,3,4,-3,0
Gabon,1985,UDEAC Cup,11,0,4,0,0,4,11,1
Gabon,1986,African Cup of Nations qualification,1,1,1,1,0,2,0,0
Gabon,1986,Friendly,0,2,0,2,0,2,-2,0
Gabon,1986,UDEAC Cup,2,0,2,0,1,3,2,0
Gabon,1987,Friendly,1,0,1,0,1,2,1,0
Gabon,1987,UDEAC Cup,2,3,0,1,3,4,-1,0
Gabon,1988,African Cup of Nations qualification,3,1,1,1,0,2,2,0
Gabon,1988,Friendly,3,9,0,2,0,2,-6,0
Gabon,1988,UDEAC Cup,4,0,2,0,2,4,4,1
Gabon,1989,African Cup of Nations qualification,3,5,2,2,0,4,-2,0
Gabon,1989,FIFA World Cup qualification,5,9,2,4,0,6,-4,0
Gabon,1989,Friendly,1,2,1,1,1,3,-1,0
Gabon,1989,UDEAC Cup,4,3,2,2,0,4,1,0
Gabon,1990,African Cup of Nations qualification,1,0,1,0,1,2,1,0
Gabon,1990,Friendly,0,2,0,1,1,2,-2,0
Gabon,1990,UDEAC Cup,3,5,1,3,0,4,-2,0
Gabon,1991,African Cup of Nations qualification,2,2,1,1,2,4,0,0
Gabon,1991,Friendly,0,1,0,1,0,1,-1,0
Gabon,1992,African Cup of Nations qualification,3,1,1,0,1,2,2,0
Gabon,1992,FIFA World Cup qualification,6,3,2,0,0,2,3,0
Gabon,1992,Friendly,2,1,2,1,0,3,1,0
Gabon,1993,African Cup of Nations qualification,7,1,3,0,1,4,6,0
Gabon,1993,FIFA World Cup qualification,1,2,0,1,1,2,-1,0
Gabon,1993,Friendly,5,15,0,6,1,7,-10,0
Gabon,1994,African Cup of Nations,0,7,0,2,0,2,-7,0
Gabon,1994,African Cup of Nations qualification,5,1,2,0,0,2,4,1
Gabon,1994,Friendly,3,3,1,1,1,3,0,0
Gabon,1995,African Cup of Nations qualification,3,1,1,1,0,2,2,0
Gabon,1995,Friendly,18,8,5,2,1,8,10,0
Gabon,1996,African Cup of Nations,4,3,1,1,1,3,1,0
Gabon,1996,African Cup of Nations qualification,0,0,0,0,1,1,0,0
Gabon,1996,FIFA World Cup qualification,4,1,2,0,1,3,3,0
Gabon,1996,Friendly,12,9,4,2,4,10,3,0
Gabon,1997,African Cup of Nations qualification,4,3,1,0,2,3,1,0
Gabon,1997,FIFA World Cup qualification,0,10,0,4,0,4,-10,0
Gabon,1997,Friendly,2,1,1,0,0,1,1,0
Gabon,1998,African Cup of Nations qualification,7,0,3,0,0,3,7,0
Gabon,1999,African Cup of Nations qualification,8,10,2,2,1,5,-2,0
Gabon,1999,Friendly,9,11,3,3,2,8,-2,0
Gabon,1999,UNIFFAC Cup,8,0,4,0,1,5,8,0
Gabon,2000,African Cup of Nations,2,6,0,2,1,3,-4,0
Gabon,2000,African Cup of Nations qualification,9,6,2,1,1,4,3,0
Gabon,2000,FIFA World Cup qualification,1,2,1,1,0,2,-1,0
Gabon,2000,Friendly,3,6,0,2,1,3,-3,0
Gabon,2001,African Cup of Nations qualification,4,4,1,1,2,4,0,0
Gabon,2001,Friendly,2,0,1,0,0,1,2,0
Gabon,2002,African Cup of Nations qualification,0,3,0,2,0,2,-3,0
Gabon,2002,Friendly,0,1,0,1,1,2,-1,0
Gabon,2003,African Cup of Nations qualification,7,4,2,2,0,4,3,0
Gabon,2003,FIFA World Cup qualification,4,1,1,0,1,2,3,0
Gabon,2003,Friendly,9,3,2,0,3,5,6,0
Gabon,2004,FIFA World Cup qualification,8,7,1,1,3,5,1,0
Gabon,2004,Friendly,2,2,1,1,0,2,0,0
Gabon,2005,FIFA World Cup qualification,3,6,1,3,1,5,-3,0
Gabon,2005,Friendly,0,1,0,1,1,2,-1,0
Gabon,2006,African Cup of Nations qualification,4,5,1,1,0,2,-1,0
Gabon,2006,Friendly,2,6,1,1,0,2,-4,0
Gabon,2007,African Cup of Nations qualification,2,0,1,0,1,2,2,0
Gabon,2007,Friendly,5,2,1,0,1,2,3,0
Gabon,2008,FIFA World Cup qualification,8,3,4,2,0,6,5,0
Gabon,2008,Friendly,4,3,1,0,2,3,1,0
Gabon,2009,FIFA World Cup qualification,9,7,3,3,0,6,2,0
Gabon,2009,Friendly,1,1,0,0,1,1,0,0
Gabon,2010,African Cup of Nations,2,2,1,1,1,3,0,0
Gabon,2010,Corsica Cup,4,1,1,0,1,2,3,0
Gabon,2010,Friendly,6,6,2,3,1,6,0,0
Gabon,2011,Friendly,7,6,3,3,1,7,1,0
Gabon,2012,African Cup of Nations,7,3,3,0,1,4,4,0
Gabon,2012,African Cup of Nations qualification,2,3,0,1,1,2,-1,0
Gabon,2012,FIFA World Cup qualification,1,3,1,1,0,2,-2,0
Gabon,2012,Friendly,3,5,1,1,3,5,-2,0
Gabon,2013,FIFA World Cup qualification,4,3,1,2,1,4,1,0
Gabon,2013,Friendly,2,2,0,0,3,3,0,0
Gabon,2014,African Cup of Nations qualification,9,4,3,0,3,6,5,0
Gabon,2014,Friendly,1,5,0,3,1,4,-4,0
Gabon,2015,African Cup of Nations,2,3,1,2,0,3,-1,0
Gabon,2015,FIFA World Cup qualification,1,1,1,1,0,2,0,0
Gabon,2015,Friendly,15,12,3,3,4,10,3,0
Gabon,2016,FIFA World Cup qualification,0,0,0,0,2,2,0,0
Gabon,2016,Friendly,7,10,2,4,1,7,-3,0
Gabon,2017,African Cup of Nations,2,2,0,0,3,3,0,0
Gabon,2017,African Cup of Nations qualification,1,2,0,1,0,1,-1,0
Gabon,2017,FIFA World Cup qualification,2,7,1,2,1,4,-5,0
Gabon,2017,Friendly,2,3,0,1,3,4,-1,0
Gabon,2018,African Cup of Nations qualification,5,2,2,1,1,4,3,0
Gabon,2018,Friendly,0,1,0,1,1,2,-1,0
Gabon,2019,African Cup of Nations qualification,3,2,1,0,2,3,1,0
Gabon,2019,Friendly,4,2,2,0,0,2,2,0
Gabon,2020,African Cup of Nations qualification,3,3,1,1,0,2,0,0
Gabon,2020,Friendly,0,2,0,1,0,1,-2,0
Gabon,2021,African Cup of Nations qualification,3,2,1,1,0,2,1,0
Gabon,2021,FIFA World Cup qualification,7,8,2,3,1,6,-1,0
Gabon,2022,African Cup of Nations,5,4,1,0,3,4,1,0
Gabon,2022,African Cup of Nations qualification,1,0,1,0,1,2,1,0
Gabon,2022,Friendly,7,6,2,1,1,4,1,0
Gabon,2023,African Cup of Nations qualification,2,5,1,3,0,4,-3,0
Gabon,2023,FIFA World Cup qualification,4,2,2,0,0,2,2,0
Gabon,2023,Friendly,1,1,0,0,1,1,0,0
Gabon,2024,African Cup of Nations qualification,5,4,2,1,1,4,1,0
Gabon,2024,FIFA World Cup qualification,3,3,1,1,0,2,0,0
Gabon,2024,Friendly,1,4,0,1,1,2,-3,0
Gabon,2025,FIFA World Cup qualification,5,1,2,0,0,2,4,0
Galicia,1922,Friendly,4,1,1,0,0,1,3,0
Galicia,1923,Friendly,5,5,1,2,0,3,0,0
Galicia,2005,Friendly,3,2,1,0,0,1,1,0
Galicia,2006,Friendly,1,1,0,0,1,1,0,0
Galicia,2007,Friendly,1,1,0,0,1,1,0,0
Galicia,2008,Friendly,3,2,1,0,0,1,1,0
Galicia,2013,Friendly,1,7,0,1,0,1,-6,0
Galicia,2016,Friendly,1,1,0,0,1,1,0,0
Gambia,1953,Friendly,3,5,1,2,0,3,-2,0
Gambia,1956,Friendly,0,1,0,1,0,1,-1,0
Gambia,1959,Friendly,3,2,1,0,0,1,1,0
Gambia,1960,Friendly,2,3,0,1,0,1,-1,0
Gambia,1961,Friendly,3,2,1,0,0,1,1,0
Gambia,1963,African Friendship Games,5,9,0,1,2,3,-4,0
Gambia,1968,Friendly,1,2,0,1,0,1,-1,0
Gambia,1969,Friendly,2,6,0,1,0,1,-4,0
Gambia,1971,Friendly,3,7,0,2,0,2,-4,0
Gambia,1973,Friendly,2,1,1,0,0,1,1,0
Gambia,1974,African Cup of Nations qualification,0,6,0,2,0,2,-6,0
Gambia,1975,Friendly,0,1,0,1,0,1,-1,0
Gambia,1976,Friendly,3,4,1,1,0,2,-1,0
Gambia,1977,Friendly,1,4,0,1,0,1,-3,0
Gambia,1978,Friendly,1,7,0,1,0,1,-6,0
Gambia,1979,African Cup of Nations qualification,1,2,1,1,0,2,-1,0
Gambia,1979,Amílcar Cabral Cup,4,3,1,1,1,3,1,0
Gambia,1979,Friendly,4,6,1,2,1,4,-2,0
Gambia,1980,African Cup of Nations qualification,1,1,0,0,2,2,0,0
Gambia,1980,Amílcar Cabral Cup,4,3,1,1,2,4,1,0
Gambia,1980,FIFA World Cup qualification,1,2,0,1,1,2,-1,0
Gambia,1981,Amílcar Cabral Cup,2,5,0,1,1,2,-3,0
Gambia,1982,African Cup of Nations qualification,2,3,1,1,0,2,-1,0
Gambia,1982,Amílcar Cabral Cup,4,4,1,1,1,3,0,0
Gambia,1983,Amílcar Cabral Cup,7,5,1,1,1,3,2,0
Gambia,1983,Friendly,2,2,1,1,1,3,0,0
Gambia,1984,African Cup of Nations qualification,3,4,1,1,0,2,-1,0
Gambia,1984,Amílcar Cabral Cup,4,6,1,3,1,5,-2,0
Gambia,1984,FIFA World Cup qualification,3,6,1,1,0,2,-3,0
Gambia,1984,Friendly,7,9,2,3,4,9,-2,0
Gambia,1985,Amílcar Cabral Cup,4,4,2,2,1,5,0,0
Gambia,1985,Friendly,0,1,0,1,1,2,-1,0
Gambia,1986,African Cup of Nations qualification,1,3,0,2,0,2,-2,0
Gambia,1986,Amílcar Cabral Cup,7,4,2,2,0,4,3,0
Gambia,1988,Amílcar Cabral Cup,2,10,0,3,0,3,-8,0
Gambia,1988,Friendly,2,3,1,1,1,3,-1,0
Gambia,1990,African Cup of Nations qualification,2,3,1,1,0,2,-1,0
Gambia,1990,Friendly,0,1,0,1,1,2,-1,0
Gambia,1991,Amílcar Cabral Cup,1,2,1,1,2,4,-1,0
Gambia,1991,Friendly,3,5,0,2,1,3,-2,0
Gambia,1993,Amílcar Cabral Cup,5,4,2,1,1,4,1,1
Gambia,1993,Friendly,5,4,1,1,0,2,1,0
Gambia,1994,Friendly,0,0,0,0,1,1,0,0
Gambia,1995,Amílcar Cabral Cup,1,3,0,2,0,2,-2,0
Gambia,1996,FIFA World Cup qualification,2,5,1,1,0,2,-3,0
Gambia,1996,Friendly,2,3,0,1,1,2,-1,0
Gambia,1997,Amílcar Cabral Cup,8,6,2,1,2,5,2,0
Gambia,1998,Friendly,0,2,0,1,0,1,-2,0
Gambia,1999,Friendly,0,3,0,1,1,2,-3,0
Gambia,2000,African Cup of Nations qualification,2,4,0,1,1,2,-2,0
Gambia,2000,Amílcar Cabral Cup,4,4,0,0,3,3,0,0
Gambia,2000,FIFA World Cup qualification,0,3,0,2,0,2,-3,0
Gambia,2000,Friendly,0,0,0,0,2,2,0,0
Gambia,2001,Amílcar Cabral Cup,2,1,1,0,1,2,1,0
Gambia,2001,Friendly,1,3,0,1,2,3,-2,0
Gambia,2002,African Cup of Nations qualification,6,0,1,0,0,1,6,0
Gambia,2002,Friendly,2,7,2,2,0,4,-5,0
Gambia,2003,African Cup of Nations qualification,1,4,0,2,1,3,-3,0
Gambia,2003,FIFA World Cup qualification,2,3,1,1,0,2,-1,0
Gambia,2003,Friendly,4,2,1,1,0,2,2,0
Gambia,2005,Friendly,2,4,0,2,0,2,-2,0
Gambia,2006,African Cup of Nations qualification,2,1,1,1,0,2,1,0
Gambia,2007,African Cup of Nations qualification,4,5,1,1,2,4,-1,0
Gambia,2007,Amílcar Cabral Cup,0,0,0,0,1,1,0,0
Gambia,2007,Friendly,3,6,1,2,0,3,-3,0
Gambia,2008,FIFA World Cup qualification,6,3,2,1,3,6,3,0
Gambia,2010,African Cup of Nations qualification,4,4,1,1,0,2,0,0
Gambia,2010,Friendly,4,7,1,1,1,3,-3,0
Gambia,2011,African Cup of Nations qualification,1,2,0,1,1,2,-1,0
Gambia,2011,Friendly,7,7,2,3,0,5,0,0
Gambia,2012,African Cup of Nations qualification,2,6,0,2,0,2,-4,0
Gambia,2012,FIFA World Cup qualification,2,3,0,1,1,2,-1,0
Gambia,2012,Friendly,1,1,0,0,1,1,0,0
Gambia,2013,FIFA World Cup qualification,2,8,1,3,0,4,-6,0
Gambia,2013,Friendly,0,2,0,1,1,2,-2,0
Gambia,2015,African Cup of Nations qualification,0,1,0,1,1,2,-1,0
Gambia,2015,FIFA World Cup qualification,2,3,0,1,1,2,-1,0
Gambia,2015,Friendly,2,1,1,0,1,2,1,0
Gambia,2016,African Cup of Nations qualification,1,8,0,3,1,4,-7,0
Gambia,2016,Friendly,0,0,0,0,1,1,0,0
Gambia,2017,African Cup of Nations qualification,0,1,0,1,0,1,-1,0
Gambia,2017,Friendly,3,1,2,0,1,3,2,0
Gambia,2018,African Cup of Nations qualification,5,4,1,1,2,4,1,0
Gambia,2018,Friendly,1,1,0,0,1,1,0,0
Gambia,2019,African Cup of Nations qualification,8,6,1,0,4,5,2,0
Gambia,2019,FIFA World Cup qualification,1,3,0,2,0,2,-2,0
Gambia,2019,Friendly,1,0,1,0,0,1,1,0
Gambia,2020,African Cup of Nations qualification,3,3,1,1,0,2,0,0
Gambia,2020,Friendly,1,0,1,0,0,1,1,0
Gambia,2021,African Cup of Nations qualification,1,1,1,1,0,2,0,0
Gambia,2021,Friendly,6,6,3,3,0,6,0,0
Gambia,2022,African Cup of Nations,4,3,3,1,1,5,1,0
Gambia,2022,African Cup of Nations qualification,4,3,2,1,1,4,1,0
Gambia,2022,Friendly,1,1,0,0,2,2,0,0
Gambia,2023,African Cup of Nations qualification,6,6,2,1,1,4,0,0
Gambia,2023,FIFA World Cup qualification,2,5,0,2,0,2,-3,0
Gambia,2024,African Cup of Nations,2,7,0,3,0,3,-5,0
Gambia,2024,African Cup of Nations qualification,4,4,1,1,2,4,0,0
Gambia,2024,FIFA World Cup qualification,7,4,1,1,0,2,3,0
Gambia,2025,FIFA World Cup qualification,3,4,0,1,1,2,-1,0
Georgia,1979,Friendly,5,0,1,0,0,1,5,0
Georgia,1990,Friendly,2,2,0,0,1,1,0,0
Georgia,1991,Friendly,4,2,1,0,0,1,2,0
Georgia,1992,Friendly,6,5,1,2,0,3,1,0
Georgia,1993,Friendly,0,1,0,1,0,1,-1,0
Georgia,1994,Friendly,5,9,1,2,1,4,-4,0
Georgia,1994,Malta International Tournament,3,1,2,1,0,3,2,0
Georgia,1994,UEFA Euro qualification,6,3,2,2,0,4,3,0
Georgia,1995,UEFA Euro qualification,8,10,3,3,0,6,-2,0
Georgia,1996,FIFA World Cup qualification,0,3,0,2,0,2,-3,0
Georgia,1996,Friendly,7,15,1,5,0,6,-8,0
Georgia,1997,FIFA World Cup qualification,7,6,3,2,1,6,1,0
Georgia,1997,Friendly,7,0,1,0,0,1,7,0
Georgia,1998,Friendly,5,8,1,2,2,5,-3,0
Georgia,1998,Malta International Tournament,8,2,3,0,0,3,6,1
Georgia,1998,UEFA Euro qualification,1,4,1,2,0,3,-3,0
Georgia,1999,Friendly,0,1,0,1,0,1,-1,0
Georgia,1999,UEFA Euro qualification,7,14,0,5,2,7,-7,0
Georgia,2000,Cyprus International Tournament,3,2,1,0,1,2,1,0
Georgia,2000,FIFA World Cup qualification,4,2,1,1,0,2,2,0
Georgia,2000,Friendly,2,4,0,2,3,5,-2,0
Georgia,2001,FIFA World Cup qualification,8,10,2,3,1,6,-2,0
Georgia,2001,Friendly,7,2,3,0,1,4,5,0
Georgia,2002,Friendly,5,6,1,2,0,3,-1,0
Georgia,2002,UEFA Euro qualification,1,4,0,1,0,1,-3,0
Georgia,2003,Friendly,2,2,0,0,1,1,0,0
Georgia,2003,UEFA Euro qualification,7,10,2,4,1,7,-3,0
Georgia,2004,Cyprus International Tournament,1,8,0,3,0,3,-7,0
Georgia,2004,FIFA World Cup qualification,5,5,1,1,2,4,0,0
Georgia,2004,Friendly,0,2,0,2,0,2,-2,0
Georgia,2005,FIFA World Cup qualification,9,20,1,5,2,8,-11,0
Georgia,2005,Friendly,6,8,2,1,0,3,-2,0
Georgia,2006,Friendly,3,6,1,3,1,5,-3,0
Georgia,2006,Malta International Tournament,2,0,1,0,0,1,2,1
Georgia,2006,UEFA Euro qualification,9,9,1,3,0,4,0,0
Georgia,2007,Friendly,4,2,2,0,2,4,2,0
Georgia,2007,UEFA Euro qualification,7,10,2,5,1,8,-3,0
Georgia,2008,FIFA World Cup qualification,2,5,0,2,2,4,-3,0
Georgia,2008,Friendly,6,13,1,4,1,6,-7,0
Georgia,2009,FIFA World Cup qualification,5,14,0,5,1,6,-9,0
Georgia,2009,Friendly,3,8,0,3,1,4,-5,0
Georgia,2010,Friendly,4,2,2,0,2,4,2,0
Georgia,2010,UEFA Euro qualification,3,2,1,0,3,4,1,0
Georgia,2011,Friendly,4,2,2,1,0,3,2,0
Georgia,2011,UEFA Euro qualification,4,7,1,4,1,6,-3,0
Georgia,2012,FIFA World Cup qualification,2,4,1,2,1,4,-2,0
Georgia,2012,Friendly,5,5,2,1,1,4,0,0
Georgia,2013,FIFA World Cup qualification,1,6,0,3,1,4,-5,0
Georgia,2013,Friendly,3,8,1,3,0,4,-5,0
Georgia,2014,Friendly,4,1,2,1,0,3,3,0
Georgia,2014,UEFA Euro qualification,4,7,1,3,0,4,-3,0
Georgia,2015,Friendly,5,7,1,2,1,4,-2,0
Georgia,2015,UEFA Euro qualification,6,9,2,4,0,6,-3,0
Georgia,2016,FIFA World Cup qualification,3,5,0,2,2,4,-2,0
Georgia,2016,Friendly,4,9,1,2,1,4,-5,0
Georgia,2017,FIFA World Cup qualification,5,9,0,3,3,6,-4,0
Georgia,2017,Friendly,13,5,3,1,2,6,8,0
Georgia,2018,Friendly,7,1,3,1,0,4,6,0
Georgia,2018,UEFA Nations League,12,2,5,0,1,6,10,0
Georgia,2019,Friendly,3,4,0,1,1,2,-1,0
Georgia,2019,UEFA Euro qualification,7,11,2,4,2,8,-4,0
Georgia,2020,UEFA Euro qualification,1,1,1,1,0,2,0,0
Georgia,2020,UEFA Nations League,6,6,1,1,4,6,0,0
Georgia,2021,FIFA World Cup qualification,6,12,2,5,1,8,-6,0
Georgia,2021,Friendly,4,8,2,2,0,4,-4,0
Georgia,2022,Friendly,1,3,1,1,1,3,-2,0
Georgia,2022,UEFA Nations League,16,3,5,0,1,6,13,0
Georgia,2023,Friendly,14,1,2,0,0,2,13,0
Georgia,2023,UEFA Euro qualification,12,18,2,4,2,8,-6,0
Georgia,2024,Friendly,3,1,1,0,0,1,2,0
Georgia,2024,UEFA Euro,5,8,1,2,1,4,-3,0
Georgia,2024,UEFA Euro qualification,2,0,1,0,1,2,2,0
Georgia,2024,UEFA Nations League,7,6,2,3,1,6,1,0
Georgia,2025,UEFA Nations League,9,1,2,0,0,2,8,0
German DR,1952,Friendly,1,11,0,3,0,3,-10,0
German DR,1953,Friendly,0,0,0,0,1,1,0,0
German DR,1954,Friendly,1,5,0,3,0,3,-4,0
German DR,1955,Friendly,4,2,2,0,0,2,2,0
German DR,1956,Friendly,6,4,2,1,0,3,2,0
German DR,1957,FIFA World Cup qualification,5,12,1,3,0,4,-7,0
German DR,1957,Friendly,3,0,1,0,0,1,3,0
German DR,1958,Friendly,15,12,2,1,3,6,3,0
German DR,1959,Friendly,6,7,1,2,1,4,-1,0
German DR,1959,UEFA Euro qualification,2,5,0,2,0,2,-3,0
German DR,1960,Friendly,11,6,3,2,0,5,5,0
German DR,1961,FIFA World Cup qualification,3,6,0,2,1,3,-3,0
German DR,1961,Friendly,3,8,0,3,1,4,-5,0
German DR,1962,Friendly,16,13,4,2,1,7,3,0
German DR,1962,UEFA Euro qualification,2,1,1,0,0,1,1,0
German DR,1963,Friendly,9,7,1,2,1,4,2,0
German DR,1963,UEFA Euro qualification,5,6,0,1,2,3,-1,0
German DR,1964,Friendly,12,4,1,1,0,2,8,0
German DR,1965,FIFA World Cup qualification,5,5,1,1,2,4,0,0
German DR,1965,Friendly,4,3,1,1,0,2,1,0
German DR,1966,Friendly,21,5,5,0,1,6,16,0
German DR,1967,Friendly,11,5,4,0,2,6,6,0
German DR,1967,UEFA Euro qualification,10,10,3,2,1,6,0,0
German DR,1968,Friendly,1,1,0,0,1,1,0,0
German DR,1969,FIFA World Cup qualification,7,7,2,1,1,4,0,0
German DR,1969,Friendly,15,6,3,1,2,6,9,0
German DR,1970,Friendly,12,4,2,1,1,4,8,0
German DR,1970,UEFA Euro qualification,6,0,2,0,0,2,6,0
German DR,1971,Friendly,8,3,3,0,3,6,5,0
German DR,1971,UEFA Euro qualification,5,6,1,2,1,4,-1,0
German DR,1972,FIFA World Cup qualification,5,0,1,0,0,1,5,0
German DR,1972,Friendly,5,3,2,1,1,4,2,0
German DR,1973,FIFA World Cup qualification,13,3,4,1,0,5,10,0
German DR,1973,Friendly,11,6,6,1,1,8,5,0
German DR,1974,FIFA World Cup,5,5,2,2,2,6,0,0
German DR,1974,Friendly,17,9,7,2,1,10,8,0
German DR,1974,UEFA Euro qualification,3,3,0,0,3,3,0,0
German DR,1975,Friendly,15,6,4,2,1,7,9,0
German DR,1975,UEFA Euro qualification,5,4,2,1,0,3,1,0
German DR,1976,FIFA World Cup qualification,1,1,0,0,1,1,0,0
German DR,1976,Friendly,11,2,2,0,2,4,9,0
German DR,1977,FIFA World Cup qualification,14,3,3,0,2,5,11,0
German DR,1977,Friendly,5,4,3,1,1,5,1,0
German DR,1978,Friendly,7,5,2,1,2,5,2,0
German DR,1978,UEFA Euro qualification,3,4,1,1,0,2,-1,0
German DR,1979,Friendly,3,8,1,4,1,6,-5,0
German DR,1979,UEFA Euro qualification,15,7,4,1,1,6,8,0
German DR,1980,Friendly,8,2,4,0,2,6,6,0
German DR,1981,FIFA World Cup qualification,9,6,2,2,0,4,3,0
German DR,1981,Friendly,5,0,1,0,1,2,5,0
German DR,1982,Friendly,12,9,4,2,3,9,3,0
German DR,1982,UEFA Euro qualification,0,2,0,1,0,1,-2,0
German DR,1983,Friendly,11,7,4,3,0,7,4,0
German DR,1983,UEFA Euro qualification,7,5,2,2,1,5,2,0
German DR,1984,FIFA World Cup qualification,7,5,1,2,0,3,2,0
German DR,1984,Friendly,14,7,5,1,1,7,7,0
German DR,1985,FIFA World Cup qualification,9,4,4,1,0,5,5,0
German DR,1985,Friendly,10,15,3,4,2,9,-5,0
German DR,1986,Friendly,7,13,3,6,0,9,-6,0
German DR,1986,UEFA Euro qualification,2,0,1,0,2,3,2,0
German DR,1987,Friendly,5,5,2,2,1,5,0,0
German DR,1987,UEFA Euro qualification,11,4,3,1,1,5,7,0
German DR,1988,FIFA World Cup qualification,3,3,1,1,0,2,0,0
German DR,1988,Friendly,8,13,1,4,3,8,-5,0
German DR,1989,FIFA World Cup qualification,6,10,2,3,1,6,-4,0
German DR,1989,Friendly,12,5,2,1,2,5,7,0
German DR,1990,Friendly,13,9,5,1,1,7,4,0
Germany,1908,Friendly,5,8,0,2,0,2,-3,0
Germany,1909,Friendly,4,3,1,0,1,2,1,0
Germany,1910,Friendly,6,11,1,3,0,4,-5,0
Germany,1911,Friendly,14,15,2,4,0,6,-1,0
Germany,1912,Friendly,14,16,1,2,2,5,-2,0
Germany,1912,Olympic Games,18,8,1,2,0,3,10,0
Germany,1913,Friendly,4,12,0,3,0,3,-8,0
Germany,1914,Friendly,4,4,0,0,1,1,0,0
Germany,1920,Friendly,4,7,1,2,0,3,-3,0
Germany,1921,Friendly,6,9,0,1,2,3,-3,0
Germany,1922,Friendly,4,2,1,0,2,3,2,0
Germany,1923,Friendly,6,8,2,3,1,6,-2,0
Germany,1924,Friendly,10,13,3,3,1,7,-3,0
Germany,1925,Friendly,10,6,2,2,0,4,4,0
Germany,1926,Friendly,12,10,2,1,1,4,2,0
Germany,1927,Friendly,9,7,1,1,1,3,2,0
Germany,1928,Friendly,7,5,3,1,0,4,2,0
Germany,1928,Olympic Games,5,4,1,1,0,2,1,0
Germany,1929,Friendly,17,3,4,0,1,5,14,0
Germany,1930,Friendly,17,15,2,2,2,6,2,0
Germany,1931,Friendly,7,17,1,3,3,7,-10,0
Germany,1932,Friendly,11,8,3,2,0,5,3,0
Germany,1933,Friendly,17,9,3,1,2,6,8,0
Germany,1934,FIFA World Cup,11,8,3,1,0,4,3,0
Germany,1934,FIFA World Cup qualification,9,1,1,0,0,1,8,0
Germany,1934,Friendly,13,5,3,0,0,3,8,0
Germany,1935,Friendly,48,19,13,3,1,17,29,0
Germany,1936,Friendly,21,18,4,3,2,9,3,0
Germany,1937,FIFA World Cup qualification,11,1,3,0,0,3,10,0
Germany,1937,Friendly,25,5,7,0,1,8,20,0
Germany,1938,FIFA World Cup,3,5,0,1,1,2,-2,0
Germany,1938,Friendly,16,12,3,1,3,7,4,0
Germany,1939,Friendly,39,25,9,4,2,15,14,1
Germany,1940,Friendly,38,17,5,3,2,10,21,0
Germany,1941,Friendly,34,11,6,2,1,9,23,0
Germany,1942,Friendly,36,15,7,2,1,10,21,1
Germany,1950,Friendly,1,0,1,0,0,1,1,0
Germany,1951,Friendly,14,8,4,2,0,6,6,0
Germany,1952,Friendly,17,8,4,1,1,6,9,0
Germany,1953,FIFA World Cup qualification,9,2,2,0,1,3,7,0
Germany,1953,Friendly,0,0,0,0,1,1,0,0
Germany,1954,FIFA World Cup,25,14,5,1,0,6,11,1
Germany,1954,FIFA World Cup qualification,3,1,1,0,0,1,2,0
Germany,1954,Friendly,10,11,2,3,0,5,-1,0
Germany,1955,Friendly,9,11,2,4,0,6,-2,0
Germany,1956,Friendly,13,17,2,5,1,8,-4,0
Germany,1957,Friendly,8,6,4,1,0,5,2,0
Germany,1958,FIFA World Cup,12,14,2,2,2,6,-2,0
Germany,1958,Friendly,15,10,3,2,3,8,5,0
Germany,1959,Friendly,18,9,2,2,2,6,9,0
Germany,1960,FIFA World Cup qualification,7,3,2,0,0,2,4,0
Germany,1960,Friendly,10,5,3,2,0,5,5,0
Germany,1961,FIFA World Cup qualification,4,2,2,0,0,2,2,0
Germany,1961,Friendly,9,4,3,1,0,4,5,0
Germany,1962,FIFA World Cup,4,2,2,1,1,4,2,0
Germany,1962,Friendly,13,5,3,0,1,4,8,0
Germany,1963,Friendly,9,5,2,2,0,4,4,0
Germany,1964,FIFA World Cup qualification,1,1,0,0,1,1,0,0
Germany,1964,Friendly,9,9,1,2,1,4,0,0
Germany,1965,FIFA World Cup qualification,13,1,3,0,0,3,12,0
Germany,1965,Friendly,6,5,2,2,1,5,1,0
Germany,1966,FIFA World Cup,15,6,4,1,1,6,9,0
Germany,1966,Friendly,18,3,7,1,0,8,15,0
Germany,1967,Friendly,11,3,3,1,0,4,8,0
Germany,1967,UEFA Euro qualification,9,2,2,1,1,4,7,0
Germany,1968,FIFA World Cup qualification,3,0,2,0,0,2,3,0
Germany,1968,Friendly,11,8,3,1,5,9,3,0
Germany,1969,FIFA World Cup qualification,17,3,3,0,1,4,14,0
Germany,1969,Friendly,3,2,1,0,2,3,1,0
Germany,1970,FIFA World Cup,17,10,5,1,0,6,7,0
Germany,1970,Friendly,10,8,4,2,1,7,2,0
Germany,1970,UEFA Euro qualification,1,1,0,0,1,1,0,0
Germany,1971,Friendly,15,3,3,1,0,4,12,0
Germany,1971,UEFA Euro qualification,9,1,4,0,1,5,8,0
Germany,1972,Friendly,11,2,3,0,0,3,9,0
Germany,1972,UEFA Euro,5,1,2,0,0,2,4,1
Germany,1972,UEFA Euro qualification,3,1,1,0,1,2,2,0
Germany,1973,Friendly,18,8,6,3,1,10,10,0
Germany,1974,FIFA World Cup,13,4,6,1,0,7,9,1
Germany,1974,Friendly,11,3,4,1,1,6,8,0
Germany,1974,UEFA Euro qualification,3,2,1,0,1,2,1,1
Germany,1975,Friendly,8,3,2,1,1,4,5,0
Germany,1975,UEFA Euro qualification,3,2,1,0,2,3,1,0
Germany,1976,Friendly,4,0,2,0,0,2,4,0
Germany,1976,UEFA Euro,6,4,1,0,1,2,2,0
Germany,1976,UEFA Euro qualification,11,1,2,0,1,3,10,1
Germany,1977,Friendly,23,9,7,1,3,11,14,0
Germany,1978,FIFA World Cup,10,5,1,1,4,6,5,0
Germany,1978,Friendly,11,9,4,2,1,7,2,0
Germany,1979,Friendly,11,4,4,0,0,4,7,0
Germany,1979,UEFA Euro qualification,9,1,3,0,2,5,8,1
Germany,1980,FIFA World Cup qualification,3,1,1,0,0,1,2,0
Germany,1980,Friendly,12,5,4,0,1,5,7,0
Germany,1980,UEFA Euro,6,3,3,0,1,4,3,1
Germany,1980,UEFA Euro qualification,8,0,1,0,0,1,8,0
Germany,1981,FIFA World Cup qualification,30,2,7,0,0,7,28,0
Germany,1981,Friendly,3,2,1,1,0,2,1,0
Germany,1981,Mundialito,2,6,0,2,0,2,-4,0
Germany,1982,FIFA World Cup,12,10,3,2,2,7,2,0
Germany,1982,Friendly,12,7,4,1,2,7,5,0
Germany,1982,UEFA Euro qualification,0,1,0,1,0,1,-1,0
Germany,1983,Friendly,5,4,1,1,1,3,1,0
Germany,1983,UEFA Euro qualification,15,4,5,1,1,7,11,0
Germany,1984,FIFA World Cup qualification,5,2,2,0,0,2,3,0
Germany,1984,Friendly,8,7,4,2,0,6,1,0
Germany,1984,UEFA Euro,2,2,1,1,1,3,0,0
Germany,1985,FIFA World Cup qualification,17,7,3,1,2,6,10,0
Germany,1985,Friendly,4,8,1,4,0,5,-4,0
Germany,1986,FIFA World Cup,8,7,3,2,2,7,1,0
Germany,1986,Friendly,14,9,5,1,2,8,5,0
Germany,1987,Friendly,10,5,4,1,4,9,5,0
Germany,1988,FIFA World Cup qualification,4,0,1,0,1,2,4,0
Germany,1988,Four Nations Tournament,2,1,1,0,1,2,1,0
Germany,1988,Friendly,3,1,2,0,1,3,2,0
Germany,1988,UEFA Euro,6,3,2,1,1,4,3,0
Germany,1989,FIFA World Cup qualification,9,3,2,0,2,4,6,0
Germany,1989,Friendly,3,2,1,0,1,2,1,0
Germany,1990,FIFA World Cup,15,5,5,0,2,7,10,1
Germany,1990,Friendly,14,7,4,1,2,7,7,0
Germany,1990,UEFA Euro qualification,3,2,1,0,0,1,1,0
Germany,1991,Friendly,3,1,2,0,0,2,2,0
Germany,1991,UEFA Euro qualification,10,2,4,1,0,5,8,0
Germany,1992,Friendly,11,9,3,2,4,9,2,0
Germany,1992,UEFA Euro,7,8,2,2,1,5,-1,0
Germany,1993,Friendly,19,5,5,1,2,8,14,0
Germany,1993,USA Cup,9,7,2,0,1,3,2,1
Germany,1994,FIFA World Cup,9,7,3,1,1,5,2,0
Germany,1994,Friendly,12,4,5,1,1,7,8,0
Germany,1994,UEFA Euro qualification,7,2,3,0,0,3,5,0
Germany,1995,Friendly,6,2,3,0,2,5,4,0
Germany,1995,UEFA Euro qualification,20,8,5,1,1,7,12,0
Germany,1996,FIFA World Cup qualification,6,2,1,0,2,3,4,0
Germany,1996,Friendly,17,4,5,1,1,7,13,0
Germany,1996,UEFA Euro,10,3,4,0,2,6,7,1
Germany,1997,FIFA World Cup qualification,17,7,5,0,2,7,10,0
Germany,1997,Friendly,4,0,2,0,0,2,4,0
Germany,1998,FIFA World Cup,8,6,3,1,1,5,2,0
Germany,1998,Friendly,21,6,6,1,3,10,15,0
Germany,1998,UEFA Euro qualification,3,2,1,1,0,2,1,0
Germany,1999,Confederations Cup,2,6,1,2,0,3,-4,0
Germany,1999,Friendly,4,7,1,2,1,4,-3,0
Germany,1999,UEFA Euro qualification,17,2,5,0,1,6,15,0
Germany,2000,FIFA World Cup qualification,3,0,2,0,0,2,3,0
Germany,2000,Friendly,19,11,3,2,2,7,8,0
Germany,2000,UEFA Euro,1,5,0,2,1,3,-4,0
Germany,2001,FIFA World Cup qualification,16,12,4,1,3,8,4,0
Germany,2001,Friendly,7,3,2,1,0,3,4,0
Germany,2002,FIFA World Cup,14,3,5,1,1,7,11,0
Germany,2002,Friendly,28,13,4,3,2,9,15,0
Germany,2002,UEFA Euro qualification,4,1,2,0,0,2,3,0
Germany,2003,Friendly,6,8,2,3,0,5,-2,0
Germany,2003,UEFA Euro qualification,9,3,3,0,3,6,6,0
Germany,2004,Friendly,33,14,9,3,1,13,19,0
Germany,2004,UEFA Euro,2,3,0,1,2,3,-1,0
Germany,2005,Confederations Cup,15,11,3,1,1,5,4,1
Germany,2005,Friendly,17,13,4,2,4,10,4,0
Germany,2006,FIFA World Cup,14,6,5,1,1,7,8,0
Germany,2006,Friendly,22,7,5,1,1,7,15,0
Germany,2006,UEFA Euro qualification,19,2,3,0,1,4,17,0
Germany,2007,Friendly,8,4,3,1,0,4,4,0
Germany,2007,UEFA Euro qualification,16,5,5,1,2,8,11,0
Germany,2008,FIFA World Cup qualification,12,4,3,0,1,4,8,0
Germany,2008,Friendly,14,5,4,1,1,6,9,0
Germany,2008,UEFA Euro,10,7,4,2,0,6,3,0
Germany,2009,FIFA World Cup qualification,14,1,5,0,1,6,13,0
Germany,2009,Friendly,12,6,2,1,2,5,6,0
Germany,2010,FIFA World Cup,16,5,5,2,0,7,11,0
Germany,2010,Friendly,11,4,3,1,2,6,7,0
Germany,2010,UEFA Euro qualification,13,1,4,0,0,4,12,0
Germany,2011,Friendly,15,11,3,1,3,7,4,0
Germany,2011,UEFA Euro qualification,21,6,6,0,0,6,15,0
Germany,2012,FIFA World Cup qualification,15,6,3,0,1,4,9,0
Germany,2012,Friendly,7,10,1,3,1,5,-3,0
Germany,2012,UEFA Euro,10,6,4,1,0,5,4,0
Germany,2013,FIFA World Cup qualification,21,4,6,0,0,6,17,0
Germany,2013,Friendly,14,11,3,1,2,6,3,0
Germany,2014,FIFA World Cup,18,4,6,0,1,7,14,1
Germany,2014,Friendly,12,7,3,1,2,6,5,0
Germany,2014,UEFA Euro qualification,7,4,2,1,1,4,3,0
Germany,2015,Friendly,3,6,0,2,1,3,-3,0
Germany,2015,UEFA Euro qualification,17,5,5,1,0,6,12,0
Germany,2016,FIFA World Cup qualification,16,0,4,0,0,4,16,0
Germany,2016,Friendly,11,7,3,2,1,6,4,0
Germany,2016,UEFA Euro,7,3,3,1,2,6,4,0
Germany,2017,Confederations Cup,12,5,4,0,1,5,7,0
Germany,2017,FIFA World Cup qualification,27,4,6,0,0,6,23,0
Germany,2017,Friendly,4,3,1,0,3,4,1,0
Germany,2018,FIFA World Cup,2,4,1,2,0,3,-2,0
Germany,2018,Friendly,9,6,3,2,1,6,3,0
Germany,2018,UEFA Nations League,3,7,0,2,2,4,-4,0
Germany,2019,Friendly,3,3,0,0,2,2,0,0
Germany,2019,UEFA Euro qualification,30,7,7,1,0,8,23,0
Germany,2020,Friendly,4,3,1,0,1,2,1,0
Germany,2020,UEFA Nations League,10,13,2,1,3,6,-3,0
Germany,2021,FIFA World Cup qualification,36,4,9,1,0,10,32,0
Germany,2021,Friendly,8,2,1,0,1,2,6,0
Germany,2021,UEFA Euro,6,7,1,2,1,4,-1,0
Germany,2022,FIFA World Cup,6,5,1,1,1,3,1,0
Germany,2022,Friendly,4,1,2,0,1,3,3,0
Germany,2022,UEFA Nations League,11,9,1,1,4,6,2,0
Germany,2023,Friendly,17,22,3,6,2,11,-5,0
Germany,2024,Friendly,6,2,3,0,1,4,4,0
Germany,2024,UEFA Euro,11,4,3,1,1,5,7,0
Germany,2024,UEFA Nations League,18,4,4,0,2,6,14,0
Germany,2025,UEFA Nations League,5,4,1,0,1,2,1,0
Ghana,1950,Friendly,1,0,1,0,0,1,1,0
Ghana,1951,Friendly,0,5,0,1,0,1,-5,0
Ghana,1953,Friendly,1,0,1,0,0,1,1,0
Ghana,1954,Friendly,2,3,1,1,0,2,-1,0
Ghana,1955,Friendly,8,0,2,0,0,2,8,0
Ghana,1956,Friendly,5,7,1,1,1,3,-2,0
Ghana,1957,Friendly,6,5,1,0,1,2,1,0
Ghana,1958,Friendly,7,5,1,1,0,2,2,0
Ghana,1959,Friendly,5,2,1,0,0,1,3,0
Ghana,1960,FIFA World Cup qualification,6,3,1,0,1,2,3,0
Ghana,1960,Friendly,20,8,4,0,2,6,12,0
Ghana,1961,African Cup of Nations qualification,2,2,0,0,2,2,0,0
Ghana,1961,FIFA World Cup qualification,0,1,0,1,1,2,-1,0
Ghana,1961,Friendly,11,1,3,0,0,3,10,0
Ghana,1962,Friendly,33,6,6,0,2,8,27,0
Ghana,1963,African Cup of Nations,6,1,2,0,1,3,5,1
Ghana,1963,Friendly,4,0,1,0,0,1,4,0
Ghana,1964,Friendly,3,0,1,0,0,1,3,0
Ghana,1965,African Cup of Nations,12,5,3,0,0,3,7,0
Ghana,1965,Friendly,35,9,6,1,1,8,26,0
Ghana,1966,Friendly,16,6,3,0,2,5,10,0
Ghana,1967,Friendly,22,15,5,2,4,11,7,0
Ghana,1968,African Cup of Nations,11,8,3,1,1,5,3,0
Ghana,1968,Friendly,7,1,3,0,0,3,6,0
Ghana,1969,African Cup of Nations qualification,15,1,2,0,0,2,14,0
Ghana,1969,FIFA World Cup qualification,2,3,0,1,1,2,-1,0
Ghana,1970,African Cup of Nations,6,4,2,1,2,5,2,0
Ghana,1970,Friendly,4,1,1,0,1,2,3,0
Ghana,1971,African Cup of Nations qualification,0,1,0,1,1,2,-1,0
Ghana,1971,Friendly,9,7,1,2,1,4,2,0
Ghana,1972,FIFA World Cup qualification,10,1,2,0,0,2,9,0
Ghana,1972,Friendly,6,9,0,2,2,4,-3,0
Ghana,1973,African Cup of Nations qualification,3,7,1,3,0,4,-4,0
Ghana,1973,All-African Games,7,8,2,3,0,5,-1,0
Ghana,1973,FIFA World Cup qualification,5,6,2,1,1,4,-1,0
Ghana,1974,Friendly,12,6,3,0,3,6,6,0
Ghana,1975,African Cup of Nations qualification,7,5,2,2,0,4,2,0
Ghana,1975,Friendly,10,4,3,1,1,5,6,0
Ghana,1976,FIFA World Cup qualification,3,3,1,1,0,2,0,0
Ghana,1976,Friendly,5,3,1,1,0,2,2,0
Ghana,1977,FIFA World Cup qualification,0,2,0,1,0,1,-2,0
Ghana,1977,Friendly,9,2,3,1,0,4,7,1
Ghana,1978,African Cup of Nations,9,2,4,0,1,5,7,1
Ghana,1978,All-African Games,4,4,2,1,2,5,0,0
Ghana,1978,Friendly,10,5,2,1,0,3,5,0
Ghana,1979,Friendly,1,3,0,1,1,2,-2,0
Ghana,1980,African Cup of Nations,1,1,1,1,1,3,0,0
Ghana,1980,Friendly,8,3,2,0,0,2,5,0
Ghana,1981,African Cup of Nations qualification,6,4,2,0,2,4,2,0
Ghana,1981,Friendly,4,7,1,1,2,4,-3,0
Ghana,1982,African Cup of Nations,7,5,2,0,3,5,2,0
Ghana,1982,Friendly,2,1,1,0,3,4,1,0
Ghana,1982,Merdeka Tournament,10,3,3,0,1,4,7,0
Ghana,1982,West African Cup,14,8,3,0,2,5,6,1
Ghana,1983,Friendly,2,0,2,0,0,2,2,0
Ghana,1983,Korea Cup,3,4,1,2,0,3,-1,0
Ghana,1983,Merdeka Tournament,2,1,1,0,0,1,1,0
Ghana,1983,West African Cup,7,2,3,0,1,4,5,1
Ghana,1984,African Cup of Nations,2,4,1,2,0,3,-2,0
Ghana,1984,Friendly,12,7,6,2,0,8,5,0
Ghana,1984,West African Cup,9,5,2,0,3,5,4,0
Ghana,1985,African Cup of Nations qualification,5,4,1,1,2,4,1,0
Ghana,1985,FIFA World Cup qualification,2,2,1,1,2,4,0,0
Ghana,1985,Friendly,0,2,0,1,0,1,-2,0
Ghana,1985,Korea Cup,1,2,0,1,0,1,-1,0
Ghana,1986,Friendly,3,4,1,2,1,4,-1,0
Ghana,1986,West African Cup,12,2,5,0,1,6,10,1
Ghana,1987,African Cup of Nations qualification,1,2,0,1,1,2,-1,0
Ghana,1987,Friendly,4,2,1,0,3,4,2,0
Ghana,1987,West African Cup,8,1,3,0,0,3,7,1
Ghana,1988,FIFA World Cup qualification,0,2,0,1,1,2,-2,0
Ghana,1988,Friendly,2,3,1,1,1,3,-1,0
Ghana,1988,Tournament Burkina Faso,3,7,1,2,1,4,-4,0
Ghana,1989,African Cup of Nations qualification,1,1,1,1,0,2,0,0
Ghana,1989,Friendly,2,2,0,0,2,2,0,0
Ghana,1990,African Cup of Nations qualification,4,0,3,0,0,3,4,0
Ghana,1990,Friendly,0,1,0,1,0,1,-1,0
Ghana,1991,African Cup of Nations qualification,7,2,2,1,2,5,5,0
Ghana,1991,Friendly,7,5,3,1,1,5,2,0
Ghana,1992,African Cup of Nations,6,2,4,0,1,5,4,0
Ghana,1992,FIFA World Cup qualification,2,1,1,1,0,2,1,0
Ghana,1992,Friendly,1,1,1,1,0,2,0,0
Ghana,1993,African Cup of Nations qualification,2,0,1,0,1,2,2,0
Ghana,1993,FIFA World Cup qualification,2,2,1,1,0,2,0,0
Ghana,1993,Friendly,14,15,4,2,3,9,-1,0
Ghana,1993,Merdeka Tournament,2,0,1,0,0,1,2,0
Ghana,1994,African Cup of Nations,3,2,2,1,0,3,1,0
Ghana,1994,African Cup of Nations qualification,4,1,1,0,0,1,3,0
Ghana,1994,Friendly,6,11,2,4,2,8,-5,0
Ghana,1994,Simba Tournament,2,1,1,0,1,2,1,0
Ghana,1995,African Cup of Nations qualification,5,2,2,1,0,3,3,0
Ghana,1995,Friendly,6,9,2,4,0,6,-3,0
Ghana,1996,African Cup of Nations,7,5,4,2,0,6,2,0
Ghana,1996,African Cup of Nations qualification,2,1,1,0,0,1,1,0
Ghana,1996,FIFA World Cup qualification,3,2,1,0,2,3,1,0
Ghana,1996,Friendly,7,19,0,5,4,9,-12,0
Ghana,1996,Simba Tournament,1,2,1,1,1,3,-1,0
Ghana,1997,African Cup of Nations qualification,2,2,1,1,1,3,0,0
Ghana,1997,FIFA World Cup qualification,6,6,1,2,2,5,0,0
Ghana,1997,Friendly,2,7,0,2,0,2,-5,0
Ghana,1997,Korea Cup,1,8,0,3,0,3,-7,0
Ghana,1997,Nehru Cup,2,2,0,0,2,2,0,0
Ghana,1998,African Cup of Nations,3,3,1,2,0,3,0,0
Ghana,1998,Friendly,7,1,4,0,2,6,6,0
Ghana,1999,Friendly,5,5,2,1,2,5,0,0
Ghana,2000,African Cup of Nations,3,4,1,2,1,4,-1,0
Ghana,2000,African Cup of Nations qualification,7,4,1,0,1,2,3,0
Ghana,2000,FIFA World Cup qualification,9,2,3,0,0,3,7,0
Ghana,2000,Friendly,3,4,1,2,0,3,-1,0
Ghana,2001,African Cup of Nations qualification,9,4,3,1,0,4,5,1
Ghana,2001,FIFA World Cup qualification,5,9,2,3,2,7,-4,0
Ghana,2001,Friendly,4,5,0,1,2,3,-1,0
Ghana,2002,African Cup of Nations,2,2,1,1,2,4,0,0
Ghana,2002,African Cup of Nations qualification,4,3,1,1,0,2,1,0
Ghana,2002,Friendly,3,8,1,4,1,6,-5,0
Ghana,2003,African Cup of Nations qualification,1,2,0,1,1,2,-1,0
Ghana,2003,FIFA World Cup qualification,7,0,2,0,0,2,7,0
Ghana,2003,Friendly,10,12,1,3,2,6,-2,0
Ghana,2004,FIFA World Cup qualification,6,2,2,1,2,5,4,0
Ghana,2004,Friendly,1,1,0,0,2,2,0,0
Ghana,2005,FIFA World Cup qualification,11,2,4,0,1,5,9,0
Ghana,2005,Friendly,5,3,1,0,2,3,2,0
Ghana,2006,African Cup of Nations,2,3,1,2,0,3,-1,0
Ghana,2006,FIFA World Cup,4,6,2,2,0,4,-2,0
Ghana,2006,Friendly,15,9,5,3,2,10,6,0
Ghana,2007,Friendly,14,11,4,2,2,8,3,0
Ghana,2008,African Cup of Nations,11,5,5,1,0,6,6,0
Ghana,2008,FIFA World Cup qualification,11,5,4,2,0,6,6,0
Ghana,2008,Friendly,3,6,0,3,2,5,-3,0
Ghana,2009,FIFA World Cup qualification,9,3,4,1,1,6,6,0
Ghana,2009,Friendly,11,10,2,2,2,6,1,0
Ghana,2010,African Cup of Nations,4,4,3,2,0,5,0,0
Ghana,2010,African Cup of Nations qualification,3,0,1,0,1,2,3,0
Ghana,2010,FIFA World Cup,5,4,2,1,2,5,1,0
Ghana,2010,Friendly,3,7,1,3,2,6,-4,0
Ghana,2011,African Cup of Nations qualification,10,1,4,0,0,4,9,0
Ghana,2011,Friendly,8,6,2,2,2,6,2,0
Ghana,2012,African Cup of Nations,6,5,3,2,1,6,1,0
Ghana,2012,African Cup of Nations qualification,3,0,2,0,0,2,3,0
Ghana,2012,FIFA World Cup qualification,7,1,1,1,0,2,6,0
Ghana,2012,Friendly,3,4,1,1,2,4,-1,0
Ghana,2013,African Cup of Nations,10,6,3,1,2,6,4,0
Ghana,2013,FIFA World Cup qualification,18,5,5,1,0,6,13,0
Ghana,2013,Friendly,13,10,3,2,2,7,3,0
Ghana,2014,African Cup of Nations qualification,11,7,3,1,2,6,4,0
Ghana,2014,FIFA World Cup,4,6,0,2,1,3,-2,0
Ghana,2014,Friendly,5,2,2,2,0,4,3,0
Ghana,2015,African Cup of Nations,10,3,4,1,1,6,7,0
Ghana,2015,African Cup of Nations qualification,8,1,2,0,0,2,7,0
Ghana,2015,COSAFA Cup,1,5,0,2,0,2,-4,0
Ghana,2015,FIFA World Cup qualification,2,0,1,0,1,2,2,0
Ghana,2015,Friendly,6,5,2,1,1,4,1,0
Ghana,2016,African Cup of Nations qualification,6,2,2,0,2,4,4,0
Ghana,2016,FIFA World Cup qualification,0,2,0,1,1,2,-2,0
Ghana,2016,Friendly,1,2,0,1,1,2,-1,0
Ghana,2017,African Cup of Nations,4,5,3,3,0,6,-1,0
Ghana,2017,African Cup of Nations qualification,5,0,1,0,0,1,5,1
Ghana,2017,FIFA World Cup qualification,7,3,1,0,3,4,4,0
Ghana,2017,Friendly,5,3,1,1,1,3,2,0
Ghana,2018,African Cup of Nations qualification,2,1,1,1,0,2,1,0
Ghana,2018,Friendly,4,2,1,0,1,2,2,0
Ghana,2019,African Cup of Nations,5,3,1,0,3,4,2,0
Ghana,2019,African Cup of Nations qualification,4,0,3,0,0,3,4,0
Ghana,2019,Friendly,3,1,1,0,1,2,2,0
Ghana,2020,African Cup of Nations qualification,2,1,1,1,0,2,1,0
Ghana,2020,Friendly,5,4,1,1,0,2,1,0
Ghana,2021,African Cup of Nations qualification,4,2,1,0,1,2,2,0
Ghana,2021,FIFA World Cup qualification,7,3,4,1,1,6,4,0
Ghana,2021,Friendly,0,1,0,1,1,2,-1,0
Ghana,2022,African Cup of Nations,3,5,0,2,1,3,-2,0
Ghana,2022,African Cup of Nations qualification,4,1,1,0,1,2,3,0
Ghana,2022,FIFA World Cup,5,7,1,2,0,3,-2,0
Ghana,2022,FIFA World Cup qualification,1,1,0,0,2,2,0,0
Ghana,2022,Friendly,3,6,2,2,0,4,-3,0
Ghana,2022,Kirin Cup,1,4,0,1,1,2,-3,0
Ghana,2023,African Cup of Nations qualification,4,2,2,0,2,4,2,0
Ghana,2023,FIFA World Cup qualification,1,1,1,1,0,2,0,0
Ghana,2023,Friendly,3,7,1,2,0,3,-4,0
Ghana,2024,African Cup of Nations,5,6,0,1,2,3,-1,0
Ghana,2024,African Cup of Nations qualification,1,4,0,2,2,4,-3,0
Ghana,2024,FIFA World Cup qualification,6,4,2,0,0,2,2,0
Ghana,2024,Friendly,1,2,0,1,1,2,-1,0
Ghana,2025,FIFA World Cup qualification,8,0,2,0,0,2,8,0
Gibraltar,1993,Island Games,1,9,0,4,0,4,-8,0
Gibraltar,1995,Island Games,6,3,4,2,0,6,3,0
Gibraltar,1997,Island Games,13,8,2,3,0,5,5,0
Gibraltar,1999,Island Games,9,11,1,3,0,4,-2,1
Gibraltar,2000,Friendly,5,0,1,0,0,1,5,0
Gibraltar,2001,Island Games,7,2,3,1,0,4,5,0
Gibraltar,2002,Friendly,2,2,0,0,1,1,0,0
Gibraltar,2003,Island Games,29,5,3,2,0,5,24,0
Gibraltar,2005,Friendly,4,0,1,0,0,1,4,0
Gibraltar,2006,FIFI Wild Cup,8,4,2,1,1,4,4,1
Gibraltar,2007,Island Games,9,2,3,0,1,4,7,1
Gibraltar,2008,Friendly,1,2,0,1,0,1,-1,0
Gibraltar,2009,Island Games,12,3,2,1,1,4,9,0
Gibraltar,2011,Friendly,3,0,1,0,0,1,3,0
Gibraltar,2011,Island Games,18,7,3,1,0,4,11,0
Gibraltar,2013,Friendly,0,0,0,0,1,1,0,0
Gibraltar,2014,Friendly,3,7,1,2,1,4,-4,0
Gibraltar,2014,UEFA Euro qualification,0,21,0,4,0,4,-21,0
Gibraltar,2015,Friendly,0,4,0,1,0,1,-4,0
Gibraltar,2015,Island Games,3,6,1,1,2,4,-3,0
Gibraltar,2015,UEFA Euro qualification,2,35,0,6,0,6,-33,0
Gibraltar,2016,FIFA World Cup qualification,2,17,0,4,0,4,-15,0
Gibraltar,2016,Friendly,0,10,0,2,1,3,-10,0
Gibraltar,2017,FIFA World Cup qualification,1,30,0,6,0,6,-29,0
Gibraltar,2018,Friendly,1,0,1,0,0,1,1,0
Gibraltar,2018,UEFA Nations League,5,15,2,4,0,6,-10,0
Gibraltar,2019,Friendly,0,2,0,2,0,2,-2,0
Gibraltar,2019,UEFA Euro qualification,3,31,0,8,0,8,-28,0
Gibraltar,2020,Friendly,0,5,0,2,0,2,-5,0
Gibraltar,2020,UEFA Nations League,3,1,2,0,2,4,2,0
Gibraltar,2021,FIFA World Cup qualification,4,43,0,10,0,10,-39,0
Gibraltar,2021,Friendly,0,6,0,1,1,2,-6,0
Gibraltar,2022,Friendly,3,0,2,0,2,4,3,0
Gibraltar,2022,UEFA Nations League,3,18,0,5,1,6,-15,0
Gibraltar,2023,Friendly,0,5,0,2,0,2,-5,0
Gibraltar,2023,UEFA Euro qualification,0,41,0,8,0,8,-41,0
Gibraltar,2024,Friendly,2,3,1,1,2,4,-1,0
Gibraltar,2024,UEFA Nations League,4,5,1,2,3,6,-1,0
Gibraltar,2025,FIFA World Cup qualification,1,7,0,2,0,2,-6,0
Gotland,1999,Island Games,27,12,3,1,1,5,15,0
Gotland,2003,Island Games,7,3,2,0,3,5,4,0
Gotland,2007,Island Games,5,6,1,3,0,4,-1,0
Gotland,2009,Island Games,9,8,2,2,0,4,1,0
Gotland,2011,Island Games,11,12,1,3,0,4,-1,0
Gotland,2015,Island Games,5,11,0,4,0,4,-6,0
Gotland,2017,Island Games,17,5,2,2,0,4,12,0
Gozo,2009,Viva World Cup,4,12,0,3,0,3,-8,0
Gozo,2010,Viva World Cup,3,8,1,2,0,3,-5,0
Gozo,2012,Friendly,17,1,1,0,0,1,16,0
Gozo,2023,Island Games,4,2,2,2,0,4,2,0
Greece,1919,Inter-Allied Games,3,22,1,2,0,3,-19,0
Greece,1920,Olympic Games,0,9,0,1,0,1,-9,0
Greece,1929,Friendly,1,1,0,0,1,1,0,0
Greece,1930,Balkan Cup,9,10,2,1,0,3,-1,1
Greece,1931,Balkan Cup,4,10,0,3,0,3,-6,0
Greece,1932,Balkan Cup,1,12,0,3,0,3,-11,0
Greece,1932,Friendly,3,4,0,1,1,2,-1,0
Greece,1933,Balkan Cup,3,7,0,2,0,2,-4,0
Greece,1934,Balkan Cup,4,3,1,0,1,2,1,0
Greece,1934,FIFA World Cup qualification,0,4,0,1,0,1,-4,0
Greece,1935,Balkan Cup,6,15,0,3,1,4,-9,0
Greece,1936,Balkan Cup,6,10,0,2,0,2,-4,0
Greece,1936,Friendly,1,3,0,1,0,1,-2,0
Greece,1938,FIFA World Cup qualification,5,12,2,1,0,3,-7,0
Greece,1948,Friendly,2,5,0,2,0,2,-3,0
Greece,1949,Friendly,10,5,1,2,0,3,5,0
Greece,1950,Friendly,0,2,0,1,0,1,-2,0
Greece,1951,Friendly,1,0,1,0,0,1,1,0
Greece,1953,FIFA World Cup qualification,1,1,1,1,0,2,0,0
Greece,1954,FIFA World Cup qualification,2,1,1,1,0,2,1,0
Greece,1954,Friendly,1,1,0,0,1,1,0,0
Greece,1957,FIFA World Cup qualification,2,9,0,3,1,4,-7,0
Greece,1958,UEFA Euro qualification,2,8,0,1,1,2,-6,0
Greece,1959,Friendly,1,3,0,1,0,1,-2,0
Greece,1960,FIFA World Cup qualification,0,3,0,1,0,1,-3,0
Greece,1960,Friendly,2,7,0,1,0,1,-5,0
Greece,1961,FIFA World Cup qualification,3,5,1,2,0,3,-2,0
Greece,1962,Friendly,3,2,1,0,0,1,1,0
Greece,1963,Friendly,4,8,1,2,0,3,-4,0
Greece,1964,FIFA World Cup qualification,6,2,2,0,0,2,4,1
Greece,1964,Friendly,3,1,1,0,0,1,2,0
Greece,1965,FIFA World Cup qualification,4,12,0,3,1,4,-8,0
Greece,1966,UEFA Euro qualification,2,1,1,0,0,1,1,0
Greece,1967,Friendly,5,2,1,1,0,2,3,0
Greece,1967,UEFA Euro qualification,6,8,1,2,2,5,-2,0
Greece,1968,FIFA World Cup qualification,4,3,1,1,0,2,1,0
Greece,1969,FIFA World Cup qualification,9,6,1,0,3,4,3,0
Greece,1969,Friendly,6,5,1,0,2,3,1,0
Greece,1970,Friendly,3,6,0,2,1,3,-3,0
Greece,1970,UEFA Euro qualification,1,2,0,1,1,2,-1,0
Greece,1971,Friendly,3,5,0,2,2,4,-2,0
Greece,1971,UEFA Euro qualification,2,6,1,3,0,4,-4,0
Greece,1972,FIFA World Cup qualification,0,1,0,1,0,1,-1,0
Greece,1972,Friendly,4,9,2,2,1,5,-5,0
Greece,1973,FIFA World Cup qualification,5,10,0,3,0,3,-5,0
Greece,1973,Friendly,3,5,0,1,1,2,-2,0
Greece,1974,Balkan Cup,1,3,0,1,0,1,-2,0
Greece,1974,Friendly,3,3,1,1,1,3,0,0
Greece,1974,UEFA Euro qualification,7,6,1,0,2,3,1,0
Greece,1975,Balkan Cup,1,1,0,0,1,1,0,0
Greece,1975,Friendly,4,4,1,1,0,2,0,0
Greece,1975,UEFA Euro qualification,5,3,1,1,1,3,2,0
Greece,1976,FIFA World Cup qualification,1,1,0,0,1,1,0,0
Greece,1976,Friendly,1,4,1,2,0,3,-3,0
Greece,1977,Balkan Cup,0,0,0,0,1,1,0,0
Greece,1977,FIFA World Cup qualification,1,5,1,2,0,3,-4,0
Greece,1977,Friendly,2,13,0,3,2,5,-11,0
Greece,1978,Balkan Cup,1,4,0,1,0,1,-3,0
Greece,1978,Friendly,10,9,4,2,1,7,1,0
Greece,1978,UEFA Euro qualification,12,7,2,2,0,4,5,0
Greece,1979,Friendly,3,9,0,2,1,3,-6,0
Greece,1979,UEFA Euro qualification,1,0,1,0,1,2,1,0
Greece,1980,FIFA World Cup qualification,1,2,1,1,0,2,-1,0
Greece,1980,Friendly,5,13,0,3,3,6,-8,0
Greece,1980,UEFA Euro,1,4,0,2,1,3,-3,0
Greece,1981,FIFA World Cup qualification,9,11,2,3,1,6,-2,0
Greece,1981,Friendly,3,1,2,0,0,2,2,0
Greece,1982,Friendly,5,12,1,6,1,8,-7,0
Greece,1982,UEFA Euro qualification,2,3,1,1,0,2,-1,0
Greece,1983,Friendly,7,13,1,4,0,5,-6,0
Greece,1983,UEFA Euro qualification,6,7,2,2,2,6,-1,0
Greece,1984,FIFA World Cup qualification,1,3,0,1,1,2,-2,0
Greece,1984,Friendly,8,11,2,4,3,9,-3,0
Greece,1985,FIFA World Cup qualification,4,7,1,2,1,4,-3,0
Greece,1985,Friendly,2,2,1,1,1,3,0,0
Greece,1986,Friendly,4,5,2,2,2,6,-1,0
Greece,1986,UEFA Euro qualification,7,5,2,1,0,3,2,0
Greece,1987,Friendly,4,7,0,1,3,4,-3,0
Greece,1987,UEFA Euro qualification,5,8,2,2,1,5,-3,0
Greece,1988,FIFA World Cup qualification,1,4,0,1,1,2,-3,0
Greece,1988,Friendly,10,12,3,3,1,7,-2,0
Greece,1988,Matthews Cup,4,0,2,0,1,3,4,0
Greece,1989,FIFA World Cup qualification,2,11,1,2,1,4,-9,0
Greece,1989,Friendly,12,21,2,6,3,11,-9,0
Greece,1990,Friendly,12,4,4,1,1,6,8,0
Greece,1990,UEFA Euro qualification,4,2,1,1,0,2,2,0
Greece,1991,Friendly,3,5,0,1,3,4,-2,0
Greece,1991,UEFA Euro qualification,7,7,2,2,2,6,0,0
Greece,1992,FIFA World Cup qualification,2,0,2,0,1,3,2,0
Greece,1992,Friendly,6,5,2,2,0,4,1,0
Greece,1993,FIFA World Cup qualification,8,2,4,0,1,5,6,0
Greece,1993,Friendly,1,2,0,1,0,1,-1,0
Greece,1994,FIFA World Cup,0,10,0,3,0,3,-10,0
Greece,1994,Friendly,6,12,1,3,3,7,-6,0
Greece,1994,UEFA Euro qualification,12,1,4,0,0,4,11,1
Greece,1995,Friendly,6,7,2,2,1,5,-1,0
Greece,1995,UEFA Euro qualification,11,8,2,4,0,6,3,0
Greece,1996,FIFA World Cup qualification,7,3,2,1,1,4,4,0
Greece,1996,Friendly,7,7,3,2,0,5,0,0
Greece,1997,FIFA World Cup qualification,4,1,2,1,1,4,3,0
Greece,1997,Friendly,7,2,2,0,2,4,5,0
Greece,1998,Friendly,2,3,0,1,1,2,-1,0
Greece,1998,UEFA Euro qualification,5,2,1,0,2,3,3,0
Greece,1999,Cyprus International Tournament,3,1,2,0,0,2,2,1
Greece,1999,Friendly,18,7,6,0,3,9,11,0
Greece,1999,UEFA Euro qualification,8,6,3,3,1,7,2,0
Greece,2000,FIFA World Cup qualification,1,4,1,2,0,3,-3,0
Greece,2000,Friendly,11,8,3,2,2,7,3,0
Greece,2001,FIFA World Cup qualification,6,13,1,3,1,5,-7,0
Greece,2001,Friendly,10,9,1,1,3,5,1,0
Greece,2002,Friendly,6,3,2,0,3,5,3,0
Greece,2002,UEFA Euro qualification,2,4,1,2,0,3,-2,0
Greece,2003,Friendly,10,7,3,0,3,6,3,0
Greece,2003,UEFA Euro qualification,6,0,5,0,0,5,6,0
Greece,2004,FIFA World Cup qualification,5,4,1,1,2,4,1,0
Greece,2004,Friendly,5,5,3,2,1,6,0,0
Greece,2004,UEFA Euro,7,4,4,1,1,6,3,1
Greece,2005,Confederations Cup,0,4,0,2,1,3,-4,0
Greece,2005,FIFA World Cup qualification,10,5,5,2,1,8,5,0
Greece,2005,Friendly,2,3,1,1,0,2,-1,0
Greece,2006,Cyprus International Tournament,3,0,2,0,0,2,3,1
Greece,2006,Friendly,2,8,0,3,2,5,-6,0
Greece,2006,UEFA Euro qualification,6,0,3,0,0,3,6,0
Greece,2007,Friendly,2,4,0,2,0,2,-2,0
Greece,2007,UEFA Euro qualification,19,10,7,1,1,9,9,0
Greece,2008,FIFA World Cup qualification,9,2,3,1,0,4,7,0
Greece,2008,Friendly,11,6,4,1,2,7,5,0
Greece,2008,UEFA Euro,1,5,0,3,0,3,-4,0
Greece,2009,FIFA World Cup qualification,12,8,4,1,3,8,4,0
Greece,2009,Friendly,1,3,0,1,1,2,-2,0
Greece,2010,FIFA World Cup,2,5,1,2,0,3,-3,0
Greece,2010,Friendly,5,7,2,2,1,5,-2,0
Greece,2010,UEFA Euro qualification,4,2,2,0,2,4,2,0
Greece,2011,Friendly,4,5,1,1,4,6,-1,0
Greece,2011,UEFA Euro qualification,10,3,5,0,1,6,7,0
Greece,2012,FIFA World Cup qualification,5,1,3,0,1,4,4,0
Greece,2012,Friendly,7,4,3,0,2,5,3,0
Greece,2012,UEFA Euro,5,7,1,2,1,4,-2,0
Greece,2013,FIFA World Cup qualification,11,5,6,1,1,8,6,0
Greece,2013,Friendly,2,0,1,0,1,2,2,0
Greece,2014,FIFA World Cup,3,5,1,1,2,4,-2,0
Greece,2014,Friendly,2,5,1,2,2,5,-3,0
Greece,2014,UEFA Euro qualification,1,5,0,3,1,4,-4,0
Greece,2015,Friendly,0,1,0,1,2,3,-1,0
Greece,2015,UEFA Euro qualification,6,9,1,3,2,6,-3,0
Greece,2016,FIFA World Cup qualification,9,2,3,0,1,4,7,0
Greece,2016,Friendly,8,8,3,3,0,6,0,0
Greece,2017,FIFA World Cup qualification,9,8,2,2,4,8,1,0
Greece,2018,Friendly,1,3,1,2,0,3,-2,0
Greece,2018,UEFA Nations League,4,5,3,3,0,6,-1,0
Greece,2019,Friendly,1,2,0,1,0,1,-1,0
Greece,2019,UEFA Euro qualification,12,14,4,4,2,10,-2,0
Greece,2020,Friendly,3,3,1,1,0,2,0,0
Greece,2020,UEFA Nations League,6,1,3,0,3,6,5,0
Greece,2021,FIFA World Cup qualification,8,8,2,2,4,8,0,0
Greece,2021,Friendly,6,5,2,1,1,4,1,0
Greece,2022,Friendly,4,5,1,2,1,4,-1,0
Greece,2022,UEFA Nations League,10,2,5,1,0,6,8,0
Greece,2023,Friendly,2,0,1,0,1,2,2,0
Greece,2023,UEFA Euro qualification,14,8,4,3,1,8,6,0
Greece,2024,Friendly,3,2,1,1,0,2,1,0
Greece,2024,UEFA Euro qualification,5,0,1,0,1,2,5,0
Greece,2024,UEFA Nations League,11,4,5,1,0,6,7,0
Greece,2025,UEFA Nations League,3,1,1,1,0,2,2,0
Greenland,1980,Friendly,1,10,0,2,0,2,-9,0
Greenland,1983,Friendly,2,3,0,1,1,2,-1,0
Greenland,1984,Friendly,2,6,0,3,0,3,-4,0
Greenland,1989,Island Games,4,8,1,3,0,4,-4,0
Greenland,1991,Island Games,8,15,0,4,0,4,-7,0
Greenland,1993,Island Games,9,6,2,2,0,4,3,0
Greenland,1995,Island Games,7,4,2,2,0,4,3,0
Greenland,1997,Island Games,3,9,0,3,1,4,-6,0
Greenland,1999,Island Games,11,18,2,3,0,5,-7,0
Greenland,2001,Friendly,4,1,1,0,0,1,3,0
Greenland,2001,Island Games,6,2,2,1,1,4,4,0
Greenland,2003,Island Games,22,5,3,2,0,5,17,0
Greenland,2005,Island Games,8,14,1,2,2,5,-6,0
Greenland,2006,ELF Cup,3,2,1,1,1,3,1,0
Greenland,2006,FIFI Wild Cup,2,5,0,2,0,2,-3,0
Greenland,2009,Island Games,7,15,1,3,0,4,-8,0
Greenland,2011,Island Games,5,7,1,3,0,4,-2,0
Greenland,2013,Island Games,21,4,2,2,0,4,17,0
Greenland,2015,Island Games,8,4,3,0,1,4,4,0
Greenland,2017,Island Games,7,9,2,1,2,5,-2,0
Greenland,2023,Island Games,5,7,1,1,1,3,-2,0
Grenada,1938,Friendly,8,2,2,0,0,2,6,0
Grenada,1951,Friendly,5,4,1,1,0,2,1,0
Grenada,1961,Windward Islands Tournament,15,7,2,1,0,3,8,0
Grenada,1962,Windward Islands Tournament,2,1,1,0,0,1,1,1
Grenada,1965,Windward Islands Tournament,0,2,0,1,0,1,-2,0
Grenada,1966,Windward Islands Tournament,11,7,1,1,1,3,4,0
Grenada,1967,Windward Islands Tournament,7,4,2,0,1,3,3,0
Grenada,1968,Windward Islands Tournament,6,2,1,0,0,1,4,0
Grenada,1969,Windward Islands Tournament,7,0,2,0,1,3,7,0
Grenada,1970,Windward Islands Tournament,13,5,3,0,0,3,8,1
Grenada,1971,Windward Islands Tournament,6,6,1,1,1,3,0,0
Grenada,1972,Windward Islands Tournament,2,2,1,1,1,3,0,0
Grenada,1973,Windward Islands Tournament,9,10,2,2,1,5,-1,0
Grenada,1974,Windward Islands Tournament,3,1,2,0,1,3,2,1
Grenada,1978,Friendly,3,1,1,0,2,3,2,0
Grenada,1979,CFU Caribbean Cup qualification,1,3,0,2,0,2,-2,0
Grenada,1980,CONCACAF Championship qualification,4,8,0,2,0,2,-4,0
Grenada,1981,Friendly,2,8,0,2,0,2,-6,0
Grenada,1984,Windward Islands Tournament,4,0,1,0,0,1,4,1
Grenada,1985,CFU Caribbean Cup qualification,1,8,0,2,0,2,-7,0
Grenada,1985,Windward Islands Tournament,0,0,0,0,1,1,0,0
Grenada,1986,Friendly,1,2,0,1,0,1,-1,0
Grenada,1987,Friendly,1,4,0,1,1,2,-3,0
Grenada,1989,CFU Caribbean Cup,4,3,1,1,1,3,1,0
Grenada,1989,CFU Caribbean Cup qualification,3,1,2,0,2,4,2,0
Grenada,1990,CFU Caribbean Cup qualification,4,2,1,0,2,3,2,0
Grenada,1990,Friendly,1,5,0,1,1,2,-4,0
Grenada,1992,CFU Caribbean Cup qualification,0,1,0,1,0,1,-1,0
Grenada,1993,CFU Caribbean Cup qualification,1,2,0,1,1,2,-1,0
Grenada,1994,CFU Caribbean Cup qualification,3,3,1,1,0,2,0,0
Grenada,1994,Friendly,1,2,0,1,1,2,-1,0
Grenada,1995,CFU Caribbean Cup qualification,2,4,1,1,0,2,-2,0
Grenada,1995,Windward Islands Tournament,2,0,2,0,0,2,2,1
Grenada,1996,CFU Caribbean Cup qualification,1,0,1,0,0,1,1,0
Grenada,1996,FIFA World Cup qualification,9,8,2,2,0,4,1,0
Grenada,1997,CFU Caribbean Cup,6,8,1,2,1,4,-2,0
Grenada,1997,CFU Caribbean Cup qualification,6,2,1,0,1,2,4,0
Grenada,1997,Friendly,3,2,1,0,0,1,1,0
Grenada,1998,CFU Caribbean Cup qualification,15,3,1,1,0,2,12,0
Grenada,1999,CFU Caribbean Cup,3,10,1,2,0,3,-7,0
Grenada,1999,CFU Caribbean Cup qualification,3,1,1,0,1,2,2,0
Grenada,1999,Friendly,3,3,1,1,0,2,0,0
Grenada,2000,FIFA World Cup qualification,4,5,0,1,1,2,-1,0
Grenada,2001,CFU Caribbean Cup qualification,6,7,1,2,0,3,-1,0
Grenada,2001,Friendly,6,9,1,3,0,4,-3,0
Grenada,2001,Windward Islands Tournament,12,6,2,0,0,2,6,0
Grenada,2002,Friendly,13,7,2,2,1,5,6,0
Grenada,2002,Gold Cup qualification,20,15,2,3,0,5,5,0
Grenada,2004,CFU Caribbean Cup qualification,7,6,1,1,1,3,1,0
Grenada,2004,FIFA World Cup qualification,10,7,2,2,0,4,3,0
Grenada,2004,Friendly,6,9,1,3,2,6,-3,0
Grenada,2005,Friendly,0,3,0,1,0,1,-3,0
Grenada,2006,CFU Caribbean Cup qualification,1,3,0,2,1,3,-2,0
Grenada,2006,Friendly,3,3,0,0,2,2,0,0
Grenada,2008,CFU Caribbean Cup,8,11,2,2,1,5,-3,0
Grenada,2008,CFU Caribbean Cup qualification,10,9,2,2,1,5,1,0
Grenada,2008,FIFA World Cup qualification,12,5,1,1,1,3,7,0
Grenada,2008,Friendly,4,4,2,1,0,3,0,0
Grenada,2009,Friendly,2,7,0,1,1,2,-5,0
Grenada,2009,Gold Cup,0,10,0,3,0,3,-10,0
Grenada,2010,CFU Caribbean Cup,3,4,1,2,2,5,-1,0
Grenada,2010,CFU Caribbean Cup qualification,5,4,2,1,0,3,1,0
Grenada,2010,Friendly,2,2,0,0,1,1,0,0
Grenada,2011,FIFA World Cup qualification,7,14,1,4,1,6,-7,0
Grenada,2011,Friendly,2,5,0,2,2,4,-3,0
Grenada,2011,Gold Cup,1,15,0,3,0,3,-14,0
Grenada,2012,CFU Caribbean Cup qualification,1,1,0,0,1,1,0,0
Grenada,2012,Friendly,1,2,0,1,0,1,-1,0
Grenada,2014,CFU Caribbean Cup qualification,4,5,0,1,2,3,-1,0
Grenada,2014,Windward Islands Tournament,5,4,1,1,0,2,1,1
Grenada,2015,FIFA World Cup qualification,3,7,1,3,0,4,-4,0
Grenada,2015,Friendly,0,4,0,2,0,2,-4,0
Grenada,2015,Windward Islands Tournament,3,2,1,1,0,2,1,1
Grenada,2016,CFU Caribbean Cup qualification,5,4,1,0,1,2,1,0
Grenada,2017,Friendly,8,13,2,3,1,6,-5,0
Grenada,2017,Windward Islands Tournament,0,2,0,1,0,1,-2,0
Grenada,2018,CONCACAF Nations League qualification,5,14,1,2,0,3,-9,0
Grenada,2018,Friendly,3,9,0,2,0,2,-6,0
Grenada,2019,CONCACAF Nations League,8,4,4,0,2,6,4,0
Grenada,2019,CONCACAF Nations League qualification,2,0,1,0,0,1,2,0
Grenada,2019,Friendly,0,3,0,1,0,1,-3,0
Grenada,2021,FIFA World Cup qualification,2,5,1,3,0,4,-3,0
Grenada,2021,Gold Cup,1,11,0,3,0,3,-10,0
Grenada,2022,CONCACAF Nations League,3,10,0,2,1,3,-7,0
Grenada,2022,Friendly,6,5,1,2,1,4,1,0
Grenada,2023,CONCACAF Nations League,3,20,0,4,1,5,-17,0
Grenada,2023,Friendly,6,5,1,1,2,4,1,0
Grenada,2023,Gold Cup qualification,1,1,0,0,1,1,0,0
Grenada,2024,CONCACAF Nations League,7,6,2,3,1,6,1,0
Grenada,2024,FIFA World Cup qualification,2,5,0,1,1,2,-3,0
Grenada,2024,Friendly,0,3,0,1,0,1,-3,0
Grenada,2025,Friendly,1,6,0,1,1,2,-5,0
Guadeloupe,1934,Friendly,0,6,0,1,0,1,-6,0
Guadeloupe,1941,Friendly,1,7,0,2,0,2,-6,0
Guadeloupe,1948,Friendly,11,2,3,0,0,3,9,0
Guadeloupe,1950,Friendly,0,1,0,1,0,1,-1,0
Guadeloupe,1951,Friendly,1,6,0,2,1,3,-5,0
Guadeloupe,1952,Friendly,6,1,2,0,0,2,5,0
Guadeloupe,1953,Friendly,3,6,0,2,0,2,-3,0
Guadeloupe,1954,Friendly,4,6,0,1,1,2,-2,0
Guadeloupe,1955,Friendly,2,5,0,1,1,2,-3,0
Guadeloupe,1956,Friendly,3,7,0,2,1,3,-4,0
Guadeloupe,1957,Friendly,6,8,1,1,0,2,-2,0
Guadeloupe,1958,Friendly,1,1,0,0,1,1,0,0
Guadeloupe,1959,Friendly,8,8,2,1,1,4,0,0
Guadeloupe,1960,Friendly,2,3,0,1,1,2,-1,0
Guadeloupe,1961,Friendly,2,2,0,0,1,1,0,0
Guadeloupe,1962,Friendly,11,7,3,1,1,5,4,0
Guadeloupe,1963,Friendly,6,0,2,0,0,2,6,0
Guadeloupe,1964,Friendly,4,1,1,1,0,2,3,0
Guadeloupe,1966,Friendly,2,12,1,3,1,5,-10,0
Guadeloupe,1967,Friendly,5,5,1,2,0,3,0,0
Guadeloupe,1968,Friendly,5,1,2,0,0,2,4,0
Guadeloupe,1971,Friendly,2,3,0,1,1,2,-1,0
Guadeloupe,1972,Friendly,4,4,0,0,1,1,0,0
Guadeloupe,1973,Friendly,0,2,0,1,0,1,-2,0
Guadeloupe,1975,Friendly,8,14,2,2,0,4,-6,0
Guadeloupe,1976,Friendly,2,4,0,2,0,2,-2,0
Guadeloupe,1977,Friendly,1,4,0,2,0,2,-3,0
Guadeloupe,1978,CFU Caribbean Cup qualification,3,1,2,0,0,2,2,0
Guadeloupe,1978,Friendly,2,1,1,0,0,1,1,0
Guadeloupe,1979,CFU Caribbean Cup qualification,1,3,0,1,1,2,-2,0
Guadeloupe,1979,Friendly,0,1,0,1,0,1,-1,0
Guadeloupe,1980,Friendly,0,1,0,1,0,1,-1,0
Guadeloupe,1981,CFU Caribbean Cup,2,6,0,2,1,3,-4,0
Guadeloupe,1981,CFU Caribbean Cup qualification,12,5,3,1,0,4,7,0
Guadeloupe,1983,CFU Caribbean Cup qualification,8,7,2,1,1,4,1,0
Guadeloupe,1985,CFU Caribbean Cup,4,5,0,1,2,3,-1,0
Guadeloupe,1985,CFU Caribbean Cup qualification,3,1,2,0,1,3,2,0
Guadeloupe,1986,Friendly,1,2,0,1,0,1,-1,0
Guadeloupe,1987,Friendly,7,1,2,0,0,2,6,0
Guadeloupe,1988,CFU Caribbean Cup,1,5,0,2,1,3,-4,0
Guadeloupe,1988,CFU Caribbean Cup qualification,1,3,0,1,1,2,-2,0
Guadeloupe,1988,Friendly,2,1,1,0,0,1,1,0
Guadeloupe,1989,CFU Caribbean Cup,2,1,1,1,0,2,1,0
Guadeloupe,1989,CFU Caribbean Cup qualification,3,1,1,0,1,2,2,0
Guadeloupe,1989,Friendly,0,2,0,1,0,1,-2,0
Guadeloupe,1990,CFU Caribbean Cup qualification,1,4,0,2,1,3,-3,0
Guadeloupe,1990,Friendly,1,0,1,0,0,1,1,0
Guadeloupe,1991,CFU Caribbean Cup qualification,2,3,1,1,0,2,-1,0
Guadeloupe,1992,CFU Caribbean Cup,0,1,0,1,0,1,-1,0
Guadeloupe,1992,CFU Caribbean Cup qualification,0,0,0,0,1,1,0,0
Guadeloupe,1992,Friendly,1,1,0,0,1,1,0,0
Guadeloupe,1993,CFU Caribbean Cup qualification,2,6,0,2,0,2,-4,0
Guadeloupe,1993,Friendly,0,5,0,2,0,2,-5,0
Guadeloupe,1994,CFU Caribbean Cup,4,4,1,1,0,2,0,0
Guadeloupe,1994,CFU Caribbean Cup qualification,9,0,1,0,0,1,9,0
Guadeloupe,1995,CFU Caribbean Cup qualification,5,5,1,1,1,3,0,0
Guadeloupe,1998,CFU Caribbean Cup qualification,5,3,1,1,1,3,2,0
Guadeloupe,1999,CFU Caribbean Cup,4,10,0,3,0,3,-6,0
Guadeloupe,1999,CFU Caribbean Cup qualification,4,1,3,0,0,3,3,0
Guadeloupe,2001,CFU Caribbean Cup qualification,13,5,1,2,0,3,8,0
Guadeloupe,2001,Friendly,1,4,0,1,0,1,-3,0
Guadeloupe,2002,Friendly,3,1,1,0,0,1,2,0
Guadeloupe,2002,Gold Cup qualification,12,6,4,1,0,5,6,0
Guadeloupe,2003,Friendly,3,2,1,0,1,2,1,0
Guadeloupe,2003,Gold Cup qualification,4,4,1,2,0,3,0,0
Guadeloupe,2004,CFU Caribbean Cup qualification,7,1,1,1,1,3,6,0
Guadeloupe,2004,Friendly,2,0,1,0,0,1,2,0
Guadeloupe,2005,Friendly,3,1,1,0,0,1,2,0
Guadeloupe,2006,CFU Caribbean Cup qualification,14,4,5,1,0,6,10,1
Guadeloupe,2006,Friendly,2,1,1,0,0,1,1,0
Guadeloupe,2007,CFU Caribbean Cup,8,10,2,3,0,5,-2,0
Guadeloupe,2007,Friendly,8,8,2,1,2,5,0,0
Guadeloupe,2007,Gold Cup,5,5,2,2,1,5,0,0
Guadeloupe,2008,CFU Caribbean Cup,6,8,1,2,2,5,-2,0
Guadeloupe,2008,CFU Caribbean Cup qualification,12,3,3,0,0,3,9,0
Guadeloupe,2008,Coupe de l'Outre-Mer,9,1,3,1,0,4,8,0
Guadeloupe,2008,Friendly,3,0,1,0,1,2,3,0
Guadeloupe,2009,Gold Cup,5,8,2,2,0,4,-3,0
Guadeloupe,2010,CFU Caribbean Cup,5,5,2,1,2,5,0,0
Guadeloupe,2010,CFU Caribbean Cup qualification,8,3,3,0,0,3,5,0
Guadeloupe,2010,Coupe de l'Outre-Mer,8,2,2,0,2,4,6,0
Guadeloupe,2010,Friendly,2,4,1,1,0,2,-2,0
Guadeloupe,2011,Friendly,0,0,0,0,1,1,0,0
Guadeloupe,2011,Gold Cup,2,5,0,3,0,3,-3,0
Guadeloupe,2012,CFU Caribbean Cup qualification,7,6,1,1,1,3,1,0
Guadeloupe,2012,Coupe de l'Outre-Mer,19,4,3,1,0,4,15,1
Guadeloupe,2012,Friendly,11,5,2,2,0,4,6,0
Guadeloupe,2014,CFU Caribbean Cup qualification,0,1,0,1,0,1,-1,0
Guadeloupe,2014,Friendly,3,2,1,0,0,1,1,0
Guadeloupe,2015,Friendly,0,2,0,1,0,1,-2,0
Guadeloupe,2016,CFU Caribbean Cup qualification,4,6,1,2,1,4,-2,0
Guadeloupe,2016,Friendly,1,1,0,0,1,1,0,0
Guadeloupe,2017,Friendly,3,6,0,1,1,2,-3,0
Guadeloupe,2018,CONCACAF Nations League qualification,3,6,1,1,1,3,-3,0
Guadeloupe,2018,Friendly,0,3,0,2,0,2,-3,0
Guadeloupe,2019,CONCACAF Nations League,20,2,4,0,0,4,18,0
Guadeloupe,2019,CONCACAF Nations League qualification,0,1,0,1,0,1,-1,0
Guadeloupe,2021,Gold Cup,3,7,0,3,0,3,-4,0
Guadeloupe,2021,Gold Cup qualification,3,1,1,0,1,2,2,0
Guadeloupe,2022,CONCACAF Nations League,5,3,3,1,0,4,2,0
Guadeloupe,2022,Friendly,0,2,0,1,0,1,-2,0
Guadeloupe,2023,CONCACAF Nations League,16,5,5,3,0,8,11,0
Guadeloupe,2023,Gold Cup,8,6,1,1,1,3,2,0
Guadeloupe,2023,Gold Cup qualification,7,0,2,0,0,2,7,1
Guadeloupe,2024,CONCACAF Nations League,8,4,3,2,1,6,4,0
Guadeloupe,2025,Gold Cup qualification,2,0,2,0,0,2,2,0
Guam,1975,South Pacific Games,1,16,0,2,0,2,-15,0
Guam,1979,South Pacific Games,12,18,2,2,0,4,-6,0
Guam,1991,South Pacific Games,1,52,0,4,0,4,-51,0
Guam,1993,South Pacific Mini Games,1,35,0,3,0,3,-34,0
Guam,1995,South Pacific Games,0,23,0,3,0,3,-23,0
Guam,1996,AFC Asian Cup qualification,0,18,0,2,0,2,-18,0
Guam,1997,East Asian Games,1,43,0,4,0,4,-42,0
Guam,1998,Friendly,17,6,2,1,0,3,11,0
Guam,1999,Friendly,7,1,2,0,0,2,6,0
Guam,2000,AFC Asian Cup qualification,0,32,0,3,0,3,-32,0
Guam,2000,FIFA World Cup qualification,0,35,0,2,0,2,-35,0
Guam,2003,AFC Asian Cup qualification,0,11,0,2,0,2,-11,0
Guam,2003,EAFF Championship,0,22,0,4,0,4,-22,0
Guam,2005,EAFF Championship,1,40,0,3,0,3,-39,0
Guam,2006,AFC Challenge Cup,0,17,0,3,0,3,-17,0
Guam,2007,EAFF Championship,15,32,2,3,0,5,-17,0
Guam,2008,AFC Challenge Cup qualification,4,18,0,3,0,3,-14,0
Guam,2008,Friendly,3,2,1,0,0,1,1,0
Guam,2009,EAFF Championship,7,24,2,2,1,5,-17,0
Guam,2010,Friendly,1,1,0,0,1,1,0,0
Guam,2011,Pacific Games,4,21,1,3,1,5,-17,0
Guam,2012,EAFF Championship,7,17,2,3,0,5,-10,0
Guam,2012,Friendly,11,4,2,2,0,4,7,0
Guam,2013,AFC Challenge Cup qualification,0,9,0,2,0,2,-9,0
Guam,2013,Friendly,2,0,1,0,0,1,2,0
Guam,2014,EAFF Championship,8,5,2,1,2,5,3,0
Guam,2014,Friendly,2,4,0,1,1,2,-2,0
Guam,2015,FIFA World Cup qualification,3,15,2,4,1,7,-12,0
Guam,2015,Friendly,2,3,0,1,1,2,-1,0
Guam,2016,EAFF Championship,2,5,0,2,0,2,-3,0
Guam,2016,FIFA World Cup qualification,0,1,0,1,0,1,-1,0
Guam,2018,EAFF Championship,5,3,1,1,1,3,2,0
Guam,2019,FIFA World Cup qualification,7,20,1,6,0,7,-13,0
Guam,2019,Friendly,0,3,0,1,0,1,-3,0
Guam,2021,AFC Asian Cup qualification,1,3,0,2,0,2,-2,0
Guam,2021,FIFA World Cup qualification,0,13,0,3,0,3,-13,0
Guam,2023,FIFA World Cup qualification,1,3,0,2,0,2,-2,0
Guam,2024,EAFF Championship qualification,2,6,1,1,0,2,-4,0
Guam,2024,Marianas Cup,3,4,0,1,1,2,-1,0
Guatemala,1921,Friendly,0,6,0,1,0,1,-6,0
Guatemala,1923,Friendly,10,15,1,4,1,6,-5,0
Guatemala,1930,Central American and Caribbean Games,3,16,0,2,0,2,-13,0
Guatemala,1935,Central American and Caribbean Games,6,17,0,4,1,5,-11,0
Guatemala,1943,CCCF Championship,21,11,4,1,1,6,10,0
Guatemala,1946,CCCF Championship,20,10,3,1,1,5,10,0
Guatemala,1946,Central American and Caribbean Games,12,20,1,4,1,6,-8,0
Guatemala,1948,CCCF Championship,20,16,3,1,4,8,4,0
Guatemala,1950,Friendly,1,4,0,2,0,2,-3,0
Guatemala,1953,CCCF Championship,8,8,3,1,2,6,0,0
Guatemala,1955,CCCF Championship,6,6,1,2,0,3,0,0
Guatemala,1955,Friendly,4,10,1,1,0,2,-6,0
Guatemala,1957,FIFA World Cup qualification,4,12,0,3,0,3,-8,0
Guatemala,1960,FIFA World Cup qualification,7,8,0,1,2,3,-1,0
Guatemala,1961,CCCF Championship,3,3,1,1,0,2,0,0
Guatemala,1963,CONCACAF Championship,7,6,1,1,2,4,1,0
Guatemala,1963,Friendly,3,3,1,1,0,2,0,0
Guatemala,1965,CONCACAF Championship,11,5,3,1,1,5,6,0
Guatemala,1965,Friendly,1,7,0,2,0,2,-6,0
Guatemala,1966,Friendly,1,0,1,0,0,1,1,0
Guatemala,1967,CONCACAF Championship,7,1,4,0,1,5,6,0
Guatemala,1967,CONCACAF Championship qualification,6,2,2,0,0,2,4,1
Guatemala,1967,Friendly,8,3,3,0,1,4,5,0
Guatemala,1968,FIFA World Cup qualification,4,2,1,1,1,3,2,0
Guatemala,1968,Friendly,0,4,0,2,0,2,-4,0
Guatemala,1969,CONCACAF Championship,10,2,3,0,2,5,8,0
Guatemala,1969,FIFA World Cup qualification,1,1,0,0,1,1,0,0
Guatemala,1969,Friendly,1,3,0,1,0,1,-2,0
Guatemala,1971,CONCACAF Championship qualification,1,2,0,1,1,2,-1,0
Guatemala,1972,CONCACAF Championship qualification,2,0,2,0,0,2,2,1
Guatemala,1972,Friendly,3,3,0,0,3,3,0,0
Guatemala,1973,CONCACAF Championship,4,6,0,2,3,5,-2,0
Guatemala,1973,Friendly,1,5,0,1,0,1,-4,0
Guatemala,1975,Friendly,0,2,0,1,0,1,-2,0
Guatemala,1976,CONCACAF Championship qualification,15,6,3,1,2,6,9,0
Guatemala,1976,Friendly,2,0,2,0,0,2,2,0
Guatemala,1977,CONCACAF Championship,8,10,1,3,1,5,-2,0
Guatemala,1977,Friendly,5,1,2,0,0,2,4,0
Guatemala,1980,CONCACAF Championship qualification,10,2,3,2,3,8,8,0
Guatemala,1980,Friendly,10,16,0,5,4,9,-6,0
Guatemala,1983,Friendly,3,6,1,2,2,5,-3,0
Guatemala,1984,Friendly,10,6,4,3,0,7,4,0
Guatemala,1984,Korea Cup,0,2,0,1,0,1,-2,0
Guatemala,1985,CONCACAF Championship,7,3,2,1,1,4,4,0
Guatemala,1985,Friendly,1,2,1,1,1,3,-1,0
Guatemala,1987,Friendly,2,1,1,1,0,2,1,0
Guatemala,1988,CONCACAF Championship qualification,5,4,2,1,1,4,1,0
Guatemala,1988,Friendly,4,6,2,4,2,8,-2,0
Guatemala,1988,Marlboro Cup,2,1,1,0,0,1,1,1
Guatemala,1989,CONCACAF Championship,4,7,1,4,1,6,-3,0
Guatemala,1989,Friendly,8,8,2,4,0,6,0,0
Guatemala,1990,Friendly,0,3,0,1,0,1,-3,0
Guatemala,1991,Gold Cup,1,5,1,2,0,3,-4,0
Guatemala,1991,UNCAF Cup,0,1,0,1,2,3,-1,0
Guatemala,1992,FIFA World Cup qualification,0,2,0,1,1,2,-2,0
Guatemala,1992,Friendly,12,5,2,0,2,4,7,0
Guatemala,1995,UNCAF Cup,2,5,2,2,0,4,-3,0
Guatemala,1996,FIFA World Cup qualification,9,10,4,2,2,8,-1,0
Guatemala,1996,Friendly,9,8,3,3,2,8,1,0
Guatemala,1996,Gold Cup,3,5,1,3,0,4,-2,0
Guatemala,1997,Friendly,3,5,1,1,3,5,-2,0
Guatemala,1997,UNCAF Cup,10,3,3,0,2,5,7,0
Guatemala,1998,Friendly,5,5,0,0,2,2,0,0
Guatemala,1998,Gold Cup,3,4,0,1,2,3,-1,0
Guatemala,1999,Friendly,10,20,1,7,3,11,-10,0
Guatemala,1999,UNCAF Cup,5,2,3,1,1,5,3,1
Guatemala,1999,USA Cup,3,4,1,1,0,2,-1,0
Guatemala,2000,FIFA World Cup qualification,21,10,6,3,3,12,11,0
Guatemala,2000,Friendly,9,6,3,1,2,6,3,0
Guatemala,2000,Gold Cup,3,5,0,1,1,2,-2,0
Guatemala,2001,FIFA World Cup qualification,2,5,0,1,0,1,-3,0
Guatemala,2001,Friendly,4,6,0,1,2,3,-2,0
Guatemala,2001,UNCAF Cup,9,5,2,0,3,5,4,0
Guatemala,2002,Friendly,1,1,1,1,1,3,0,0
Guatemala,2002,Gold Cup,1,4,0,2,0,2,-3,0
Guatemala,2003,Friendly,4,7,1,3,3,7,-3,0
Guatemala,2003,Gold Cup,1,3,0,1,1,2,-2,0
Guatemala,2003,UNCAF Cup,10,4,3,1,1,5,6,0
Guatemala,2004,FIFA World Cup qualification,11,11,4,2,2,8,0,0
Guatemala,2004,Friendly,17,8,7,2,2,11,9,0
Guatemala,2005,FIFA World Cup qualification,16,18,3,5,2,10,-2,0
Guatemala,2005,Friendly,5,10,1,4,1,6,-5,0
Guatemala,2005,Gold Cup,4,9,0,2,1,3,-5,0
Guatemala,2005,UNCAF Cup,10,5,3,1,1,5,5,1
Guatemala,2006,Friendly,6,14,0,5,1,6,-8,0
Guatemala,2007,Friendly,4,7,1,3,2,6,-3,0
Guatemala,2007,Gold Cup,2,5,1,2,1,4,-3,0
Guatemala,2007,UNCAF Cup,3,2,3,1,1,5,1,1
Guatemala,2008,FIFA World Cup qualification,15,8,3,3,2,8,7,0
Guatemala,2008,Friendly,4,3,2,2,2,6,1,0
Guatemala,2009,Friendly,2,5,1,2,1,4,-3,0
Guatemala,2009,UNCAF Cup,1,6,0,3,0,3,-5,0
Guatemala,2010,Friendly,17,12,5,3,0,8,5,0
Guatemala,2011,FIFA World Cup qualification,19,3,6,0,0,6,16,0
Guatemala,2011,Friendly,1,3,0,1,1,2,-2,0
Guatemala,2011,Gold Cup,5,4,1,2,1,4,1,0
Guatemala,2011,UNCAF Cup,3,6,1,2,0,3,-3,0
Guatemala,2012,FIFA World Cup qualification,9,8,3,2,1,6,1,0
Guatemala,2012,Friendly,10,13,2,5,1,8,-3,0
Guatemala,2013,Friendly,0,12,0,4,1,5,-12,0
Guatemala,2013,UNCAF Cup,3,5,0,1,3,4,-2,0
Guatemala,2014,Friendly,4,1,2,1,0,3,3,0
Guatemala,2015,FIFA World Cup qualification,8,3,3,2,1,6,5,0
Guatemala,2015,Friendly,2,10,0,3,1,4,-8,0
Guatemala,2015,Gold Cup,1,4,0,2,1,3,-3,0
Guatemala,2016,FIFA World Cup qualification,13,9,2,1,1,4,4,0
Guatemala,2016,Friendly,1,7,0,1,0,1,-6,0
Guatemala,2018,Friendly,4,12,2,3,0,5,-8,0
Guatemala,2019,CONCACAF Nations League,25,0,4,0,0,4,25,0
Guatemala,2019,Friendly,11,5,3,2,2,7,6,0
Guatemala,2020,Friendly,2,1,1,0,1,2,1,0
Guatemala,2021,FIFA World Cup qualification,14,0,3,0,1,4,14,0
Guatemala,2021,Friendly,6,2,3,0,2,5,4,0
Guatemala,2021,Gold Cup,1,6,0,2,1,3,-5,0
Guatemala,2021,Gold Cup qualification,5,1,1,0,1,2,4,0
Guatemala,2022,CONCACAF Nations League,5,3,2,1,1,4,2,0
Guatemala,2022,Friendly,12,10,4,3,1,8,2,0
Guatemala,2023,CONCACAF Nations League,11,8,3,2,1,6,3,0
Guatemala,2023,Friendly,2,5,1,3,3,7,-3,0
Guatemala,2023,Gold Cup,4,3,2,1,1,4,1,0
Guatemala,2024,CONCACAF Nations League,6,5,2,1,1,4,1,0
Guatemala,2024,FIFA World Cup qualification,9,0,2,0,0,2,9,0
Guatemala,2024,Friendly,3,10,0,4,3,7,-7,0
Guatemala,2025,Friendly,2,1,1,0,0,1,1,0
Guatemala,2025,Gold Cup qualification,4,3,1,1,0,2,1,0
Guernsey,1905,Muratti Vase,7,0,2,0,0,2,7,1
Guernsey,1906,Muratti Vase,3,1,2,0,0,2,2,1
Guernsey,1907,Muratti Vase,3,2,1,0,0,1,1,1
Guernsey,1908,Muratti Vase,3,4,1,1,0,2,-1,0
Guernsey,1909,Muratti Vase,5,0,2,0,0,2,5,1
Guernsey,1910,Muratti Vase,2,3,0,1,0,1,-1,0
Guernsey,1911,Muratti Vase,3,5,1,1,0,2,-2,0
Guernsey,1912,Muratti Vase,12,5,2,0,1,3,7,1
Guernsey,1913,Muratti Vase,4,2,1,0,0,1,2,1
Guernsey,1914,Muratti Vase,6,1,2,0,0,2,5,1
Guernsey,1919,Muratti Vase,2,0,1,0,0,1,2,1
Guernsey,1920,Muratti Vase,1,1,1,1,0,2,0,0
Guernsey,1921,Muratti Vase,0,1,0,1,0,1,-1,0
Guernsey,1921,Peace Cup,3,0,1,0,0,1,3,1
Guernsey,1922,Muratti Vase,10,1,2,0,0,2,9,1
Guernsey,1922,Peace Cup,3,1,1,0,0,1,2,1
Guernsey,1923,Muratti Vase,4,2,2,0,0,2,2,1
Guernsey,1923,Peace Cup,2,1,1,0,0,1,1,1
Guernsey,1924,Muratti Vase,0,1,0,1,0,1,-1,0
Guernsey,1924,Peace Cup,1,2,0,1,0,1,-1,0
Guernsey,1925,Muratti Vase,5,1,2,0,0,2,4,1
Guernsey,1925,Peace Cup,7,1,2,0,0,2,6,1
Guernsey,1926,Muratti Vase,1,5,0,1,0,1,-4,0
Guernsey,1927,Muratti Vase,1,0,1,0,0,1,1,1
Guernsey,1928,Muratti Vase,5,2,1,1,0,2,3,0
Guernsey,1929,Muratti Vase,12,1,2,0,0,2,11,1
Guernsey,1930,Muratti Vase,3,2,1,0,0,1,1,1
Guernsey,1931,Muratti Vase,3,4,1,1,0,2,-1,0
Guernsey,1932,Muratti Vase,6,2,2,0,0,2,4,1
Guernsey,1933,Muratti Vase,4,1,1,0,0,1,3,1
Guernsey,1934,Muratti Vase,4,0,2,0,0,2,4,1
Guernsey,1935,Muratti Vase,6,0,2,0,0,2,6,1
Guernsey,1936,Muratti Vase,2,1,1,0,0,1,1,1
Guernsey,1937,Muratti Vase,9,6,1,0,2,3,3,0
Guernsey,1938,Muratti Vase,7,4,2,0,0,2,3,1
Guernsey,1939,Muratti Vase,0,1,0,1,0,1,-1,0
Guernsey,1946,Muratti Vase,0,11,0,2,0,2,-11,0
Guernsey,1947,Muratti Vase,1,3,0,1,0,1,-2,0
Guernsey,1948,Muratti Vase,6,6,1,1,0,2,0,0
Guernsey,1949,Muratti Vase,1,2,0,1,0,1,-1,0
Guernsey,1950,Muratti Vase,5,1,2,0,0,2,4,1
Guernsey,1951,Muratti Vase,3,1,1,0,0,1,2,1
Guernsey,1952,Muratti Vase,10,3,2,0,0,2,7,1
Guernsey,1953,Muratti Vase,0,2,0,1,0,1,-2,0
Guernsey,1954,Muratti Vase,7,4,2,0,0,2,3,1
Guernsey,1955,Muratti Vase,0,1,0,1,1,2,-1,0
Guernsey,1956,Muratti Vase,5,2,1,1,0,2,3,0
Guernsey,1957,Muratti Vase,6,4,1,0,0,1,2,1
Guernsey,1958,Muratti Vase,9,4,1,1,0,2,5,0
Guernsey,1959,Muratti Vase,2,3,0,1,0,1,-1,0
Guernsey,1960,Muratti Vase,6,6,1,1,0,2,0,0
Guernsey,1961,Muratti Vase,1,2,0,1,0,1,-1,0
Guernsey,1962,Muratti Vase,7,3,1,1,0,2,4,0
Guernsey,1963,Muratti Vase,1,4,0,1,0,1,-3,0
Guernsey,1964,Muratti Vase,3,1,1,1,0,2,2,0
Guernsey,1965,Muratti Vase,2,4,0,1,0,1,-2,0
Guernsey,1966,Muratti Vase,14,2,2,0,1,3,12,1
Guernsey,1967,Muratti Vase,1,3,0,1,0,1,-2,0
Guernsey,1968,Muratti Vase,3,2,1,1,0,2,1,0
Guernsey,1969,Muratti Vase,2,1,1,0,0,1,1,1
Guernsey,1970,Muratti Vase,5,2,1,1,0,2,3,0
Guernsey,1971,Muratti Vase,0,1,0,1,0,1,-1,0
Guernsey,1972,Muratti Vase,8,0,2,0,0,2,8,1
Guernsey,1973,Muratti Vase,1,4,0,1,0,1,-3,0
Guernsey,1974,Muratti Vase,8,1,2,0,0,2,7,1
Guernsey,1975,Muratti Vase,5,4,1,0,1,2,1,1
Guernsey,1976,Muratti Vase,6,3,1,1,0,2,3,0
Guernsey,1977,Muratti Vase,1,5,0,1,0,1,-4,0
Guernsey,1978,Muratti Vase,14,0,2,0,0,2,14,1
Guernsey,1979,Muratti Vase,5,0,1,0,0,1,5,1
Guernsey,1980,Muratti Vase,7,1,2,0,0,2,6,1
Guernsey,1981,Muratti Vase,1,4,0,1,0,1,-3,0
Guernsey,1982,Muratti Vase,6,3,1,1,0,2,3,0
Guernsey,1983,Muratti Vase,2,1,1,0,0,1,1,1
Guernsey,1984,Muratti Vase,8,6,1,1,0,2,2,0
Guernsey,1985,Muratti Vase,4,3,1,0,0,1,1,1
Guernsey,1986,Muratti Vase,9,3,1,1,0,2,6,0
Guernsey,1987,Muratti Vase,3,4,0,1,0,1,-1,0
Guernsey,1988,Muratti Vase,6,1,2,0,0,2,5,1
Guernsey,1989,Muratti Vase,0,4,0,1,0,1,-4,0
Guernsey,1990,Muratti Vase,5,2,1,1,0,2,3,0
Guernsey,1991,Island Games,2,6,0,3,1,4,-4,0
Guernsey,1991,Muratti Vase,3,0,1,0,0,1,3,1
Guernsey,1992,Muratti Vase,12,3,2,0,0,2,9,1
Guernsey,1993,Muratti Vase,11,2,1,1,0,2,9,0
Guernsey,1994,Muratti Vase,1,3,0,1,0,1,-2,0
Guernsey,1995,Island Games,7,6,1,1,2,4,1,0
Guernsey,1995,Muratti Vase,1,2,0,1,0,1,-1,0
Guernsey,1996,Muratti Vase,2,1,1,1,1,3,1,0
Guernsey,1997,Island Games,5,9,2,2,1,5,-4,0
Guernsey,1997,Muratti Vase,8,1,2,0,0,2,7,1
Guernsey,1998,Friendly,1,6,0,1,0,1,-5,0
Guernsey,1998,Muratti Vase,0,2,0,1,0,1,-2,0
Guernsey,1999,Island Games,11,8,2,0,2,4,3,0
Guernsey,1999,Muratti Vase,3,0,2,0,0,2,3,1
Guernsey,2000,Friendly,2,1,1,0,0,1,1,0
Guernsey,2000,Muratti Vase,0,1,0,1,0,1,-1,0
Guernsey,2001,Island Games,9,4,3,0,1,4,5,0
Guernsey,2001,Muratti Vase,10,1,2,0,0,2,9,1
Guernsey,2002,Muratti Vase,1,2,0,1,0,1,-1,0
Guernsey,2003,Island Games,23,3,4,0,0,4,20,0
Guernsey,2003,Muratti Vase,7,5,1,1,1,3,2,0
Guernsey,2004,Muratti Vase,0,3,0,1,0,1,-3,0
Guernsey,2005,Island Games,14,3,4,1,0,5,11,0
Guernsey,2005,Muratti Vase,5,4,1,0,2,3,1,0
Guernsey,2006,Muratti Vase,2,3,0,1,0,1,-1,0
Guernsey,2007,Friendly,1,1,0,0,1,1,0,0
Guernsey,2007,Muratti Vase,5,0,1,0,1,2,5,0
Guernsey,2008,Muratti Vase,1,1,0,0,1,1,0,0
Guernsey,2009,Island Games,15,2,3,1,1,5,13,0
Guernsey,2009,Muratti Vase,5,1,1,1,0,2,4,0
Guernsey,2010,Muratti Vase,1,0,1,0,0,1,1,1
Guernsey,2011,Island Games,17,9,4,1,0,5,8,0
Guernsey,2011,Muratti Vase,6,1,1,0,1,2,5,0
Guernsey,2012,Muratti Vase,9,0,2,0,0,2,9,1
Guernsey,2013,Muratti Vase,2,1,1,0,0,1,1,1
Guernsey,2014,Muratti Vase,8,1,2,0,0,2,7,1
Guernsey,2015,Island Games,17,3,5,0,0,5,14,1
Guernsey,2015,Muratti Vase,2,3,0,1,0,1,-1,0
Guernsey,2016,Muratti Vase,1,1,1,1,0,2,0,0
Guernsey,2017,Island Games,9,6,2,1,2,5,3,0
Guernsey,2017,Muratti Vase,2,1,1,0,0,1,1,1
Guernsey,2018,Muratti Vase,2,1,1,1,0,2,1,0
Guernsey,2019,Inter Games Football Tournament,15,5,3,1,0,4,10,0
Guernsey,2019,Muratti Vase,0,0,0,0,1,1,0,0
Guernsey,2022,Muratti Vase,3,3,1,2,0,3,0,0
Guernsey,2023,Island Games,7,3,3,1,0,4,4,0
Guinea,1962,Friendly,3,5,0,2,0,2,-2,0
Guinea,1963,African Cup of Nations qualification,2,2,0,0,1,1,0,0
Guinea,1963,Friendly,6,2,1,0,1,2,4,1
Guinea,1964,Friendly,2,1,1,0,0,1,1,0
Guinea,1965,African Cup of Nations qualification,6,6,2,2,0,4,0,0
Guinea,1965,Friendly,4,8,1,3,0,4,-4,0
Guinea,1966,Friendly,12,3,2,1,1,4,9,0
Guinea,1967,African Cup of Nations qualification,10,8,2,2,1,5,2,0
Guinea,1967,Friendly,1,2,0,1,0,1,-1,0
Guinea,1968,Friendly,12,10,3,2,2,7,2,0
Guinea,1969,African Cup of Nations qualification,10,5,2,0,2,4,5,0
Guinea,1969,Friendly,8,4,1,0,2,3,4,0
Guinea,1970,African Cup of Nations,4,7,0,1,2,3,-3,0
Guinea,1970,Friendly,18,8,6,1,0,7,10,0
Guinea,1971,African Cup of Nations qualification,2,3,1,1,2,4,-1,0
Guinea,1971,Friendly,20,14,4,3,0,7,6,0
Guinea,1972,FIFA World Cup qualification,5,2,1,1,0,2,3,0
Guinea,1972,Friendly,6,11,1,2,3,6,-5,0
Guinea,1973,African Cup of Nations qualification,3,3,0,0,2,2,0,0
Guinea,1973,All-African Games,14,7,4,1,0,5,7,0
Guinea,1973,FIFA World Cup qualification,1,3,0,1,1,2,-2,0
Guinea,1973,Friendly,2,5,0,1,1,2,-3,0
Guinea,1974,African Cup of Nations,4,4,1,1,1,3,0,0
Guinea,1974,Friendly,5,10,0,2,2,4,-5,0
Guinea,1975,African Cup of Nations qualification,11,4,3,0,1,4,7,0
Guinea,1975,Friendly,5,1,2,1,0,3,4,0
Guinea,1976,African Cup of Nations,11,7,3,0,3,6,4,0
Guinea,1976,FIFA World Cup qualification,3,3,1,1,0,2,0,0
Guinea,1976,Friendly,9,5,2,1,2,5,4,0
Guinea,1977,African Cup of Nations qualification,8,5,3,1,0,4,3,1
Guinea,1977,FIFA World Cup qualification,8,4,4,1,0,5,4,0
Guinea,1977,Friendly,0,1,0,1,0,1,-1,0
Guinea,1979,African Cup of Nations qualification,8,7,2,2,0,4,1,0
Guinea,1979,Amílcar Cabral Cup,8,8,1,2,2,5,0,0
Guinea,1979,Friendly,2,3,0,1,1,2,-1,0
Guinea,1980,African Cup of Nations,3,5,0,2,1,3,-2,0
Guinea,1980,Amílcar Cabral Cup,3,3,1,1,1,3,0,0
Guinea,1980,FIFA World Cup qualification,5,2,2,0,2,4,3,0
Guinea,1980,Friendly,5,6,1,2,1,4,-1,0
Guinea,1981,African Cup of Nations qualification,3,3,0,0,2,2,0,0
Guinea,1981,Amílcar Cabral Cup,5,3,2,0,3,5,2,0
Guinea,1981,FIFA World Cup qualification,1,2,0,1,1,2,-1,0
Guinea,1981,Friendly,2,2,1,1,0,2,0,0
Guinea,1982,Amílcar Cabral Cup,6,1,3,0,2,5,5,1
Guinea,1982,Friendly,2,5,0,1,3,4,-3,0
Guinea,1983,African Cup of Nations qualification,0,3,0,2,0,2,-3,0
Guinea,1983,Amílcar Cabral Cup,3,7,0,2,1,3,-4,0
Guinea,1983,Friendly,7,6,1,2,2,5,1,0
Guinea,1984,Amílcar Cabral Cup,3,3,0,0,3,3,0,0
Guinea,1984,Friendly,8,11,2,4,4,10,-3,0
Guinea,1985,African Cup of Nations qualification,2,5,0,1,1,2,-3,0
Guinea,1985,Amílcar Cabral Cup,2,5,1,2,0,3,-3,0
Guinea,1985,FIFA World Cup qualification,1,2,1,1,0,2,-1,0
Guinea,1985,Friendly,4,6,1,2,3,6,-2,0
Guinea,1986,African Cup of Nations qualification,3,1,2,0,0,2,2,0
Guinea,1986,Amílcar Cabral Cup,3,5,0,2,1,3,-2,0
Guinea,1986,Friendly,1,4,0,2,1,3,-3,0
Guinea,1987,African Cup of Nations qualification,0,4,0,1,1,2,-4,0
Guinea,1987,Amílcar Cabral Cup,3,0,3,0,2,5,3,1
Guinea,1987,Friendly,1,0,1,0,0,1,1,0
Guinea,1988,Amílcar Cabral Cup,6,2,2,0,3,5,4,0
Guinea,1988,FIFA World Cup qualification,3,5,1,1,0,2,-2,0
Guinea,1988,Friendly,2,1,2,1,0,3,1,0
Guinea,1989,African Cup of Nations qualification,1,4,0,1,1,2,-3,0
Guinea,1989,Amílcar Cabral Cup,4,4,2,1,0,3,0,0
Guinea,1989,Friendly,3,7,1,3,2,6,-4,0
Guinea,1990,African Cup of Nations qualification,2,3,0,1,1,2,-1,0
Guinea,1991,African Cup of Nations qualification,3,2,2,1,1,4,1,0
Guinea,1991,Amílcar Cabral Cup,0,3,0,2,1,3,-3,0
Guinea,1991,Friendly,0,0,0,0,2,2,0,0
Guinea,1992,African Cup of Nations qualification,2,2,0,0,1,1,0,0
Guinea,1992,FIFA World Cup qualification,4,0,1,0,0,1,4,1
Guinea,1992,Friendly,0,0,0,0,1,1,0,0
Guinea,1993,African Cup of Nations qualification,3,2,1,0,3,4,1,0
Guinea,1993,Amílcar Cabral Cup,2,3,0,1,1,2,-1,0
Guinea,1993,FIFA World Cup qualification,4,7,1,4,0,5,-3,0
Guinea,1993,Friendly,6,3,2,2,0,4,3,0
Guinea,1994,African Cup of Nations,1,3,0,2,0,2,-2,0
Guinea,1994,African Cup of Nations qualification,5,5,2,2,0,4,0,0
Guinea,1994,Friendly,5,4,1,1,2,4,1,0
Guinea,1995,African Cup of Nations qualification,12,4,3,1,2,6,8,0
Guinea,1995,Amílcar Cabral Cup,1,7,0,3,0,3,-6,0
Guinea,1995,Friendly,3,1,1,0,0,1,2,0
Guinea,1996,FIFA World Cup qualification,8,5,2,1,0,3,3,0
Guinea,1996,Friendly,1,2,0,1,2,3,-1,0
Guinea,1997,African Cup of Nations qualification,2,1,2,1,0,3,1,0
Guinea,1997,Amílcar Cabral Cup,8,4,2,1,2,5,4,0
Guinea,1997,FIFA World Cup qualification,7,4,3,2,0,5,3,0
Guinea,1997,Friendly,1,2,0,1,0,1,-1,0
Guinea,1998,African Cup of Nations,3,3,1,1,1,3,0,0
Guinea,1998,African Cup of Nations qualification,0,2,0,1,0,1,-2,0
Guinea,1998,Friendly,2,4,1,1,0,2,-2,0
Guinea,1999,African Cup of Nations qualification,3,3,1,1,1,3,0,0
Guinea,1999,Friendly,0,2,0,2,0,2,-2,0
Guinea,2000,African Cup of Nations qualification,4,2,1,0,1,2,2,0
Guinea,2000,Amílcar Cabral Cup,8,5,3,1,1,5,3,1
Guinea,2000,FIFA World Cup qualification,7,4,1,0,1,2,3,0
Guinea,2000,Friendly,0,4,0,1,0,1,-4,0
Guinea,2001,Friendly,1,0,1,0,0,1,1,0
Guinea,2002,African Cup of Nations qualification,3,1,1,1,0,2,2,0
Guinea,2002,Friendly,1,3,0,2,0,2,-2,0
Guinea,2003,African Cup of Nations qualification,7,2,3,1,0,4,5,0
Guinea,2003,FIFA World Cup qualification,5,3,2,0,0,2,2,0
Guinea,2003,Friendly,0,1,0,1,1,2,-1,0
Guinea,2004,African Cup of Nations,5,5,1,1,2,4,0,0
Guinea,2004,FIFA World Cup qualification,9,5,2,1,2,5,4,0
Guinea,2004,Friendly,4,5,1,1,1,3,-1,0
Guinea,2005,Amílcar Cabral Cup,3,2,1,0,1,2,1,1
Guinea,2005,FIFA World Cup qualification,6,5,3,2,0,5,1,0
Guinea,2005,Friendly,6,9,1,2,1,4,-3,0
Guinea,2006,African Cup of Nations,9,4,3,1,0,4,5,0
Guinea,2006,African Cup of Nations qualification,0,1,0,1,1,2,-1,0
Guinea,2006,Friendly,2,1,1,0,1,2,1,0
Guinea,2007,African Cup of Nations qualification,10,2,3,0,1,4,8,0
Guinea,2007,Friendly,5,5,1,2,1,4,0,0
Guinea,2008,African Cup of Nations,5,10,1,2,1,4,-5,0
Guinea,2008,FIFA World Cup qualification,9,5,3,1,2,6,4,0
Guinea,2008,Friendly,13,5,3,1,1,5,8,0
Guinea,2009,FIFA World Cup qualification,7,14,1,5,0,6,-7,0
Guinea,2009,Friendly,4,6,0,1,1,2,-2,0
Guinea,2010,African Cup of Nations qualification,5,1,2,0,0,2,4,0
Guinea,2010,Friendly,3,2,1,1,0,2,1,0
Guinea,2011,African Cup of Nations qualification,8,4,2,0,2,4,4,0
Guinea,2011,Friendly,3,7,0,2,2,4,-4,0
Guinea,2012,African Cup of Nations,7,3,1,1,1,3,4,0
Guinea,2012,African Cup of Nations qualification,1,2,1,1,0,2,-1,0
Guinea,2012,FIFA World Cup qualification,3,3,1,1,0,2,0,0
Guinea,2012,Friendly,3,6,1,2,1,4,-3,0
Guinea,2013,FIFA World Cup qualification,9,5,2,1,1,4,4,0
Guinea,2013,Friendly,2,2,0,0,1,1,0,0
Guinea,2014,African Cup of Nations qualification,10,8,3,2,1,6,2,0
Guinea,2014,Friendly,4,2,2,0,0,2,2,0
Guinea,2015,African Cup of Nations,3,6,0,1,3,4,-3,0
Guinea,2015,African Cup of Nations qualification,2,3,0,1,1,2,-1,0
Guinea,2015,FIFA World Cup qualification,3,0,2,0,0,2,3,0
Guinea,2015,Friendly,7,8,2,1,1,4,-1,0
Guinea,2016,African Cup of Nations qualification,3,2,2,1,1,4,1,0
Guinea,2016,FIFA World Cup qualification,1,4,0,2,0,2,-3,0
Guinea,2016,Friendly,1,1,0,0,1,1,0,0
Guinea,2017,African Cup of Nations qualification,3,2,1,0,0,1,1,0
Guinea,2017,FIFA World Cup qualification,5,10,1,3,0,4,-5,0
Guinea,2017,Friendly,5,5,1,1,1,3,0,0
Guinea,2018,African Cup of Nations qualification,5,2,2,0,2,4,3,0
Guinea,2018,Friendly,0,2,0,1,0,1,-2,0
Guinea,2019,African Cup of Nations,4,6,1,2,1,4,-2,0
Guinea,2019,African Cup of Nations qualification,4,2,1,0,2,3,2,0
Guinea,2019,Friendly,3,8,0,4,0,4,-5,0
Guinea,2020,African Cup of Nations qualification,2,1,1,0,1,2,1,0
Guinea,2020,Friendly,2,1,1,0,0,1,1,0
Guinea,2021,African Cup of Nations qualification,2,2,1,1,0,2,0,0
Guinea,2021,FIFA World Cup qualification,5,11,0,2,4,6,-6,0
Guinea,2021,Friendly,4,4,2,1,1,4,0,0
Guinea,2022,African Cup of Nations,2,3,1,2,1,4,-1,0
Guinea,2022,African Cup of Nations qualification,1,1,1,1,0,2,0,0
Guinea,2022,Friendly,3,7,1,3,1,5,-4,0
Guinea,2023,African Cup of Nations qualification,8,6,2,1,1,4,2,0
Guinea,2023,FIFA World Cup qualification,2,2,1,1,0,2,0,0
Guinea,2023,Friendly,3,5,1,1,1,3,-2,0
Guinea,2024,African Cup of Nations,4,6,2,2,1,5,-2,0
Guinea,2024,African Cup of Nations qualification,8,4,2,2,0,4,4,0
Guinea,2024,FIFA Series,11,1,2,0,0,2,10,0
Guinea,2024,FIFA World Cup qualification,2,2,1,1,0,2,0,0
Guinea,2024,Friendly,2,0,1,0,0,1,2,0
Guinea,2025,FIFA World Cup qualification,0,1,0,1,1,2,-1,0
Guinea-Bissau,1953,Friendly,4,1,2,0,0,2,3,0
Guinea-Bissau,1960,Friendly,7,10,1,2,0,3,-3,0
Guinea-Bissau,1975,Friendly,1,0,1,0,0,1,1,0
Guinea-Bissau,1976,Friendly,2,4,0,1,1,2,-2,0
Guinea-Bissau,1977,Friendly,1,3,0,1,0,1,-2,0
Guinea-Bissau,1979,Amílcar Cabral Cup,6,5,1,1,2,4,1,0
Guinea-Bissau,1980,Amílcar Cabral Cup,3,8,0,3,0,3,-5,0
Guinea-Bissau,1981,Amílcar Cabral Cup,4,7,1,2,0,3,-3,0
Guinea-Bissau,1982,Amílcar Cabral Cup,1,3,0,2,1,3,-2,0
Guinea-Bissau,1983,Amílcar Cabral Cup,7,8,2,1,2,5,-1,0
Guinea-Bissau,1983,Friendly,2,6,1,2,0,3,-4,0
Guinea-Bissau,1984,Amílcar Cabral Cup,5,4,2,1,0,3,1,0
Guinea-Bissau,1985,Amílcar Cabral Cup,0,3,0,2,1,3,-3,0
Guinea-Bissau,1985,Friendly,1,3,0,1,0,1,-2,0
Guinea-Bissau,1986,Amílcar Cabral Cup,3,6,1,2,0,3,-3,0
Guinea-Bissau,1987,Amílcar Cabral Cup,1,1,0,0,3,3,0,0
Guinea-Bissau,1987,Friendly,2,0,1,0,1,2,2,0
Guinea-Bissau,1988,Amílcar Cabral Cup,4,2,1,0,2,3,2,0
Guinea-Bissau,1989,Amílcar Cabral Cup,4,4,1,1,1,3,0,0
Guinea-Bissau,1990,Friendly,1,0,1,0,0,1,1,0
Guinea-Bissau,1991,Amílcar Cabral Cup,1,6,0,2,0,2,-5,0
Guinea-Bissau,1991,Friendly,4,1,2,0,0,2,3,0
Guinea-Bissau,1992,African Cup of Nations qualification,5,11,2,4,0,6,-6,0
Guinea-Bissau,1993,African Cup of Nations qualification,1,9,0,3,0,3,-8,0
Guinea-Bissau,1993,Amílcar Cabral Cup,1,3,1,1,1,3,-2,0
Guinea-Bissau,1993,Friendly,2,1,1,0,0,1,1,0
Guinea-Bissau,1995,Amílcar Cabral Cup,4,6,2,3,0,5,-2,0
Guinea-Bissau,1996,FIFA World Cup qualification,4,5,1,1,0,2,-1,0
Guinea-Bissau,1997,Amílcar Cabral Cup,2,10,0,3,0,3,-8,0
Guinea-Bissau,2000,Amílcar Cabral Cup,4,5,1,2,0,3,-1,0
Guinea-Bissau,2000,FIFA World Cup qualification,0,3,0,1,1,2,-3,0
Guinea-Bissau,2001,Amílcar Cabral Cup,9,6,2,2,0,4,3,0
Guinea-Bissau,2003,FIFA World Cup qualification,1,4,0,2,0,2,-3,0
Guinea-Bissau,2005,Amílcar Cabral Cup,3,3,0,0,2,2,0,0
Guinea-Bissau,2007,Amílcar Cabral Cup,3,1,1,0,1,2,2,0
Guinea-Bissau,2007,FIFA World Cup qualification,0,1,0,1,1,2,-1,0
Guinea-Bissau,2010,African Cup of Nations qualification,1,1,1,1,0,2,0,0
Guinea-Bissau,2010,Friendly,1,2,0,1,0,1,-1,0
Guinea-Bissau,2011,African Cup of Nations qualification,1,7,0,4,0,4,-6,0
Guinea-Bissau,2011,FIFA World Cup qualification,1,2,0,1,1,2,-1,0
Guinea-Bissau,2011,Friendly,7,2,2,0,0,2,5,0
Guinea-Bissau,2012,African Cup of Nations qualification,0,2,0,2,0,2,-2,0
Guinea-Bissau,2014,African Cup of Nations qualification,4,4,1,1,2,4,0,0
Guinea-Bissau,2015,African Cup of Nations qualification,2,4,0,1,1,2,-2,0
Guinea-Bissau,2015,FIFA World Cup qualification,2,4,0,1,1,2,-2,0
Guinea-Bissau,2016,African Cup of Nations qualification,5,3,3,1,0,4,2,0
Guinea-Bissau,2017,African Cup of Nations,2,5,0,2,1,3,-3,0
Guinea-Bissau,2017,African Cup of Nations qualification,1,0,1,0,0,1,1,0
Guinea-Bissau,2017,Friendly,1,4,0,2,1,3,-3,0
Guinea-Bissau,2018,African Cup of Nations qualification,5,5,1,1,2,4,0,0
Guinea-Bissau,2018,Friendly,0,2,0,1,0,1,-2,0
Guinea-Bissau,2019,African Cup of Nations,0,4,0,2,1,3,-4,0
Guinea-Bissau,2019,African Cup of Nations qualification,5,5,1,1,1,3,0,0
Guinea-Bissau,2019,FIFA World Cup qualification,3,1,2,0,0,2,2,0
Guinea-Bissau,2019,Friendly,0,2,0,1,0,1,-2,0
Guinea-Bissau,2020,African Cup of Nations qualification,0,3,0,2,0,2,-3,0
Guinea-Bissau,2021,African Cup of Nations qualification,6,1,2,0,0,2,5,0
Guinea-Bissau,2021,FIFA World Cup qualification,5,11,1,2,3,6,-6,0
Guinea-Bissau,2022,African Cup of Nations,0,3,0,2,1,3,-3,0
Guinea-Bissau,2022,African Cup of Nations qualification,7,3,1,0,1,2,4,0
Guinea-Bissau,2022,Friendly,6,6,1,2,1,4,0,0
Guinea-Bissau,2023,African Cup of Nations qualification,4,2,3,1,0,4,2,0
Guinea-Bissau,2023,FIFA World Cup qualification,2,1,1,0,1,2,1,0
Guinea-Bissau,2023,Friendly,0,1,0,1,0,1,-1,0
Guinea-Bissau,2024,African Cup of Nations,2,7,0,3,0,3,-5,0
Guinea-Bissau,2024,African Cup of Nations qualification,2,3,1,2,1,4,-1,0
Guinea-Bissau,2024,FIFA World Cup qualification,1,1,0,0,2,2,0,0
Guinea-Bissau,2024,Friendly,2,6,0,1,0,1,-4,0
Guinea-Bissau,2025,FIFA World Cup qualification,2,5,0,2,0,2,-3,0
Guyana,1905,Friendly,1,4,0,1,0,1,-3,0
Guyana,1921,Friendly,2,1,1,0,0,1,1,0
Guyana,1923,Friendly,1,2,0,1,0,1,-1,0
Guyana,1928,Friendly,1,1,0,0,1,1,0,0
Guyana,1929,Friendly,4,4,2,1,2,5,0,0
Guyana,1931,Friendly,18,3,3,1,0,4,15,0
Guyana,1932,Friendly,5,4,2,1,1,4,1,0
Guyana,1933,Friendly,8,6,2,2,1,5,2,0
Guyana,1937,Friendly,2,14,0,3,0,3,-12,0
Guyana,1938,Friendly,1,6,0,2,1,3,-5,0
Guyana,1943,Friendly,2,5,1,2,0,3,-3,0
Guyana,1944,Friendly,5,7,2,2,1,5,-2,0
Guyana,1945,Friendly,2,13,0,3,0,3,-11,0
Guyana,1946,Friendly,3,5,1,2,0,3,-2,0
Guyana,1947,Friendly,4,8,2,3,2,7,-4,0
Guyana,1948,Friendly,2,6,0,2,0,2,-4,0
Guyana,1950,Friendly,5,14,2,5,0,7,-9,0
Guyana,1951,Friendly,1,15,0,3,0,3,-14,0
Guyana,1952,Friendly,0,9,0,1,0,1,-9,0
Guyana,1956,Friendly,4,4,1,1,1,3,0,0
Guyana,1959,Friendly,4,6,0,2,1,3,-2,0
Guyana,1964,Friendly,5,15,0,4,1,5,-10,0
Guyana,1967,Friendly,2,5,0,2,1,3,-3,0
Guyana,1970,Friendly,2,2,0,0,2,2,0,0
Guyana,1971,CONCACAF Championship qualification,3,7,0,2,0,2,-4,0
Guyana,1973,Friendly,4,6,2,2,0,4,-2,0
Guyana,1976,CONCACAF Championship qualification,2,3,1,1,0,2,-1,0
Guyana,1977,Friendly,6,5,2,1,3,6,1,0
Guyana,1978,CFU Caribbean Cup qualification,1,4,0,2,0,2,-3,0
Guyana,1978,Friendly,1,12,0,4,0,4,-11,0
Guyana,1980,CONCACAF Championship qualification,8,13,2,4,0,6,-5,0
Guyana,1980,Friendly,1,3,0,1,1,2,-2,0
Guyana,1983,CFU Caribbean Cup qualification,3,5,1,1,2,4,-2,0
Guyana,1984,CONCACAF Championship qualification,1,2,0,1,1,2,-1,0
Guyana,1984,Friendly,6,7,1,2,2,5,-1,0
Guyana,1985,CFU Caribbean Cup qualification,1,1,1,1,0,2,0,0
Guyana,1985,Friendly,3,2,1,0,1,2,1,0
Guyana,1986,Friendly,2,1,1,0,0,1,1,0
Guyana,1987,Friendly,10,6,2,1,2,5,4,0
Guyana,1988,CONCACAF Championship qualification,0,5,0,2,0,2,-5,0
Guyana,1990,CFU Caribbean Cup qualification,1,6,0,1,2,3,-5,0
Guyana,1991,CFU Caribbean Cup,4,14,1,3,0,4,-10,0
Guyana,1991,CFU Caribbean Cup qualification,5,2,1,0,1,2,3,0
Guyana,1991,Friendly,1,1,0,0,1,1,0,0
Guyana,1992,CFU Caribbean Cup qualification,1,1,0,0,1,1,0,0
Guyana,1992,FIFA World Cup qualification,2,3,0,1,1,2,-1,0
Guyana,1992,Friendly,0,2,0,1,0,1,-2,0
Guyana,1993,CFU Caribbean Cup qualification,3,7,1,2,0,3,-4,0
Guyana,1994,CFU Caribbean Cup qualification,1,3,0,1,1,2,-2,0
Guyana,1995,CFU Caribbean Cup qualification,0,7,0,2,0,2,-7,0
Guyana,1996,CFU Caribbean Cup qualification,3,3,1,1,0,2,0,1
Guyana,1996,FIFA World Cup qualification,1,8,0,2,0,2,-7,0
Guyana,1997,CFU Caribbean Cup qualification,5,9,1,2,1,4,-4,0
Guyana,1997,Friendly,0,3,0,1,0,1,-3,0
Guyana,1998,CFU Caribbean Cup qualification,14,0,1,0,0,1,14,0
Guyana,1999,CFU Caribbean Cup qualification,2,4,0,1,1,2,-2,0
Guyana,1999,Friendly,1,2,0,1,0,1,-1,0
Guyana,2000,Friendly,0,0,0,0,1,1,0,0
Guyana,2001,CFU Caribbean Cup qualification,4,3,2,1,0,3,1,0
Guyana,2002,Friendly,1,3,0,1,0,1,-2,0
Guyana,2002,Gold Cup qualification,2,2,1,1,0,2,0,0
Guyana,2004,FIFA World Cup qualification,1,8,0,2,0,2,-7,0
Guyana,2004,Friendly,2,1,1,1,0,2,1,0
Guyana,2005,Friendly,9,3,2,0,1,3,6,0
Guyana,2006,CFU Caribbean Cup qualification,24,2,6,0,0,6,22,0
Guyana,2006,Friendly,11,4,4,0,0,4,7,0
Guyana,2007,CFU Caribbean Cup,4,3,1,0,1,2,1,0
Guyana,2008,CFU Caribbean Cup qualification,7,5,1,1,3,5,2,0
Guyana,2008,FIFA World Cup qualification,1,3,0,2,0,2,-2,0
Guyana,2008,Friendly,2,12,0,5,1,6,-10,0
Guyana,2009,Friendly,5,5,2,2,0,4,0,0
Guyana,2010,CFU Caribbean Cup,1,6,0,2,1,3,-5,0
Guyana,2010,CFU Caribbean Cup qualification,7,4,3,1,1,5,3,0
Guyana,2010,Friendly,1,4,0,1,1,2,-3,0
Guyana,2011,FIFA World Cup qualification,9,5,4,1,1,6,4,0
Guyana,2011,Friendly,7,4,3,0,1,4,3,0
Guyana,2012,CFU Caribbean Cup qualification,6,5,2,1,0,3,1,1
Guyana,2012,FIFA World Cup qualification,5,24,0,5,1,6,-19,0
Guyana,2012,Friendly,8,12,3,5,1,9,-4,0
Guyana,2014,CFU Caribbean Cup qualification,0,2,0,1,1,2,-2,0
Guyana,2015,FIFA World Cup qualification,6,6,0,0,2,2,0,0
Guyana,2015,Friendly,2,0,1,0,0,1,2,0
Guyana,2016,CFU Caribbean Cup qualification,11,8,1,2,0,3,3,0
Guyana,2016,Friendly,2,0,1,0,0,1,2,0
Guyana,2017,Friendly,2,4,0,2,2,4,-2,0
Guyana,2018,CONCACAF Nations League qualification,12,2,2,1,0,3,10,0
Guyana,2019,CONCACAF Nations League,12,10,3,2,1,6,2,0
Guyana,2019,CONCACAF Nations League qualification,2,1,1,0,0,1,1,0
Guyana,2019,Friendly,0,1,0,1,0,1,-1,0
Guyana,2019,Gold Cup,3,9,0,2,1,3,-6,0
Guyana,2021,FIFA World Cup qualification,4,8,1,3,0,4,-4,0
Guyana,2021,Gold Cup qualification,0,4,0,1,0,1,-4,0
Guyana,2022,CONCACAF Nations League,6,14,2,2,0,4,-8,0
Guyana,2022,Friendly,7,3,1,1,1,3,4,0
Guyana,2023,CONCACAF Nations League,22,5,6,0,1,7,17,0
Guyana,2023,Friendly,0,2,0,1,0,1,-2,0
Guyana,2023,Gold Cup qualification,1,3,0,1,1,2,-2,0
Guyana,2024,CONCACAF Nations League,14,17,2,3,1,6,-3,0
Guyana,2024,FIFA Series,4,2,1,1,0,2,2,0
Guyana,2024,FIFA World Cup qualification,3,3,1,1,0,2,0,0
Guyana,2024,Friendly,1,4,0,2,0,2,-3,0
Guyana,2025,Gold Cup qualification,3,4,1,1,0,2,-1,0
Găgăuzia,2006,ELF Cup,2,9,0,2,1,3,-7,0
Haiti,1925,Friendly,1,6,0,3,0,3,-5,0
Haiti,1926,Friendly,5,11,1,2,2,5,-6,0
Haiti,1932,Friendly,4,2,1,1,0,2,2,0
Haiti,1934,FIFA World Cup qualification,2,10,0,2,1,3,-8,0
Haiti,1938,Friendly,9,2,3,0,0,3,7,0
Haiti,1939,Friendly,5,1,2,0,1,3,4,0
Haiti,1944,Friendly,1,8,0,2,1,3,-7,0
Haiti,1948,Friendly,2,14,1,5,1,7,-12,0
Haiti,1949,Friendly,14,5,3,1,1,5,9,1
Haiti,1950,Friendly,1,2,0,1,0,1,-1,0
Haiti,1951,Friendly,4,4,1,1,1,3,0,0
Haiti,1952,Friendly,12,6,3,0,1,4,6,0
Haiti,1953,FIFA World Cup qualification,0,12,0,2,0,2,-12,0
Haiti,1953,Friendly,5,1,2,0,0,2,4,0
Haiti,1954,FIFA World Cup qualification,2,6,0,2,0,2,-4,0
Haiti,1956,Friendly,9,4,3,0,1,4,5,0
Haiti,1957,CCCF Championship,9,2,2,0,0,2,7,0
Haiti,1961,CCCF Championship,8,5,3,1,0,4,3,0
Haiti,1961,Friendly,5,0,2,0,0,2,5,0
Haiti,1962,Friendly,12,6,3,0,0,3,6,0
Haiti,1963,Friendly,3,0,1,0,0,1,3,0
Haiti,1963,Phillip Seaga Cup,2,4,0,2,0,2,-2,0
Haiti,1965,CONCACAF Championship,3,13,0,4,1,5,-10,0
Haiti,1966,Friendly,11,4,4,1,0,5,7,0
Haiti,1967,CONCACAF Championship,5,9,1,4,0,5,-4,0
Haiti,1967,CONCACAF Championship qualification,7,3,3,0,1,4,4,0
Haiti,1967,Friendly,0,2,0,1,0,1,-2,0
Haiti,1968,FIFA World Cup qualification,8,4,2,1,0,3,4,0
Haiti,1968,Friendly,9,8,2,1,0,3,1,0
Haiti,1969,FIFA World Cup qualification,8,4,3,2,1,6,4,0
Haiti,1969,Friendly,4,2,1,1,0,2,2,0
Haiti,1970,Friendly,1,1,0,0,1,1,0,0
Haiti,1971,CONCACAF Championship,9,2,2,0,3,5,7,0
Haiti,1971,Friendly,10,2,1,0,1,2,8,0
Haiti,1972,CONCACAF Championship qualification,12,0,2,0,0,2,12,0
Haiti,1972,Friendly,14,7,3,0,2,5,7,0
Haiti,1973,CONCACAF Championship,8,3,4,1,0,5,5,0
Haiti,1973,Friendly,22,15,7,5,3,15,7,0
Haiti,1974,FIFA World Cup,2,14,0,3,0,3,-12,0
Haiti,1974,Friendly,3,11,1,5,2,8,-8,0
Haiti,1975,Friendly,8,7,3,3,1,7,1,0
Haiti,1976,CONCACAF Championship qualification,19,3,5,0,2,7,16,1
Haiti,1976,Friendly,0,0,0,0,3,3,0,0
Haiti,1977,CONCACAF Championship,6,6,3,1,1,5,0,1
Haiti,1977,Friendly,3,4,0,1,1,2,-1,0
Haiti,1978,CFU Caribbean Cup,3,5,1,1,1,3,-2,0
Haiti,1978,CFU Caribbean Cup qualification,2,1,1,0,3,4,1,0
Haiti,1979,CFU Caribbean Cup,5,1,3,0,0,3,4,1
Haiti,1979,CFU Caribbean Cup qualification,10,1,4,0,0,4,9,1
Haiti,1980,CONCACAF Championship qualification,4,2,2,1,1,4,2,0
Haiti,1980,Friendly,5,8,2,3,0,5,-3,0
Haiti,1981,CONCACAF Championship,2,9,0,3,2,5,-7,0
Haiti,1981,Friendly,0,4,0,1,2,3,-4,0
Haiti,1983,Friendly,0,2,0,1,0,1,-2,0
Haiti,1984,CONCACAF Championship qualification,5,2,1,1,0,2,3,0
Haiti,1984,Friendly,1,1,1,1,0,2,0,0
Haiti,1985,CONCACAF Championship,0,9,0,4,0,4,-9,0
Haiti,1989,Friendly,0,4,0,1,0,1,-4,0
Haiti,1991,CFU Caribbean Cup qualification,4,3,1,0,1,2,1,0
Haiti,1991,Friendly,2,5,0,2,1,3,-3,0
Haiti,1992,FIFA World Cup qualification,2,2,1,1,0,2,0,0
Haiti,1992,Friendly,1,4,0,1,0,1,-3,0
Haiti,1994,CFU Caribbean Cup,4,6,1,1,1,3,-2,0
Haiti,1994,CFU Caribbean Cup qualification,1,0,1,0,0,1,1,1
Haiti,1996,CFU Caribbean Cup,0,1,0,1,1,2,-1,0
Haiti,1996,CFU Caribbean Cup qualification,7,1,1,0,1,2,6,0
Haiti,1996,FIFA World Cup qualification,9,8,2,1,1,4,1,0
Haiti,1996,Friendly,0,2,0,1,0,1,-2,0
Haiti,1997,Friendly,5,3,1,1,1,3,2,0
Haiti,1998,CFU Caribbean Cup,10,8,3,2,0,5,2,0
Haiti,1998,CFU Caribbean Cup qualification,9,0,2,0,0,2,9,0
Haiti,1999,CFU Caribbean Cup,4,9,1,2,0,3,-5,0
Haiti,1999,CFU Caribbean Cup qualification,12,0,3,0,0,3,12,0
Haiti,1999,Friendly,3,4,1,1,0,2,-1,0
Haiti,1999,Gold Cup qualification,3,3,1,1,1,3,0,0
Haiti,2000,FIFA World Cup qualification,23,12,4,3,1,8,11,0
Haiti,2000,Friendly,8,22,2,4,1,7,-14,0
Haiti,2000,Gold Cup,1,4,0,1,1,2,-3,0
Haiti,2001,CFU Caribbean Cup,13,6,2,1,2,5,7,0
Haiti,2001,CFU Caribbean Cup qualification,17,3,3,0,0,3,14,1
Haiti,2001,Friendly,3,3,1,1,3,5,0,0
Haiti,2002,Friendly,3,3,0,0,1,1,0,0
Haiti,2002,Gold Cup,3,4,1,2,0,3,-1,0
Haiti,2002,Gold Cup qualification,4,0,2,0,0,2,4,0
Haiti,2003,Friendly,13,11,2,2,0,4,2,0
Haiti,2003,Gold Cup qualification,3,6,1,2,0,3,-3,0
Haiti,2003,SKN Football Festival,2,1,1,1,0,2,1,0
Haiti,2004,CFU Caribbean Cup qualification,17,3,4,1,0,5,14,0
Haiti,2004,FIFA World Cup qualification,8,4,2,1,1,4,4,0
Haiti,2004,Friendly,6,13,0,2,4,6,-7,0
Haiti,2005,CFU Caribbean Cup qualification,1,2,0,1,1,2,-1,0
Haiti,2005,Friendly,6,8,1,3,1,5,-2,0
Haiti,2006,CFU Caribbean Cup qualification,9,7,1,3,1,5,2,0
Haiti,2006,Friendly,6,4,2,1,2,5,2,0
Haiti,2007,CFU Caribbean Cup,9,5,4,1,0,5,4,1
Haiti,2007,CFU Caribbean Cup qualification,5,0,2,0,0,2,5,1
Haiti,2007,Friendly,11,3,4,1,2,7,8,0
Haiti,2007,Gold Cup,2,4,0,1,2,3,-2,0
Haiti,2008,CFU Caribbean Cup,4,4,1,1,1,3,0,0
Haiti,2008,FIFA World Cup qualification,5,13,1,3,4,8,-8,0
Haiti,2008,Friendly,8,12,3,5,3,11,-4,0
Haiti,2009,Friendly,4,12,0,4,3,7,-8,0
Haiti,2009,Gold Cup,4,7,1,2,1,4,-3,0
Haiti,2010,CFU Caribbean Cup qualification,0,4,0,1,1,2,-4,0
Haiti,2010,Friendly,1,4,1,1,1,3,-3,0
Haiti,2011,FIFA World Cup qualification,21,6,4,1,1,6,15,0
Haiti,2011,Friendly,0,1,0,1,0,1,-1,0
Haiti,2012,CFU Caribbean Cup,4,2,3,1,1,5,2,1
Haiti,2012,CFU Caribbean Cup qualification,13,3,4,1,0,5,10,0
Haiti,2012,Friendly,2,1,1,0,0,1,1,0
Haiti,2013,Friendly,5,17,0,5,1,6,-12,0
Haiti,2013,Gold Cup,2,3,1,2,0,3,-1,0
Haiti,2014,CFU Caribbean Cup,7,3,2,0,1,3,4,0
Haiti,2014,CFU Caribbean Cup qualification,2,2,0,0,2,2,0,0
Haiti,2014,Friendly,0,1,0,1,1,2,-1,0
Haiti,2015,FIFA World Cup qualification,6,3,2,2,0,4,3,0
Haiti,2015,Friendly,2,2,0,0,1,1,0,0
Haiti,2015,Gold Cup,2,3,1,2,1,4,-1,0
Haiti,2016,CFU Caribbean Cup qualification,4,5,1,1,0,2,-1,0
Haiti,2016,Copa América,1,12,0,3,0,3,-11,0
Haiti,2016,Copa América qualification,1,0,1,0,0,1,1,0
Haiti,2016,FIFA World Cup qualification,2,2,1,2,1,4,0,0
Haiti,2017,CFU Caribbean Cup qualification,8,5,2,0,0,2,3,1
Haiti,2017,Kirin Challenge Cup,3,3,0,0,1,1,0,0
Haiti,2018,CONCACAF Nations League qualification,17,1,3,0,0,3,16,0
Haiti,2018,Friendly,0,5,0,2,0,2,-5,0
Haiti,2019,CONCACAF Nations League,3,4,0,1,3,4,-1,0
Haiti,2019,CONCACAF Nations League qualification,2,1,1,0,0,1,1,0
Haiti,2019,Friendly,2,6,0,3,0,3,-4,0
Haiti,2019,Gold Cup,9,5,4,1,0,5,4,0
Haiti,2021,FIFA World Cup qualification,13,4,3,2,0,5,9,0
Haiti,2021,Friendly,3,6,1,1,0,2,-3,0
Haiti,2021,Gold Cup,3,6,1,2,0,3,-3,0
Haiti,2021,Gold Cup qualification,10,2,2,0,0,2,8,0
Haiti,2022,CONCACAF Nations League,15,4,3,0,1,4,11,0
Haiti,2022,Friendly,1,2,0,1,0,1,-1,0
Haiti,2023,CONCACAF Nations League,12,7,2,1,3,6,5,0
Haiti,2023,Friendly,0,0,0,0,1,1,0,0
Haiti,2023,Gold Cup,4,6,1,2,0,3,-2,0
Haiti,2024,CONCACAF Nations League,29,5,6,0,0,6,24,0
Haiti,2024,FIFA World Cup qualification,5,2,2,0,0,2,3,0
Haiti,2025,Friendly,3,0,1,0,0,1,3,0
Hitra,1997,Island Games,2,18,0,4,0,4,-16,0
Hitra,1999,Island Games,4,30,1,3,0,4,-26,0
Hitra,2015,Island Games,8,10,1,3,0,4,-2,0
Hitra,2017,Island Games,4,12,1,2,1,4,-8,0
Hitra,2019,Inter Games Football Tournament,6,12,1,2,0,3,-6,0
Hmong,2023,CONIFA Asia Cup,6,10,1,2,0,3,-4,0
Honduras,1927,Friendly,1,0,1,0,1,2,1,0
Honduras,1928,Friendly,0,5,0,1,0,1,-5,0
Honduras,1930,Central American and Caribbean Games,9,25,2,3,0,5,-16,0
Honduras,1935,Central American and Caribbean Games,6,20,1,3,1,5,-14,0
Honduras,1937,Friendly,2,3,0,1,0,1,-1,0
Honduras,1946,CCCF Championship,17,12,2,3,0,5,5,1
Honduras,1953,CCCF Championship,13,10,4,2,0,6,3,1
Honduras,1955,CCCF Championship,8,6,2,2,1,5,2,0
Honduras,1955,Friendly,2,2,0,0,2,2,0,0
Honduras,1957,CCCF Championship,3,1,1,0,1,2,2,0
Honduras,1959,Friendly,1,7,0,2,0,2,-6,0
Honduras,1960,CCCF Championship,3,3,0,0,1,1,0,0
Honduras,1960,FIFA World Cup qualification,3,7,1,1,1,3,-4,0
Honduras,1961,CCCF Championship,6,2,2,0,0,2,4,1
Honduras,1961,FIFA World Cup qualification,0,1,0,1,0,1,-1,0
Honduras,1963,CONCACAF Championship,8,12,3,3,1,7,-4,0
Honduras,1963,Friendly,3,3,1,1,0,2,0,0
Honduras,1965,CONCACAF Championship qualification,1,5,0,2,0,2,-4,0
Honduras,1965,FIFA World Cup qualification,1,6,0,3,1,4,-5,0
Honduras,1965,Friendly,1,1,0,0,1,1,0,0
Honduras,1967,CONCACAF Championship,4,2,2,1,2,5,2,0
Honduras,1967,Friendly,2,4,0,1,1,2,-2,0
Honduras,1968,FIFA World Cup qualification,7,2,3,0,1,4,5,0
Honduras,1968,Friendly,1,2,0,1,1,2,-1,0
Honduras,1969,FIFA World Cup qualification,3,6,1,2,0,3,-3,0
Honduras,1970,Friendly,1,0,1,0,0,1,1,0
Honduras,1971,CONCACAF Championship,5,11,0,4,1,5,-6,0
Honduras,1971,CONCACAF Championship qualification,2,1,1,0,1,2,1,0
Honduras,1972,CONCACAF Championship qualification,5,4,1,0,1,2,1,0
Honduras,1973,CONCACAF Championship,6,6,1,1,3,5,0,0
Honduras,1977,Friendly,1,0,1,0,0,1,1,0
Honduras,1980,CONCACAF Championship qualification,15,5,5,1,2,8,10,0
Honduras,1980,Friendly,11,10,4,2,4,10,1,0
Honduras,1981,CONCACAF Championship,8,1,3,0,2,5,7,0
Honduras,1982,FIFA World Cup,2,3,0,1,2,3,-1,0
Honduras,1982,Friendly,4,4,1,1,2,4,0,0
Honduras,1983,Friendly,6,1,3,0,0,3,5,0
Honduras,1984,CONCACAF Championship qualification,4,0,2,0,0,2,4,0
Honduras,1984,Friendly,4,2,2,1,1,4,2,0
Honduras,1985,CONCACAF Championship,11,9,3,2,3,8,2,0
Honduras,1985,Friendly,1,0,1,0,0,1,1,0
Honduras,1986,Friendly,1,0,1,0,0,1,1,0
Honduras,1987,Friendly,4,2,2,0,1,3,2,0
Honduras,1988,CONCACAF Championship qualification,1,1,0,0,2,2,0,0
Honduras,1988,Friendly,2,9,0,4,4,8,-7,0
Honduras,1991,Gold Cup,12,3,3,0,2,5,9,0
Honduras,1991,UNCAF Cup,5,5,2,2,1,5,0,1
Honduras,1992,FIFA World Cup qualification,16,6,5,1,2,8,10,0
Honduras,1992,Friendly,26,6,5,1,2,8,20,0
Honduras,1993,FIFA World Cup qualification,7,14,1,4,1,6,-7,0
Honduras,1993,Friendly,6,5,1,1,3,5,1,0
Honduras,1993,Gold Cup,6,5,1,2,0,3,1,0
Honduras,1993,UNCAF Cup,7,0,3,0,0,3,7,1
Honduras,1994,Friendly,3,12,0,2,1,3,-9,0
Honduras,1994,Miami Cup,3,4,1,1,0,2,-1,1
Honduras,1995,Friendly,1,3,0,2,1,3,-2,0
Honduras,1995,UNCAF Cup,8,1,3,0,1,4,7,1
Honduras,1996,FIFA World Cup qualification,18,11,3,2,1,6,7,0
Honduras,1996,Friendly,19,14,5,3,7,15,5,0
Honduras,1996,Gold Cup,1,8,0,2,0,2,-7,0
Honduras,1997,Friendly,2,3,0,1,0,1,-1,0
Honduras,1997,UNCAF Cup,8,5,2,2,1,5,3,0
Honduras,1998,Friendly,9,5,2,0,1,3,4,0
Honduras,1998,Gold Cup,1,5,0,2,0,2,-4,0
Honduras,1999,Friendly,13,4,3,0,2,5,9,0
Honduras,1999,UNCAF Cup,11,5,4,1,0,5,6,0
Honduras,2000,FIFA World Cup qualification,39,8,10,2,0,12,31,0
Honduras,2000,Friendly,15,9,3,2,0,5,6,0
Honduras,2000,Gold Cup,7,5,2,1,0,3,2,0
Honduras,2001,Copa América,7,5,3,2,1,6,2,0
Honduras,2001,FIFA World Cup qualification,17,17,4,4,2,10,0,0
Honduras,2001,Friendly,4,2,1,0,2,3,2,0
Honduras,2001,UNCAF Cup,12,5,1,1,1,3,7,0
Honduras,2002,Friendly,1,4,1,1,0,2,-3,0
Honduras,2002,Kirin Cup,3,3,0,0,1,1,0,0
Honduras,2002,Lunar New Year Cup,5,1,1,0,0,1,4,0
Honduras,2003,Friendly,8,13,1,5,3,9,-5,0
Honduras,2003,Gold Cup,1,2,0,1,1,2,-1,0
Honduras,2003,Gold Cup qualification,6,2,2,0,0,2,4,1
Honduras,2003,UNCAF Cup,4,5,1,3,1,5,-1,0
Honduras,2004,FIFA World Cup qualification,15,8,3,1,4,8,7,0
Honduras,2004,Friendly,9,12,1,3,5,9,-3,0
Honduras,2004,Lunar New Year Cup,1,3,0,1,0,1,-2,0
Honduras,2005,Friendly,6,7,1,2,1,4,-1,0
Honduras,2005,Gold Cup,8,6,3,1,1,5,2,0
Honduras,2005,UNCAF Cup,12,3,3,0,2,5,9,0
Honduras,2006,Friendly,8,4,4,1,1,6,4,0
Honduras,2007,Friendly,13,9,6,3,1,10,4,0
Honduras,2007,Gold Cup,10,6,2,2,0,4,4,0
Honduras,2007,UNCAF Cup,11,5,1,1,1,3,6,0
Honduras,2008,FIFA World Cup qualification,15,7,5,2,1,8,8,0
Honduras,2008,Friendly,10,3,4,0,1,5,7,0
Honduras,2009,FIFA World Cup qualification,17,11,5,4,1,10,6,0
Honduras,2009,Friendly,7,3,3,1,0,4,4,0
Honduras,2009,Gold Cup,6,4,3,2,0,5,2,0
Honduras,2009,UNCAF Cup,9,3,4,1,0,5,6,1
Honduras,2010,FIFA World Cup,0,3,0,2,1,3,-3,0
Honduras,2010,Friendly,13,21,3,6,4,13,-8,0
Honduras,2011,Friendly,9,17,3,5,2,10,-8,0
Honduras,2011,Gold Cup,8,5,1,2,2,5,3,0
Honduras,2011,UNCAF Cup,8,3,3,0,1,4,5,0
Honduras,2012,FIFA World Cup qualification,12,3,3,1,2,6,9,0
Honduras,2012,Friendly,4,4,1,2,2,5,0,0
Honduras,2013,FIFA World Cup qualification,13,12,4,3,3,10,1,0
Honduras,2013,Friendly,2,9,0,2,1,3,-7,0
Honduras,2013,Gold Cup,5,5,3,2,0,5,0,0
Honduras,2013,UNCAF Cup,3,3,1,1,2,4,0,0
Honduras,2014,FIFA World Cup,1,8,0,3,0,3,-7,0
Honduras,2014,Friendly,3,11,0,2,3,5,-8,0
Honduras,2015,FIFA World Cup qualification,0,3,0,2,0,2,-3,0
Honduras,2015,Friendly,11,8,3,3,2,8,3,0
Honduras,2015,Gold Cup,2,4,0,2,1,3,-2,0
Honduras,2015,Gold Cup qualification,4,3,1,1,0,2,1,1
Honduras,2016,FIFA World Cup qualification,9,5,3,1,2,6,4,1
Honduras,2016,Friendly,3,1,2,0,0,2,2,0
Honduras,2017,FIFA World Cup qualification,11,20,2,3,5,10,-9,0
Honduras,2017,Friendly,5,5,1,1,1,3,0,0
Honduras,2017,Gold Cup,0,2,0,2,2,4,-2,0
Honduras,2017,UNCAF Cup,5,2,3,0,0,3,3,1
Honduras,2018,Friendly,3,8,1,3,1,5,-5,0
Honduras,2019,CONCACAF Nations League,8,1,3,0,1,4,7,0
Honduras,2019,Friendly,7,9,2,1,2,5,-2,0
Honduras,2019,Gold Cup,6,4,1,2,0,3,2,0
Honduras,2020,Friendly,2,3,0,1,1,2,-1,0
Honduras,2021,CONCACAF Nations League,2,3,0,1,1,2,-1,0
Honduras,2021,FIFA World Cup qualification,5,15,0,5,3,8,-10,0
Honduras,2021,Friendly,2,3,0,1,2,3,-1,0
Honduras,2021,Gold Cup,7,7,2,2,0,4,0,0
Honduras,2022,CONCACAF Nations League,4,3,2,1,0,3,1,0
Honduras,2022,FIFA World Cup qualification,2,11,0,5,1,6,-9,0
Honduras,2022,Friendly,3,7,1,3,1,5,-4,0
Honduras,2023,CONCACAF Nations League,11,7,3,3,1,7,4,0
Honduras,2023,Friendly,1,1,1,1,1,3,0,0
Honduras,2023,Gold Cup,3,6,1,1,1,3,-3,0
Honduras,2024,CONCACAF Nations League,10,8,3,2,1,6,2,0
Honduras,2024,Copa América qualification,1,3,0,1,0,1,-2,0
Honduras,2024,FIFA World Cup qualification,9,2,2,0,0,2,7,0
Honduras,2024,Friendly,2,5,0,2,1,3,-3,0
Honduras,2025,Friendly,1,2,0,1,0,1,-1,0
Honduras,2025,Gold Cup qualification,7,3,2,0,0,2,4,1
Hong Kong,1953,Friendly,4,0,1,0,0,1,4,0
Hong Kong,1954,Asian Games,7,5,1,0,1,2,2,0
Hong Kong,1954,Friendly,2,2,0,0,1,1,0,0
Hong Kong,1956,AFC Asian Cup,6,7,0,1,2,3,-1,0
Hong Kong,1956,Friendly,2,4,0,1,0,1,-2,0
Hong Kong,1958,Asian Games,8,6,2,1,0,3,2,0
Hong Kong,1958,Friendly,13,8,3,0,2,5,5,0
Hong Kong,1959,AFC Asian Cup qualification,7,0,1,0,0,1,7,0
Hong Kong,1959,Friendly,3,6,0,2,0,2,-3,0
Hong Kong,1961,Friendly,1,2,0,1,0,1,-1,0
Hong Kong,1961,Merdeka Tournament,2,1,1,0,0,1,1,0
Hong Kong,1962,Friendly,6,2,1,0,0,1,4,0
Hong Kong,1963,AFC Asian Cup qualification,11,7,2,0,1,3,4,0
Hong Kong,1963,Friendly,3,4,0,1,0,1,-1,0
Hong Kong,1964,AFC Asian Cup,1,5,0,3,0,3,-4,0
Hong Kong,1964,Friendly,2,6,0,2,1,3,-4,0
Hong Kong,1965,Friendly,4,8,1,3,1,5,-4,0
Hong Kong,1965,Merdeka Tournament,9,11,1,3,2,6,-2,0
Hong Kong,1966,Merdeka Tournament,2,8,0,4,1,5,-6,0
Hong Kong,1967,AFC Asian Cup qualification,2,0,1,0,0,1,2,0
Hong Kong,1967,Friendly,0,4,0,1,0,1,-4,0
Hong Kong,1967,Merdeka Tournament,8,19,3,4,0,7,-11,0
Hong Kong,1967,Vietnam Independence Cup,1,8,0,3,0,3,-7,0
Hong Kong,1968,AFC Asian Cup,2,11,0,3,1,4,-9,0
Hong Kong,1968,Merdeka Tournament,3,8,0,2,3,5,-5,0
Hong Kong,1970,Indonesia Tournament,7,7,1,2,1,4,0,0
Hong Kong,1970,King's Cup,5,8,1,3,0,4,-3,0
Hong Kong,1970,Merdeka Tournament,10,14,3,3,1,7,-4,0
Hong Kong,1971,AFC Asian Cup qualification,3,6,0,3,0,3,-3,0
Hong Kong,1971,Friendly,6,0,1,0,0,1,6,0
Hong Kong,1971,Merdeka Tournament,6,14,2,4,0,6,-8,0
Hong Kong,1972,Friendly,8,5,3,1,0,4,3,0
Hong Kong,1972,Merdeka Tournament,7,4,2,1,2,5,3,0
Hong Kong,1973,FIFA World Cup qualification,4,3,3,1,0,4,1,0
Hong Kong,1974,Friendly,1,0,1,0,1,2,1,0
Hong Kong,1974,Merdeka Tournament,5,4,1,0,2,3,1,1
Hong Kong,1975,AFC Asian Cup qualification,3,4,0,1,2,3,-1,0
Hong Kong,1975,Friendly,1,1,0,0,1,1,0,0
Hong Kong,1975,Merdeka Tournament,17,13,3,4,0,7,4,0
Hong Kong,1976,Friendly,1,4,1,2,0,3,-3,0
Hong Kong,1977,Beijing International Friendship Tournament,3,1,2,0,0,2,2,0
Hong Kong,1977,FIFA World Cup qualification,15,31,3,8,2,13,-16,0
Hong Kong,1977,Friendly,3,2,1,1,0,2,1,0
Hong Kong,1978,Friendly,4,0,1,0,0,1,4,0
Hong Kong,1979,AFC Asian Cup qualification,0,3,0,1,1,2,-3,0
Hong Kong,1980,FIFA World Cup qualification,3,4,0,1,3,4,-1,0
Hong Kong,1980,Friendly,3,0,2,0,0,2,3,0
Hong Kong,1980,Guangzhou International Friendship Tournament,1,12,0,3,0,3,-11,0
Hong Kong,1981,Friendly,3,1,1,0,0,1,2,0
Hong Kong,1982,Beijing International Friendship Tournament,0,2,0,1,1,2,-2,0
Hong Kong,1982,Friendly,0,1,0,1,0,1,-1,0
Hong Kong,1983,Friendly,1,0,1,0,0,1,1,0
Hong Kong,1983,Great Wall Cup,1,1,0,0,1,1,0,0
Hong Kong,1984,AFC Asian Cup qualification,1,4,0,2,2,4,-3,0
Hong Kong,1984,Friendly,3,0,1,0,0,1,3,0
Hong Kong,1985,FIFA World Cup qualification,20,7,5,2,1,8,13,0
Hong Kong,1985,Friendly,4,1,2,0,0,2,3,0
Hong Kong,1986,Friendly,5,6,1,1,0,2,-1,0
Hong Kong,1987,Friendly,5,0,1,0,0,1,5,0
Hong Kong,1988,AFC Asian Cup qualification,0,5,0,3,1,4,-5,0
Hong Kong,1988,Friendly,2,4,1,2,0,3,-2,0
Hong Kong,1989,FIFA World Cup qualification,5,10,0,3,3,6,-5,0
Hong Kong,1989,Friendly,2,1,1,0,0,1,1,0
Hong Kong,1989,Lunar New Year Cup,0,0,0,0,1,1,0,0
Hong Kong,1990,Asian Games,3,4,1,2,0,3,-1,0
Hong Kong,1991,Friendly,2,0,1,0,0,1,2,0
Hong Kong,1992,AFC Asian Cup qualification,2,2,0,0,3,3,0,0
Hong Kong,1992,Friendly,1,3,0,1,0,1,-2,0
Hong Kong,1993,FIFA World Cup qualification,9,19,2,5,1,8,-10,0
Hong Kong,1993,Friendly,2,3,0,1,1,2,-1,0
Hong Kong,1994,Asian Games,6,8,1,3,0,4,-2,0
Hong Kong,1995,Dynasty Cup,3,7,0,2,2,4,-4,0
Hong Kong,1996,AFC Asian Cup qualification,12,3,2,1,0,3,9,0
Hong Kong,1997,FIFA World Cup qualification,3,10,1,3,0,4,-7,0
Hong Kong,1998,Asian Games,0,11,0,2,0,2,-11,0
Hong Kong,1998,Dynasty Cup,1,7,0,3,0,3,-6,0
Hong Kong,1998,Friendly,1,1,0,0,1,1,0,0
Hong Kong,1999,AFC Asian Cup qualification,7,5,2,1,1,4,2,0
Hong Kong,1999,Friendly,4,3,1,0,0,1,1,0
Hong Kong,2000,Friendly,4,4,2,2,2,6,0,0
Hong Kong,2001,FIFA World Cup qualification,3,10,1,4,1,6,-7,0
Hong Kong,2001,Millennium Cup,2,6,0,2,0,2,-4,0
Hong Kong,2003,AFC Asian Cup qualification,10,14,2,4,2,8,-4,0
Hong Kong,2003,EAFF Championship,28,6,4,2,0,6,22,0
Hong Kong,2003,Friendly,1,4,0,1,0,1,-3,0
Hong Kong,2004,FIFA World Cup qualification,5,15,2,4,0,6,-10,0
Hong Kong,2004,Friendly,2,2,0,0,2,2,0,0
Hong Kong,2005,EAFF Championship,21,2,2,1,0,3,19,0
Hong Kong,2005,Friendly,8,1,1,0,0,1,7,0
Hong Kong,2005,Lunar New Year Cup,1,7,0,1,0,1,-6,0
Hong Kong,2006,AFC Asian Cup qualification,5,7,2,2,2,6,-2,0
Hong Kong,2006,Friendly,4,5,0,1,3,4,-1,0
Hong Kong,2006,Lunar New Year Cup,0,4,0,1,0,1,-4,0
Hong Kong,2007,EAFF Championship,16,3,1,1,1,3,13,0
Hong Kong,2007,FIFA World Cup qualification,11,6,2,1,1,4,5,0
Hong Kong,2007,Friendly,2,4,1,1,0,2,-2,0
Hong Kong,2008,Friendly,10,1,2,0,0,2,9,0
Hong Kong,2009,AFC Asian Cup qualification,1,14,0,4,0,4,-13,0
Hong Kong,2009,EAFF Championship,12,0,1,0,1,2,12,1
Hong Kong,2009,Friendly,2,1,1,0,0,1,1,0
Hong Kong,2010,AFC Asian Cup qualification,0,4,0,1,1,2,-4,0
Hong Kong,2010,EAFF Championship,0,10,0,3,0,3,-10,0
Hong Kong,2010,Friendly,1,7,1,1,0,2,-6,0
Hong Kong,2011,Dragon Cup,8,4,1,0,1,2,4,0
Hong Kong,2011,FIFA World Cup qualification,0,8,0,2,0,2,-8,0
Hong Kong,2011,Friendly,1,3,0,1,1,2,-2,0
Hong Kong,2012,EAFF Championship,4,6,2,2,0,4,-2,0
Hong Kong,2012,Friendly,8,9,2,3,1,6,-1,0
Hong Kong,2013,AFC Asian Cup qualification,1,10,1,3,1,5,-9,0
Hong Kong,2013,Friendly,1,1,1,1,1,3,0,0
Hong Kong,2014,AFC Asian Cup qualification,1,3,0,1,0,1,-2,0
Hong Kong,2014,EAFF Championship,1,2,0,1,1,2,-1,0
Hong Kong,2014,Friendly,3,11,1,2,1,4,-8,0
Hong Kong,2015,FIFA World Cup qualification,13,3,4,1,2,7,10,0
Hong Kong,2015,Friendly,8,1,3,1,1,5,7,0
Hong Kong,2016,EAFF Championship,7,5,2,1,0,3,2,0
Hong Kong,2016,FIFA World Cup qualification,0,2,0,1,0,1,-2,0
Hong Kong,2016,Friendly,10,7,3,1,1,5,3,0
Hong Kong,2017,AFC Asian Cup qualification,4,5,1,2,2,5,-1,0
Hong Kong,2017,Friendly,5,7,1,2,2,5,-2,0
Hong Kong,2018,AFC Asian Cup qualification,0,2,0,1,0,1,-2,0
Hong Kong,2018,EAFF Championship,7,2,2,0,1,3,5,1
Hong Kong,2018,Friendly,1,2,0,1,1,2,-1,0
Hong Kong,2019,EAFF Championship,0,9,0,3,0,3,-9,0
Hong Kong,2019,FIFA World Cup qualification,3,5,1,2,2,5,-2,0
Hong Kong,2019,Friendly,0,2,0,1,0,1,-2,0
Hong Kong,2021,FIFA World Cup qualification,1,8,0,3,0,3,-7,0
Hong Kong,2022,AFC Asian Cup qualification,5,5,2,1,0,3,0,0
Hong Kong,2022,EAFF Championship,0,10,0,3,0,3,-10,0
Hong Kong,2022,Friendly,2,2,1,1,1,3,0,0
Hong Kong,2023,FIFA World Cup qualification,6,8,1,2,1,4,-2,0
Hong Kong,2023,Friendly,12,6,1,3,2,6,6,0
Hong Kong,2024,AFC Asian Cup,1,7,0,3,0,3,-6,0
Hong Kong,2024,EAFF Championship qualification,10,1,3,0,0,3,9,1
Hong Kong,2024,FIFA World Cup qualification,2,9,0,3,1,4,-7,0
Hong Kong,2024,Friendly,10,7,4,3,0,7,3,1
Hong Kong,2024,Tri-Nations Series,4,1,1,0,1,2,3,1
Hong Kong,2025,AFC Asian Cup qualification,0,0,0,0,1,1,0,0
Hong Kong,2025,Friendly,2,0,1,0,0,1,2,0
Hungary,1902,Friendly,0,5,0,1,0,1,-5,0
Hungary,1903,Friendly,7,7,2,1,0,3,0,0
Hungary,1904,Friendly,7,5,1,1,0,2,2,0
Hungary,1905,Friendly,0,0,0,0,1,1,0,0
Hungary,1906,Friendly,8,6,1,0,2,3,2,1
Hungary,1907,Friendly,13,11,2,2,0,4,2,1
Hungary,1908,Friendly,10,16,2,2,0,4,-6,1
Hungary,1909,Friendly,14,21,1,2,3,6,-7,0
Hungary,1910,Friendly,10,3,2,1,0,3,7,1
Hungary,1911,Friendly,20,6,5,2,0,7,14,1
Hungary,1912,Friendly,38,7,4,0,3,7,31,0
Hungary,1912,Olympic Games,6,1,2,0,0,2,5,1
Hungary,1913,Friendly,10,4,3,0,0,3,6,0
Hungary,1914,Friendly,10,7,2,1,2,5,3,1
Hungary,1915,Friendly,12,12,2,2,0,4,0,1
Hungary,1916,Friendly,8,10,1,2,1,4,-2,0
Hungary,1917,Friendly,15,6,4,0,1,5,9,0
Hungary,1918,Friendly,9,1,4,0,0,4,8,0
Hungary,1919,Friendly,5,5,2,1,0,3,0,0
Hungary,1920,Friendly,3,5,0,2,1,3,-2,0
Hungary,1921,Friendly,9,6,3,1,0,4,3,0
Hungary,1922,Friendly,14,8,2,1,5,8,6,0
Hungary,1923,Friendly,13,4,4,1,1,6,9,0
Hungary,1924,Friendly,21,10,4,2,1,7,11,0
Hungary,1924,Olympic Games,5,3,1,1,0,2,2,0
Hungary,1925,Friendly,13,17,2,5,2,9,-4,0
Hungary,1926,Friendly,19,15,5,2,1,8,4,0
Hungary,1927,Central European International Cup,5,3,1,0,0,1,2,0
Hungary,1927,Friendly,18,13,2,3,0,5,5,0
Hungary,1928,Central European International Cup,9,10,2,2,0,4,-1,1
Hungary,1928,Friendly,6,11,0,1,1,2,-5,0
Hungary,1929,Central European International Cup,6,5,1,0,1,2,1,0
Hungary,1929,Friendly,4,6,1,1,1,3,-2,0
Hungary,1930,Central European International Cup,0,5,0,1,0,1,-5,0
Hungary,1930,Friendly,18,14,3,1,3,7,4,0
Hungary,1931,Central European International Cup,13,10,1,1,3,5,3,0
Hungary,1931,Friendly,8,4,2,1,0,3,4,0
Hungary,1932,Central European International Cup,4,5,1,1,1,3,-1,0
Hungary,1932,Friendly,11,17,2,3,1,6,-6,0
Hungary,1933,Central European International Cup,3,1,1,1,0,2,2,0
Hungary,1933,Friendly,9,10,2,2,2,6,-1,0
Hungary,1934,Central European International Cup,5,3,1,0,1,2,2,0
Hungary,1934,FIFA World Cup,5,4,1,1,0,2,1,0
Hungary,1934,FIFA World Cup qualification,8,2,2,0,0,2,6,0
Hungary,1934,Friendly,13,17,2,3,1,6,-4,0
Hungary,1935,Central European International Cup,9,12,1,1,2,4,-3,0
Hungary,1935,Friendly,12,6,2,1,0,3,6,0
Hungary,1936,Central European International Cup,7,8,1,1,0,2,-1,0
Hungary,1936,Friendly,19,19,4,2,1,7,0,0
Hungary,1937,Central European International Cup,17,7,4,1,0,5,10,1
Hungary,1937,Friendly,3,3,0,0,2,2,0,0
Hungary,1938,FIFA World Cup,15,5,3,1,0,4,10,0
Hungary,1938,FIFA World Cup qualification,11,1,1,0,0,1,10,0
Hungary,1938,Friendly,11,10,2,2,1,5,1,0
Hungary,1939,Friendly,19,20,2,4,3,9,-1,0
Hungary,1940,Friendly,12,6,3,0,5,8,6,0
Hungary,1941,Friendly,3,9,1,1,1,3,-6,0
Hungary,1942,Friendly,7,6,1,1,1,3,1,0
Hungary,1943,Friendly,15,12,4,1,0,5,3,0
Hungary,1945,Friendly,14,4,3,0,0,3,10,0
Hungary,1946,Friendly,11,5,2,1,0,3,6,0
Hungary,1947,Balkan Cup,18,2,4,0,0,4,16,0
Hungary,1947,Friendly,10,9,1,2,0,3,1,0
Hungary,1948,Balkan Cup,20,4,3,1,1,5,16,0
Hungary,1948,Central European International Cup,11,8,2,1,0,3,3,0
Hungary,1948,Friendly,2,1,1,0,0,1,1,0
Hungary,1949,Central European International Cup,9,7,1,1,1,3,2,0
Hungary,1949,Friendly,24,7,4,0,1,5,17,0
Hungary,1950,Friendly,30,11,4,1,1,6,19,0
Hungary,1951,Friendly,16,1,3,0,0,3,15,0
Hungary,1952,Central European International Cup,4,2,1,0,0,1,2,0
Hungary,1952,Friendly,23,5,4,1,1,6,18,0
Hungary,1953,Central European International Cup,3,0,1,0,0,1,3,0
Hungary,1953,Friendly,22,12,4,0,3,7,10,0
Hungary,1954,FIFA World Cup,27,10,4,1,0,5,17,0
Hungary,1954,Friendly,32,7,8,0,1,9,25,0
Hungary,1955,Central European International Cup,18,8,4,0,1,5,10,1
Hungary,1955,Friendly,35,8,6,0,1,7,27,0
Hungary,1956,Central European International Cup,7,7,1,1,1,3,0,0
Hungary,1956,Friendly,20,13,5,2,1,8,7,0
Hungary,1957,FIFA World Cup qualification,12,4,3,1,0,4,8,0
Hungary,1957,Friendly,3,3,1,2,1,4,0,0
Hungary,1958,FIFA World Cup,7,5,1,2,1,4,2,0
Hungary,1958,Friendly,15,8,4,0,2,6,7,0
Hungary,1958,UEFA Euro qualification,1,3,0,1,0,1,-2,0
Hungary,1959,Central European International Cup,9,1,1,0,1,2,8,0
Hungary,1959,Friendly,16,7,5,0,0,5,9,0
Hungary,1959,UEFA Euro qualification,0,1,0,1,0,1,-1,0
Hungary,1960,Friendly,13,7,3,1,2,6,6,0
Hungary,1961,FIFA World Cup qualification,11,5,3,0,1,4,6,0
Hungary,1961,Friendly,13,14,3,3,2,8,-1,0
Hungary,1962,FIFA World Cup,8,3,2,1,1,4,5,0
Hungary,1962,Friendly,12,6,5,1,1,7,6,0
Hungary,1962,UEFA Euro qualification,3,1,1,0,0,1,2,0
Hungary,1963,Friendly,12,8,2,2,2,6,4,0
Hungary,1963,UEFA Euro qualification,6,5,1,0,2,3,1,0
Hungary,1964,Friendly,6,4,2,1,1,4,2,0
Hungary,1964,UEFA Euro,4,3,1,1,0,2,1,0
Hungary,1964,UEFA Euro qualification,5,2,2,0,0,2,3,0
Hungary,1965,FIFA World Cup qualification,8,3,3,0,1,4,5,0
Hungary,1965,Friendly,5,7,1,2,0,3,-2,0
Hungary,1966,FIFA World Cup,8,7,2,2,0,4,1,0
Hungary,1966,Friendly,11,7,3,1,1,5,4,0
Hungary,1966,UEFA Euro qualification,8,2,1,0,1,2,6,0
Hungary,1967,Friendly,13,7,5,1,0,6,6,0
Hungary,1967,UEFA Euro qualification,7,3,3,1,0,4,4,0
Hungary,1968,UEFA Euro qualification,2,3,1,1,0,2,-1,0
Hungary,1969,FIFA World Cup qualification,17,11,4,2,1,7,6,0
Hungary,1969,Friendly,6,5,1,1,1,3,1,0
Hungary,1970,Friendly,8,8,2,2,2,6,0,0
Hungary,1970,UEFA Euro qualification,3,1,1,0,0,1,2,0
Hungary,1971,FIFA World Cup qualification,2,0,1,0,0,1,2,1
Hungary,1971,Friendly,4,1,2,0,0,2,3,0
Hungary,1971,UEFA Euro qualification,9,4,3,1,1,5,5,0
Hungary,1972,FIFA World Cup qualification,5,2,1,0,2,3,3,0
Hungary,1972,Friendly,0,3,0,2,0,2,-3,0
Hungary,1972,UEFA Euro,1,3,0,2,0,2,-2,0
Hungary,1972,UEFA Euro qualification,5,4,1,0,2,3,1,1
Hungary,1973,FIFA World Cup qualification,5,5,0,0,2,2,0,0
Hungary,1973,Friendly,4,6,0,2,2,4,-2,0
Hungary,1974,Friendly,7,9,3,2,1,6,-2,0
Hungary,1974,UEFA Euro qualification,4,4,1,1,0,2,0,0
Hungary,1975,Friendly,5,8,1,2,1,4,-3,0
Hungary,1975,UEFA Euro qualification,11,4,2,1,1,4,7,0
Hungary,1976,FIFA World Cup qualification,1,1,0,0,1,1,0,0
Hungary,1976,Friendly,15,6,6,0,4,10,9,0
Hungary,1977,FIFA World Cup qualification,14,5,4,1,0,5,9,0
Hungary,1977,Friendly,19,15,5,2,3,10,4,0
Hungary,1978,FIFA World Cup,3,8,0,3,0,3,-5,0
Hungary,1978,Friendly,3,5,1,1,1,3,-2,0
Hungary,1978,UEFA Euro qualification,4,6,1,2,0,3,-2,0
Hungary,1979,Friendly,7,7,2,2,1,5,0,0
Hungary,1979,UEFA Euro qualification,5,3,1,0,2,3,2,0
Hungary,1980,Friendly,17,16,4,4,2,10,1,0
Hungary,1981,FIFA World Cup qualification,13,8,4,2,2,8,5,0
Hungary,1981,Friendly,3,0,1,0,0,1,3,0
Hungary,1982,FIFA World Cup,12,6,1,1,1,3,6,0
Hungary,1982,Friendly,12,8,3,3,0,6,4,0
Hungary,1983,Friendly,3,2,1,1,2,4,1,0
Hungary,1983,UEFA Euro qualification,18,17,3,4,1,8,1,0
Hungary,1984,FIFA World Cup qualification,7,3,3,0,0,3,4,0
Hungary,1984,Friendly,14,7,3,2,3,8,7,0
Hungary,1985,FIFA World Cup qualification,5,1,2,1,0,3,4,0
Hungary,1985,Friendly,8,3,4,1,0,5,5,0
Hungary,1986,FIFA World Cup,2,9,1,2,0,3,-7,0
Hungary,1986,Friendly,6,0,2,0,1,3,6,0
Hungary,1986,UEFA Euro qualification,1,3,0,2,0,2,-2,0
Hungary,1987,Friendly,0,2,0,1,2,3,-2,0
Hungary,1987,UEFA Euro qualification,12,8,4,2,0,6,4,0
Hungary,1988,FIFA World Cup qualification,3,2,1,0,1,2,1,0
Hungary,1988,Friendly,9,12,3,3,3,9,-3,0
Hungary,1989,FIFA World Cup qualification,5,10,1,2,3,6,-5,0
Hungary,1989,Friendly,4,5,1,1,1,3,-1,0
Hungary,1990,Friendly,13,9,4,3,0,7,4,0
Hungary,1990,UEFA Euro qualification,5,3,1,0,2,3,2,0
Hungary,1991,Friendly,6,12,1,4,1,6,-6,0
Hungary,1991,Nehru Cup,7,3,2,0,1,3,4,0
Hungary,1991,UEFA Euro qualification,5,6,1,2,2,5,-1,0
Hungary,1992,FIFA World Cup qualification,4,2,1,1,1,3,2,0
Hungary,1992,Friendly,13,8,4,2,2,8,5,0
Hungary,1993,FIFA World Cup qualification,2,9,1,4,0,5,-7,0
Hungary,1993,Friendly,4,4,1,1,0,2,0,0
Hungary,1993,Kirin Cup,1,0,1,0,1,2,1,0
Hungary,1994,Friendly,10,27,0,7,3,10,-17,0
Hungary,1994,UEFA Euro qualification,2,4,0,1,1,2,-2,0
Hungary,1995,Friendly,3,3,1,1,0,2,0,0
Hungary,1995,UEFA Euro qualification,5,9,2,3,1,6,-4,0
Hungary,1996,FIFA World Cup qualification,4,3,2,1,0,3,1,0
Hungary,1996,Friendly,4,12,1,4,0,5,-8,0
Hungary,1997,FIFA World Cup qualification,7,17,1,3,3,7,-10,0
Hungary,1997,Friendly,8,5,2,2,0,4,3,0
Hungary,1998,Friendly,10,3,5,0,1,6,7,0
Hungary,1998,UEFA Euro qualification,6,4,1,1,1,3,2,0
Hungary,1999,Friendly,3,3,0,0,3,3,0,0
Hungary,1999,UEFA Euro qualification,8,6,2,3,2,7,2,0
Hungary,2000,FIFA World Cup qualification,8,3,1,0,1,2,5,0
Hungary,2000,Friendly,7,7,3,1,3,7,0,0
Hungary,2001,FIFA World Cup qualification,6,10,1,4,1,6,-4,0
Hungary,2001,Friendly,9,7,1,1,3,5,2,0
Hungary,2002,Cyprus International Tournament,1,4,0,2,0,2,-3,0
Hungary,2002,Friendly,8,9,2,2,2,6,-1,0
Hungary,2002,UEFA Euro qualification,4,1,1,0,1,2,3,0
Hungary,2003,Friendly,6,5,1,3,0,4,1,0
Hungary,2003,UEFA Euro qualification,11,8,2,3,1,6,3,0
Hungary,2004,Cyprus International Tournament,4,1,2,0,0,2,3,0
Hungary,2004,FIFA World Cup qualification,5,8,2,2,0,4,-3,0
Hungary,2004,Friendly,10,8,3,2,0,5,2,0
Hungary,2004,King's Cup,5,1,1,1,0,2,4,0
Hungary,2005,FIFA World Cup qualification,8,6,2,2,2,6,2,0
Hungary,2005,Friendly,6,10,1,5,1,7,-4,0
Hungary,2006,Friendly,6,4,3,1,0,4,2,0
Hungary,2006,UEFA Euro qualification,5,8,1,3,0,4,-3,0
Hungary,2007,Cyprus International Tournament,3,2,1,1,0,2,1,0
Hungary,2007,Friendly,5,3,2,1,0,3,2,0
Hungary,2007,UEFA Euro qualification,6,14,3,5,0,8,-8,0
Hungary,2008,FIFA World Cup qualification,4,2,2,1,1,4,2,0
Hungary,2008,Friendly,10,8,2,1,3,6,2,0
Hungary,2009,FIFA World Cup qualification,6,6,3,3,0,6,0,0
Hungary,2009,Friendly,0,5,0,3,0,3,-5,0
Hungary,2010,Friendly,5,12,1,3,1,5,-7,0
Hungary,2010,UEFA Euro qualification,12,4,3,1,0,4,8,0
Hungary,2011,Friendly,13,2,4,1,0,5,11,0
Hungary,2011,UEFA Euro qualification,10,10,3,2,1,6,0,0
Hungary,2012,FIFA World Cup qualification,10,5,3,1,0,4,5,0
Hungary,2012,Friendly,4,5,1,1,3,5,-1,0
Hungary,2013,FIFA World Cup qualification,11,15,2,2,2,6,-4,0
Hungary,2013,Friendly,3,2,1,0,2,3,1,0
Hungary,2014,Friendly,8,6,2,2,1,5,2,0
Hungary,2014,UEFA Euro qualification,4,3,2,1,1,4,1,0
Hungary,2015,Friendly,4,0,1,0,0,1,4,0
Hungary,2015,UEFA Euro qualification,10,7,4,1,3,8,3,0
Hungary,2016,FIFA World Cup qualification,8,3,2,1,1,4,5,0
Hungary,2016,Friendly,1,3,0,1,2,3,-2,0
Hungary,2016,UEFA Euro,6,8,1,1,2,4,-2,0
Hungary,2017,FIFA World Cup qualification,6,11,2,4,0,6,-5,0
Hungary,2017,Friendly,2,5,1,2,0,3,-3,0
Hungary,2018,Friendly,4,7,0,3,1,4,-3,0
Hungary,2018,UEFA Nations League,9,6,3,2,1,6,3,0
Hungary,2019,Friendly,2,4,0,2,0,2,-2,0
Hungary,2019,UEFA Euro qualification,8,11,4,4,0,8,-3,0
Hungary,2020,UEFA Euro qualification,5,2,2,0,0,2,3,0
Hungary,2020,UEFA Nations League,7,4,3,1,2,6,3,0
Hungary,2021,FIFA World Cup qualification,19,13,5,3,2,10,6,0
Hungary,2021,Friendly,1,0,1,0,1,2,1,0
Hungary,2021,UEFA Euro,3,6,0,1,2,3,-3,0
Hungary,2022,Friendly,5,4,2,1,1,4,1,0
Hungary,2022,UEFA Nations League,8,5,3,2,1,6,3,0
Hungary,2023,Friendly,2,1,1,0,1,2,1,0
Hungary,2023,UEFA Euro qualification,16,7,5,0,3,8,9,0
Hungary,2024,Friendly,7,2,3,1,0,4,5,0
Hungary,2024,UEFA Euro,2,5,1,2,0,3,-3,0
Hungary,2024,UEFA Nations League,4,11,1,2,3,6,-7,0
Hungary,2025,UEFA Nations League,1,6,0,2,0,2,-5,0
Iceland,1946,Friendly,0,3,0,1,0,1,-3,0
Iceland,1947,Friendly,2,4,0,1,0,1,-2,0
Iceland,1948,Friendly,2,0,1,0,0,1,2,0
Iceland,1949,Friendly,1,5,0,1,0,1,-4,0
Iceland,1951,Friendly,5,6,1,1,0,2,-1,0
Iceland,1953,Friendly,1,7,0,2,0,2,-6,0
Iceland,1954,Friendly,3,3,1,1,0,2,0,0
Iceland,1955,Friendly,3,6,1,1,0,2,-3,0
Iceland,1956,Friendly,1,2,0,1,0,1,-1,0
Iceland,1957,FIFA World Cup qualification,6,26,0,4,0,4,-20,0
Iceland,1957,Friendly,2,9,0,2,0,2,-7,0
Iceland,1960,Friendly,0,9,0,2,0,2,-9,0
Iceland,1962,Friendly,1,3,0,1,0,1,-2,0
Iceland,1962,UEFA Euro qualification,3,5,0,1,1,2,-2,0
Iceland,1964,Friendly,4,5,1,1,0,2,-1,0
Iceland,1965,Friendly,1,3,0,1,0,1,-2,0
Iceland,1967,Friendly,2,14,0,1,0,1,-12,0
Iceland,1968,Friendly,0,4,0,1,0,1,-4,0
Iceland,1969,Friendly,6,9,1,3,0,4,-3,0
Iceland,1970,Friendly,2,0,1,0,1,2,2,0
Iceland,1971,Friendly,1,5,0,2,0,2,-4,0
Iceland,1972,FIFA World Cup qualification,1,12,0,3,0,3,-11,0
Iceland,1972,Friendly,5,5,1,1,0,2,0,0
Iceland,1973,FIFA World Cup qualification,1,17,0,3,0,3,-16,0
Iceland,1973,Friendly,5,5,1,3,0,4,0,0
Iceland,1974,Friendly,6,6,1,1,1,3,0,0
Iceland,1974,UEFA Euro qualification,1,3,0,1,1,2,-2,0
Iceland,1975,Friendly,6,0,1,0,0,1,6,0
Iceland,1975,UEFA Euro qualification,2,5,1,2,1,4,-3,0
Iceland,1976,FIFA World Cup qualification,0,2,0,2,0,2,-2,0
Iceland,1976,Friendly,10,3,3,1,0,4,7,0
Iceland,1977,FIFA World Cup qualification,2,10,1,3,0,4,-8,0
Iceland,1977,Friendly,2,2,1,1,0,2,0,0
Iceland,1978,Friendly,0,0,0,0,2,2,0,0
Iceland,1978,UEFA Euro qualification,1,8,0,3,0,3,-7,0
Iceland,1979,Friendly,1,3,0,1,0,1,-2,0
Iceland,1979,UEFA Euro qualification,1,13,0,5,0,5,-12,0
Iceland,1980,FIFA World Cup qualification,4,12,1,3,0,4,-8,0
Iceland,1980,Friendly,9,7,2,1,2,5,2,0
Iceland,1981,FIFA World Cup qualification,6,9,1,1,2,4,-3,0
Iceland,1981,Friendly,3,3,1,1,0,2,0,0
Iceland,1982,Friendly,11,6,2,2,2,6,5,0
Iceland,1982,UEFA Euro qualification,2,6,0,3,1,4,-4,0
Iceland,1983,Friendly,6,4,1,1,0,2,2,0
Iceland,1983,UEFA Euro qualification,1,7,1,3,0,4,-6,0
Iceland,1984,FIFA World Cup qualification,2,5,1,2,0,3,-3,0
Iceland,1984,Friendly,3,2,2,1,1,4,1,0
Iceland,1985,FIFA World Cup qualification,2,5,0,3,0,3,-3,0
Iceland,1985,Friendly,11,1,2,0,2,4,10,0
Iceland,1986,Friendly,5,7,1,4,0,5,-2,0
Iceland,1986,UEFA Euro qualification,1,3,0,1,2,3,-2,0
Iceland,1987,Friendly,2,1,1,0,1,2,1,0
Iceland,1987,UEFA Euro qualification,3,11,2,3,0,5,-8,0
Iceland,1988,FIFA World Cup qualification,2,4,0,1,2,3,-2,0
Iceland,1988,Friendly,3,10,1,4,0,5,-7,0
Iceland,1989,FIFA World Cup qualification,4,7,1,2,2,5,-3,0
Iceland,1990,Friendly,10,7,3,1,0,4,3,0
Iceland,1990,UEFA Euro qualification,4,5,1,3,0,4,-1,0
Iceland,1991,Friendly,10,4,2,1,2,5,6,0
Iceland,1991,UEFA Euro qualification,3,5,1,3,0,4,-2,0
Iceland,1992,FIFA World Cup qualification,2,4,1,3,0,4,-2,0
Iceland,1992,Friendly,3,4,1,1,1,3,-1,0
Iceland,1992,Malta International Tournament,0,1,0,1,0,1,-1,0
Iceland,1993,FIFA World Cup qualification,5,2,2,0,2,4,3,0
Iceland,1993,Friendly,2,5,0,2,1,3,-3,0
Iceland,1994,Friendly,9,6,5,2,0,7,3,0
Iceland,1994,UEFA Euro qualification,0,7,0,3,0,3,-7,0
Iceland,1995,Friendly,3,1,1,0,1,2,2,0
Iceland,1995,UEFA Euro qualification,3,5,1,2,2,5,-2,0
Iceland,1996,FIFA World Cup qualification,1,7,0,2,2,4,-6,0
Iceland,1996,Friendly,8,4,3,1,0,4,4,0
Iceland,1996,Malta International Tournament,5,11,1,2,0,3,-6,1
Iceland,1997,FIFA World Cup qualification,10,9,2,3,1,6,1,0
Iceland,1997,Friendly,2,4,1,2,1,4,-2,0
Iceland,1998,Cyprus International Tournament,3,5,0,2,0,2,-2,0
Iceland,1998,Friendly,6,3,1,0,2,3,3,0
Iceland,1998,UEFA Euro qualification,2,1,1,0,2,3,1,0
Iceland,1999,Friendly,5,2,3,0,0,3,3,0
Iceland,1999,UEFA Euro qualification,10,6,3,3,1,7,4,0
Iceland,2000,FIFA World Cup qualification,2,6,1,2,0,3,-4,0
Iceland,2000,Friendly,5,1,1,1,0,2,4,0
Iceland,2000,Nordic Championship,6,3,3,0,1,4,3,0
Iceland,2001,FIFA World Cup qualification,12,14,3,3,1,7,-2,0
Iceland,2001,Friendly,1,1,0,0,1,1,0,0
Iceland,2001,Millennium Cup,3,2,1,1,0,2,1,0
Iceland,2002,Friendly,5,12,1,4,2,7,-7,0
Iceland,2002,UEFA Euro qualification,3,2,1,1,0,2,1,0
Iceland,2003,Friendly,0,3,0,1,1,2,-3,0
Iceland,2003,UEFA Euro qualification,8,7,3,2,1,6,1,0
Iceland,2004,FIFA World Cup qualification,4,10,0,3,1,4,-6,0
Iceland,2004,Friendly,6,11,1,3,1,5,-5,0
Iceland,2005,FIFA World Cup qualification,10,17,1,5,0,6,-7,0
Iceland,2005,Friendly,6,4,1,1,1,3,2,0
Iceland,2006,Friendly,0,2,0,1,1,2,-2,0
Iceland,2006,UEFA Euro qualification,4,8,1,3,0,4,-4,0
Iceland,2007,Friendly,1,1,0,0,1,1,0,0
Iceland,2007,UEFA Euro qualification,6,19,1,5,2,8,-13,0
Iceland,2008,FIFA World Cup qualification,4,6,1,2,1,4,-2,0
Iceland,2008,Friendly,7,3,3,1,1,5,4,0
Iceland,2008,Malta International Tournament,2,3,1,2,0,3,-1,1
Iceland,2009,FIFA World Cup qualification,3,7,0,3,1,4,-4,0
Iceland,2009,Friendly,9,6,3,2,2,7,3,0
Iceland,2010,Friendly,9,4,2,1,3,6,5,0
Iceland,2010,UEFA Euro qualification,2,6,0,3,0,3,-4,0
Iceland,2011,Friendly,0,4,0,1,0,1,-4,0
Iceland,2011,UEFA Euro qualification,4,8,1,3,1,5,-4,0
Iceland,2012,FIFA World Cup qualification,4,4,2,2,0,4,0,0
Iceland,2012,Friendly,10,11,2,4,0,6,-1,0
Iceland,2013,FIFA World Cup qualification,13,13,3,2,3,8,0,0
Iceland,2013,Friendly,1,2,1,1,0,2,-1,0
Iceland,2014,Friendly,4,9,1,3,1,5,-5,0
Iceland,2014,UEFA Euro qualification,9,2,3,1,0,4,7,0
Iceland,2015,Friendly,7,10,1,2,2,5,-3,0
Iceland,2015,UEFA Euro qualification,8,4,3,1,2,6,4,0
Iceland,2016,FIFA World Cup qualification,6,5,2,1,1,4,1,0
Iceland,2016,Friendly,16,12,4,4,0,8,4,0
Iceland,2016,UEFA Euro,8,9,2,1,2,5,-1,0
Iceland,2017,FIFA World Cup qualification,10,2,5,1,0,6,8,0
Iceland,2017,Friendly,5,5,2,3,1,6,0,0
Iceland,2018,FIFA World Cup,2,5,0,2,1,3,-3,0
Iceland,2018,Friendly,19,16,2,3,3,8,3,0
Iceland,2018,UEFA Nations League,1,13,0,4,0,4,-12,0
Iceland,2019,Friendly,2,2,0,0,2,2,0,0
Iceland,2019,UEFA Euro qualification,14,11,6,3,1,10,3,0
Iceland,2020,Friendly,2,0,2,0,0,2,2,0
Iceland,2020,UEFA Euro qualification,3,3,1,1,0,2,0,0
Iceland,2020,UEFA Nations League,3,17,0,6,0,6,-14,0
Iceland,2021,FIFA World Cup qualification,12,18,2,5,3,10,-6,0
Iceland,2021,Friendly,4,4,1,1,1,3,0,0
Iceland,2022,Baltic Cup,1,1,0,0,2,2,0,0
Iceland,2022,Friendly,5,14,2,4,2,8,-9,0
Iceland,2022,UEFA Nations League,6,6,0,0,4,4,0,0
Iceland,2023,Friendly,2,3,0,1,1,2,-1,0
Iceland,2023,UEFA Euro qualification,17,16,3,6,1,10,1,0
Iceland,2024,Friendly,4,4,3,1,0,4,0,0
Iceland,2024,UEFA Euro qualification,5,3,1,1,0,2,2,0
Iceland,2024,UEFA Nations League,10,13,2,3,1,6,-3,0
Iceland,2025,UEFA Nations League,2,5,0,2,0,2,-3,0
India,1938,Friendly,16,18,1,3,1,5,-2,0
India,1941,Friendly,3,2,1,1,0,2,1,0
India,1951,Asian Games,7,0,3,0,0,3,7,1
India,1952,Friendly,6,1,2,0,1,3,5,0
India,1953,Friendly,6,2,2,0,0,2,4,0
India,1954,Asian Games,3,6,1,1,0,2,-3,0
India,1954,Friendly,3,2,1,0,1,2,1,0
India,1955,Friendly,7,15,2,1,0,3,-8,0
India,1956,Friendly,7,5,1,2,0,3,2,0
India,1957,Friendly,6,4,2,0,0,2,2,0
India,1958,Asian Games,11,13,2,3,0,5,-2,0
India,1959,AFC Asian Cup qualification,2,3,1,1,0,2,-1,0
India,1959,Friendly,5,8,1,1,1,3,-3,0
India,1959,Merdeka Tournament,5,3,1,0,2,3,2,0
India,1960,Friendly,2,5,0,1,2,3,-3,0
India,1961,Friendly,1,3,0,1,0,1,-2,0
India,1961,Merdeka Tournament,4,6,1,2,0,3,-2,0
India,1962,Asian Games,11,6,4,1,0,5,5,1
India,1964,AFC Asian Cup,5,3,2,1,0,3,2,0
India,1964,Friendly,6,4,1,0,0,1,2,0
India,1964,Merdeka Tournament,7,3,2,1,1,4,4,0
India,1965,Friendly,2,1,1,0,0,1,1,0
India,1965,Merdeka Tournament,9,5,2,1,3,6,4,0
India,1966,Asian Games,4,7,1,2,0,3,-3,0
India,1966,Merdeka Tournament,8,1,5,1,0,6,7,0
India,1967,AFC Asian Cup qualification,1,3,0,1,1,2,-2,0
India,1967,Merdeka Tournament,9,7,2,2,3,7,2,0
India,1968,Friendly,1,5,0,2,0,2,-4,0
India,1968,Merdeka Tournament,8,8,2,3,1,6,0,0
India,1969,Friendly,3,7,0,1,0,1,-4,0
India,1969,Merdeka Tournament,5,9,2,3,0,5,-4,0
India,1970,Asian Games,8,5,3,2,1,6,3,0
India,1970,Friendly,8,3,1,0,0,1,5,0
India,1970,Merdeka Tournament,12,10,4,3,0,7,2,0
India,1971,Friendly,8,6,2,1,1,4,2,0
India,1971,Indonesia Tournament,2,4,0,2,0,2,-2,0
India,1971,Merdeka Tournament,10,17,1,3,1,5,-7,0
India,1973,Friendly,5,4,1,0,0,1,1,0
India,1973,Merdeka Tournament,8,6,3,1,2,6,2,0
India,1974,Asian Games,2,14,0,3,0,3,-12,0
India,1974,Merdeka Tournament,7,8,1,1,2,4,-1,0
India,1976,Friendly,2,2,0,0,2,2,0,0
India,1976,Korea Cup,1,10,0,3,0,3,-9,0
India,1976,Merdeka Tournament,9,27,1,4,1,6,-18,0
India,1977,Friendly,5,6,1,2,0,3,-1,0
India,1977,King's Cup,3,5,1,1,1,3,-2,0
India,1977,Korea Cup,0,7,0,2,0,2,-7,0
India,1978,Asian Games,5,13,1,4,0,5,-8,0
India,1979,Friendly,0,0,0,0,1,1,0,0
India,1981,Friendly,1,5,0,2,0,2,-4,0
India,1981,Merdeka Tournament,7,5,2,1,2,5,2,0
India,1982,Asian Games,5,3,2,1,1,4,2,0
India,1982,Friendly,1,1,0,0,1,1,0,0
India,1982,Korea Cup,0,1,0,1,1,2,-1,0
India,1982,Merdeka Tournament,0,4,0,2,1,3,-4,0
India,1982,Nehru Cup,4,6,0,1,2,3,-2,0
India,1984,AFC Asian Cup,0,7,0,3,1,4,-7,0
India,1984,AFC Asian Cup qualification,8,2,3,1,0,4,6,0
India,1984,Friendly,5,20,1,5,0,6,-15,0
India,1984,Great Wall Cup,0,2,0,1,0,1,-2,0
India,1984,Nehru Cup,1,6,0,3,0,3,-5,0
India,1985,FIFA World Cup qualification,7,6,2,1,3,6,1,0
India,1985,Nehru Cup,0,1,0,1,0,1,-1,0
India,1985,South Asian Games,6,1,2,0,1,3,5,0
India,1986,Asian Games,1,8,0,3,0,3,-7,0
India,1986,Friendly,1,3,0,1,0,1,-2,0
India,1986,Merdeka Tournament,3,4,1,1,0,2,-1,0
India,1986,Nehru Cup,0,1,0,1,1,2,-1,0
India,1987,Nehru Cup,1,1,0,0,1,1,0,0
India,1987,South Asian Games,6,0,2,0,1,3,6,1
India,1988,AFC Asian Cup qualification,1,6,0,3,2,5,-5,0
India,1989,Nehru Cup,1,2,0,1,0,1,-1,0
India,1989,South Asian Games,5,3,2,0,1,3,2,0
India,1991,Nehru Cup,3,5,1,2,0,3,-2,0
India,1991,South Asian Games,1,2,0,1,1,2,-1,0
India,1992,AFC Asian Cup qualification,0,3,0,1,0,1,-3,0
India,1993,FIFA World Cup qualification,8,22,1,6,1,8,-14,0
India,1993,Nehru Cup,3,5,0,1,3,4,-2,0
India,1993,South Asian Games,6,4,1,0,2,3,2,0
India,1994,Friendly,5,9,1,3,0,4,-4,0
India,1995,Nehru Cup,2,6,1,1,1,3,-4,0
India,1995,SAFF Cup,2,3,0,1,2,3,-1,0
India,1995,South Asian Games,5,0,3,0,0,3,5,1
India,1996,AFC Asian Cup qualification,3,12,0,2,0,2,-9,0
India,1996,FIFA World Cup qualification,3,7,1,1,1,3,-4,0
India,1997,Nehru Cup,4,6,0,2,3,5,-2,0
India,1997,SAFF Cup,12,3,3,0,1,4,9,1
India,1998,Asian Games,3,8,1,4,0,5,-5,0
India,1998,Friendly,0,4,0,1,1,2,-4,0
India,1999,AFC Asian Cup qualification,8,9,1,2,1,4,-1,0
India,1999,SAFF Cup,6,1,3,0,1,4,5,0
India,1999,South Asian Games,15,4,4,1,0,5,11,0
India,2000,Friendly,2,3,1,2,1,4,-1,0
India,2001,FIFA World Cup qualification,11,5,3,1,2,6,6,0
India,2001,Merdeka Tournament,1,2,0,1,0,1,-1,0
India,2001,Millennium Cup,0,3,0,1,0,1,-3,0
India,2002,Friendly,0,3,0,1,1,2,-3,0
India,2003,AFC Asian Cup qualification,1,3,0,1,1,2,-2,0
India,2003,Afro-Asian Games,8,4,2,0,0,2,4,0
India,2003,Friendly,0,2,0,1,0,1,-2,0
India,2003,SAFF Cup,8,5,2,2,1,5,3,0
India,2004,FIFA World Cup qualification,2,18,1,4,1,6,-16,0
India,2004,Friendly,7,6,2,1,1,4,1,0
India,2005,Friendly,3,7,1,3,1,5,-4,0
India,2005,SAFF Cup,9,2,4,0,1,5,7,1
India,2006,AFC Asian Cup qualification,2,24,0,6,0,6,-22,0
India,2006,Friendly,2,2,0,0,1,1,0,0
India,2007,FIFA World Cup qualification,3,6,0,1,1,2,-3,0
India,2007,Nehru Cup,13,3,4,1,0,5,10,1
India,2008,AFC Challenge Cup,9,3,4,0,1,5,6,1
India,2008,Friendly,6,3,1,0,2,3,3,0
India,2008,SAFF Cup,9,3,4,1,0,5,6,0
India,2009,Friendly,1,2,0,1,0,1,-1,0
India,2009,Nehru Cup,6,5,2,2,1,5,1,0
India,2010,Friendly,10,27,2,7,0,9,-17,0
India,2011,AFC Asian Cup,3,13,0,3,0,3,-10,0
India,2011,AFC Challenge Cup qualification,7,2,2,0,1,3,5,0
India,2011,FIFA World Cup qualification,2,5,0,1,1,2,-3,0
India,2011,Friendly,8,15,2,3,2,7,-7,0
India,2011,SAFF Cup,16,2,4,0,1,5,14,1
India,2012,AFC Challenge Cup,0,8,0,3,0,3,-8,0
India,2012,Friendly,1,10,0,3,0,3,-9,0
India,2012,Nehru Cup,7,4,2,1,2,5,3,0
India,2013,AFC Challenge Cup qualification,6,2,2,1,0,3,4,0
India,2013,Friendly,5,8,1,2,1,4,-3,0
India,2013,SAFF Cup,4,3,2,1,1,4,1,1
India,2014,Friendly,4,5,0,1,1,2,-1,0
India,2015,FIFA World Cup qualification,6,12,2,5,1,8,-6,0
India,2015,Friendly,0,0,0,0,1,1,0,0
India,2015,SAFF Cup,9,3,3,0,0,3,6,0
India,2016,AFC Asian Cup qualification,7,1,2,0,0,2,6,0
India,2016,FIFA World Cup qualification,1,6,0,2,0,2,-5,0
India,2016,Friendly,7,1,2,0,0,2,6,0
India,2016,SAFF Cup,2,1,1,0,0,1,1,1
India,2017,AFC Asian Cup qualification,10,3,4,0,1,5,7,0
India,2017,Friendly,8,4,3,0,1,4,4,0
India,2018,AFC Asian Cup qualification,1,2,0,1,0,1,-1,0
India,2018,Friendly,1,2,0,1,2,3,-1,0
India,2018,Intercontinental Cup,11,2,3,1,0,4,9,1
India,2018,SAFF Cup,8,3,3,1,0,4,5,0
India,2019,AFC Asian Cup,4,4,1,2,0,3,0,0
India,2019,FIFA World Cup qualification,3,5,0,2,3,5,-2,0
India,2019,Intercontinental Cup,5,10,0,2,1,3,-5,0
India,2021,FIFA World Cup qualification,3,2,1,1,1,3,1,0
India,2021,Friendly,4,9,1,1,2,4,-5,0
India,2021,SAFF Cup,8,2,3,0,2,5,6,1
India,2022,AFC Asian Cup qualification,8,1,3,0,0,3,7,0
India,2022,Friendly,2,11,0,4,1,5,-9,0
India,2023,FIFA World Cup qualification,1,3,1,1,0,2,-2,0
India,2023,King's Cup,2,3,0,1,1,2,-1,0
India,2023,SAFF Cup,8,2,2,0,3,5,6,0
India,2023,Tri Nation Tournament,3,0,2,0,0,2,3,0
India,2024,AFC Asian Cup,0,6,0,3,0,3,-6,0
India,2024,FIFA World Cup qualification,2,4,0,2,2,4,-2,0
India,2024,Friendly,2,2,0,0,2,2,0,0
India,2024,Intercontinental Cup,0,3,0,1,1,2,-3,0
India,2025,AFC Asian Cup qualification,0,0,0,0,1,1,0,0
India,2025,Friendly,3,0,1,0,0,1,3,0
Indonesia,1934,Far Eastern Championship Games,9,6,1,2,0,3,3,0
Indonesia,1934,Friendly,9,6,1,2,0,3,3,0
Indonesia,1938,FIFA World Cup,0,6,0,1,0,1,-6,0
Indonesia,1938,Friendly,2,9,0,1,0,1,-7,0
Indonesia,1951,Asian Games,0,3,0,1,0,1,-3,0
Indonesia,1953,Friendly,1,3,0,1,0,1,-2,0
Indonesia,1954,Asian Games,15,12,2,2,0,4,3,0
Indonesia,1956,Friendly,13,22,1,4,0,5,-9,0
Indonesia,1957,FIFA World Cup qualification,5,4,1,1,1,3,1,0
Indonesia,1957,Merdeka Tournament,9,5,2,1,0,3,4,0
Indonesia,1958,Asian Games,15,7,4,1,0,5,8,0
Indonesia,1958,Friendly,14,3,4,0,0,4,11,0
Indonesia,1958,Merdeka Tournament,8,4,2,1,0,3,4,0
Indonesia,1959,Friendly,2,2,0,0,1,1,0,0
Indonesia,1960,Friendly,11,3,2,0,1,3,8,0
Indonesia,1960,Merdeka Tournament,17,8,3,1,0,4,9,0
Indonesia,1961,Friendly,3,5,1,1,0,2,-2,0
Indonesia,1961,Merdeka Tournament,5,2,3,0,0,3,3,0
Indonesia,1961,Vietnam Independence Cup,2,7,0,2,0,2,-5,0
Indonesia,1962,Asian Games,9,3,2,1,0,3,6,0
Indonesia,1962,Friendly,3,10,1,4,0,5,-7,0
Indonesia,1962,Merdeka Tournament,15,2,4,0,0,4,13,1
Indonesia,1962,Vietnam Independence Cup,9,7,2,2,0,4,2,0
Indonesia,1963,Friendly,12,16,2,3,2,7,-4,0
Indonesia,1964,Friendly,13,4,2,0,0,2,9,0
Indonesia,1965,Friendly,8,10,2,3,1,6,-2,0
Indonesia,1966,Asian Games,8,4,2,1,2,5,4,0
Indonesia,1967,AFC Asian Cup qualification,8,3,1,1,1,3,5,0
Indonesia,1967,Merdeka Tournament,11,12,3,3,0,6,-1,0
Indonesia,1968,Friendly,3,2,1,1,0,2,1,0
Indonesia,1968,King's Cup,18,2,5,0,0,5,16,1
Indonesia,1968,Merdeka Tournament,24,13,3,3,0,6,11,0
Indonesia,1969,King's Cup,11,7,3,2,0,5,4,0
Indonesia,1969,Merdeka Tournament,19,4,4,0,0,4,15,0
Indonesia,1970,Asian Games,4,7,1,2,2,5,-3,0
Indonesia,1970,Indonesia Tournament,10,6,3,0,1,4,4,0
Indonesia,1970,King's Cup,14,9,3,2,0,5,5,0
Indonesia,1970,Merdeka Tournament,16,15,3,3,0,6,1,0
Indonesia,1970,Vietnam Independence Cup,3,8,0,3,0,3,-5,0
Indonesia,1971,AFC Asian Cup qualification,12,6,3,2,0,5,6,0
Indonesia,1971,Friendly,3,5,0,2,0,2,-2,0
Indonesia,1971,Indonesia Tournament,7,3,3,1,2,6,4,0
Indonesia,1971,King's Cup,2,1,1,1,1,3,1,0
Indonesia,1971,Korea Cup,14,9,2,2,0,4,5,0
Indonesia,1971,Merdeka Tournament,16,5,5,1,1,7,11,0
Indonesia,1972,Friendly,11,5,3,1,1,5,6,0
Indonesia,1972,Indonesia Tournament,1,0,1,0,0,1,1,0
Indonesia,1972,King's Cup,2,8,0,3,1,4,-6,0
Indonesia,1972,Korea Cup,5,5,1,1,1,3,0,0
Indonesia,1972,Merdeka Tournament,3,5,1,2,1,4,-2,0
Indonesia,1973,FIFA World Cup qualification,6,13,1,3,2,6,-7,0
Indonesia,1973,Friendly,0,4,0,1,0,1,-4,0
Indonesia,1973,Indonesia Tournament,2,0,1,0,1,2,2,0
Indonesia,1973,Korea Cup,3,6,0,2,0,2,-3,0
Indonesia,1974,Friendly,6,18,1,4,0,5,-12,0
Indonesia,1974,Indonesia Tournament,6,7,1,1,0,2,-1,0
Indonesia,1974,Merdeka Tournament,8,4,1,1,2,4,4,0
Indonesia,1975,AFC Asian Cup qualification,3,5,1,2,1,4,-2,0
Indonesia,1975,Indonesia Tournament,11,5,3,1,0,4,6,1
Indonesia,1975,Merdeka Tournament,12,16,3,4,0,7,-4,0
Indonesia,1976,Friendly,1,1,0,0,1,1,0,0
Indonesia,1976,Indonesia Tournament,2,3,0,1,1,2,-1,0
Indonesia,1976,Merdeka Tournament,3,24,0,6,0,6,-21,0
Indonesia,1977,FIFA World Cup qualification,7,7,1,2,1,4,0,0
Indonesia,1977,Southeast Asian Games,7,6,2,2,1,5,1,0
Indonesia,1978,Indonesia Tournament,7,5,2,1,1,4,2,0
Indonesia,1978,Korea Cup,0,2,0,1,0,1,-2,0
Indonesia,1978,Merdeka Tournament,3,11,2,4,1,7,-8,0
Indonesia,1979,AFC Asian Cup qualification,1,3,0,1,0,1,-2,0
Indonesia,1979,King's Cup,0,3,0,1,1,2,-3,0
Indonesia,1979,Kirin Cup,0,4,0,1,0,1,-4,0
Indonesia,1979,Korea Cup,0,2,0,1,0,1,-2,0
Indonesia,1979,Merdeka Tournament,3,6,1,1,3,5,-3,0
Indonesia,1979,Southeast Asian Games,6,5,2,2,2,6,1,0
Indonesia,1980,Friendly,1,12,0,2,1,3,-11,0
Indonesia,1980,Korea Cup,6,9,2,2,1,5,-3,0
Indonesia,1980,Merdeka Tournament,4,7,1,3,3,7,-3,0
Indonesia,1981,FIFA World Cup qualification,5,14,2,4,2,8,-9,0
Indonesia,1981,Friendly,2,0,1,0,0,1,2,0
Indonesia,1981,Indonesia Tournament,3,1,1,1,0,2,2,0
Indonesia,1981,Korea Cup,3,7,0,3,0,3,-4,0
Indonesia,1981,Merdeka Tournament,5,7,1,3,1,5,-2,0
Indonesia,1981,Southeast Asian Games,6,2,3,1,0,4,4,0
Indonesia,1982,Merdeka Tournament,5,8,1,2,1,4,-3,0
Indonesia,1982,Merlion Cup,0,2,0,1,1,2,-2,0
Indonesia,1983,Friendly,0,2,0,1,0,1,-2,0
Indonesia,1983,Korea Cup,1,8,0,3,0,3,-7,0
Indonesia,1983,Southeast Asian Games,3,7,1,1,1,3,-4,0
Indonesia,1984,AFC Asian Cup qualification,6,5,3,2,0,5,1,0
Indonesia,1984,Merdeka Tournament,3,5,0,2,1,3,-2,0
Indonesia,1985,FIFA World Cup qualification,9,10,4,3,1,8,-1,0
Indonesia,1985,Friendly,5,11,1,2,1,4,-6,0
Indonesia,1985,Indonesia Tournament,1,2,0,1,0,1,-1,0
Indonesia,1985,Southeast Asian Games,1,10,0,3,1,4,-9,0
Indonesia,1986,Asian Games,4,14,1,3,2,6,-10,0
Indonesia,1986,Friendly,2,3,0,1,0,1,-1,0
Indonesia,1986,Indonesia Tournament,0,1,0,1,0,1,-1,0
Indonesia,1986,King's Cup,1,1,0,0,1,1,0,0
Indonesia,1987,Indonesia Tournament,5,3,2,0,1,3,2,1
Indonesia,1987,Southeast Asian Games,3,0,2,0,1,3,3,1
Indonesia,1988,AFC Asian Cup qualification,1,4,1,1,1,3,-3,0
Indonesia,1988,Friendly,1,6,0,3,0,3,-5,0
Indonesia,1988,Indonesia Tournament,1,0,1,0,0,1,1,1
Indonesia,1988,King's Cup,6,3,1,0,1,2,3,0
Indonesia,1988,Merdeka Tournament,0,0,0,0,2,2,0,0
Indonesia,1989,FIFA World Cup qualification,5,10,1,2,3,6,-5,0
Indonesia,1989,Friendly,2,1,1,0,0,1,1,0
Indonesia,1989,King's Cup,1,6,0,2,0,2,-5,0
Indonesia,1989,Southeast Asian Games,12,5,2,2,1,5,7,0
Indonesia,1990,Friendly,6,3,1,1,0,2,3,0
Indonesia,1990,King's Cup,3,4,0,1,1,2,-1,0
Indonesia,1991,Friendly,0,2,0,1,0,1,-2,0
Indonesia,1991,Korea Cup,0,12,0,3,0,3,-12,0
Indonesia,1991,Merdeka Tournament,2,1,1,0,0,1,1,1
Indonesia,1991,Southeast Asian Games,5,1,3,0,2,5,4,0
Indonesia,1992,AFC Asian Cup qualification,3,4,1,1,1,3,-1,0
Indonesia,1992,Friendly,1,4,0,1,1,2,-3,0
Indonesia,1993,FIFA World Cup qualification,6,19,1,7,0,8,-13,0
Indonesia,1993,Merdeka Tournament,0,2,0,1,0,1,-2,0
Indonesia,1993,Southeast Asian Games,6,6,2,2,1,5,0,0
Indonesia,1995,Friendly,0,0,0,0,1,1,0,0
Indonesia,1995,Southeast Asian Games,14,3,2,2,0,4,11,0
Indonesia,1996,AFC Asian Cup,4,8,0,2,1,3,-4,0
Indonesia,1996,AFC Asian Cup qualification,8,2,1,0,1,2,6,0
Indonesia,1996,AFF Championship,18,9,3,2,1,6,9,0
Indonesia,1996,Friendly,3,21,0,6,0,6,-18,0
Indonesia,1997,Dunhill Cup,1,2,1,1,1,3,-1,0
Indonesia,1997,FIFA World Cup qualification,11,6,1,1,4,6,5,0
Indonesia,1997,Friendly,9,6,2,2,0,4,3,0
Indonesia,1997,Southeast Asian Games,16,6,4,0,2,6,10,0
Indonesia,1998,AFF Championship,15,10,2,2,1,5,5,0
Indonesia,1999,AFC Asian Cup qualification,18,5,3,0,1,4,13,0
Indonesia,1999,Friendly,2,2,0,0,1,1,0,0
Indonesia,1999,Southeast Asian Games,11,2,3,1,2,6,9,0
Indonesia,2000,AFC Asian Cup,0,7,0,2,1,3,-7,0
Indonesia,2000,AFF Championship,13,10,3,2,0,5,3,0
Indonesia,2000,Friendly,8,2,3,1,1,5,6,0
Indonesia,2001,FIFA World Cup qualification,16,7,4,2,0,6,9,0
Indonesia,2002,AFF Championship,22,7,3,0,3,6,15,0
Indonesia,2002,Friendly,1,1,0,0,1,1,0,0
Indonesia,2003,AFC Asian Cup qualification,9,13,3,2,1,6,-4,0
Indonesia,2003,Friendly,1,1,0,0,1,1,0,0
Indonesia,2004,AFC Asian Cup,3,9,1,2,0,3,-6,0
Indonesia,2004,AFF Championship,18,2,3,1,1,5,16,0
Indonesia,2004,FIFA World Cup qualification,8,12,2,3,1,6,-4,0
Indonesia,2004,Friendly,2,5,0,2,2,4,-3,0
Indonesia,2005,AFF Championship,6,6,1,2,0,3,0,0
Indonesia,2005,Friendly,0,3,0,1,0,1,-3,0
Indonesia,2006,Friendly,2,1,1,0,0,1,1,0
Indonesia,2006,Merdeka Tournament,2,3,0,1,2,3,-1,0
Indonesia,2007,AFC Asian Cup,3,4,1,2,0,3,-1,0
Indonesia,2007,AFF Championship,6,4,1,0,2,3,2,0
Indonesia,2007,FIFA World Cup qualification,1,11,0,2,0,2,-10,0
Indonesia,2007,Friendly,5,2,2,1,0,3,3,0
Indonesia,2008,AFF Championship,7,3,2,2,0,4,4,0
Indonesia,2008,Friendly,18,5,5,2,1,8,13,0
Indonesia,2009,AFC Asian Cup qualification,2,3,0,1,3,4,-1,0
Indonesia,2009,Friendly,1,3,0,1,0,1,-2,0
Indonesia,2010,AFC Asian Cup qualification,1,3,0,2,0,2,-2,0
Indonesia,2010,AFF Championship,17,6,6,1,0,7,11,1
Indonesia,2010,Friendly,12,7,3,1,0,4,5,0
Indonesia,2011,FIFA World Cup qualification,8,20,1,5,1,7,-12,0
Indonesia,2011,Friendly,4,2,1,1,1,3,2,0
Indonesia,2012,AFF Championship,3,4,1,1,1,3,-1,0
Indonesia,2012,FIFA World Cup qualification,0,10,0,1,0,1,-10,0
Indonesia,2012,Friendly,3,4,1,1,3,5,-1,0
Indonesia,2013,AFC Asian Cup qualification,2,7,0,4,1,5,-5,0
Indonesia,2013,Friendly,6,8,2,2,0,4,-2,0
Indonesia,2014,AFC Asian Cup qualification,0,1,0,1,0,1,-1,0
Indonesia,2014,AFF Championship,7,7,1,1,1,3,0,0
Indonesia,2014,Friendly,12,5,5,2,2,9,7,0
Indonesia,2015,Friendly,2,2,1,1,0,2,0,0
Indonesia,2016,AFF Championship,12,13,3,2,2,7,-1,0
Indonesia,2016,Friendly,7,5,1,1,2,4,2,0
Indonesia,2017,Friendly,12,7,4,2,2,8,5,0
Indonesia,2018,AFF Championship,5,6,1,2,1,4,-1,0
Indonesia,2018,Friendly,6,11,2,2,1,5,-5,0
Indonesia,2019,FIFA World Cup qualification,3,16,0,5,0,5,-13,0
Indonesia,2019,Friendly,9,4,2,1,0,3,5,0
Indonesia,2021,AFC Asian Cup qualification,5,1,2,0,0,2,4,0
Indonesia,2021,AFF Championship,18,11,4,1,2,7,7,0
Indonesia,2021,FIFA World Cup qualification,2,11,0,2,1,3,-9,0
Indonesia,2021,Friendly,7,8,1,3,0,4,-1,0
Indonesia,2022,AFC Asian Cup qualification,9,2,2,1,0,3,7,0
Indonesia,2022,AFF Championship,12,4,2,0,2,4,8,0
Indonesia,2022,Friendly,12,4,4,0,1,5,8,0
Indonesia,2023,AFF Championship,2,3,1,1,1,3,-1,0
Indonesia,2023,FIFA World Cup qualification,14,6,2,1,1,4,8,0
Indonesia,2023,Friendly,7,5,2,1,2,5,2,0
Indonesia,2024,AFC Asian Cup,3,10,1,3,0,4,-7,0
Indonesia,2024,ASEAN Championship,4,5,1,2,1,4,-1,0
Indonesia,2024,FIFA World Cup qualification,12,11,4,3,3,10,1,0
Indonesia,2024,Friendly,1,11,0,3,1,4,-10,0
Indonesia,2025,FIFA World Cup qualification,2,5,1,1,0,2,-3,0
Iran,1941,Friendly,1,0,1,0,0,1,1,0
Iran,1947,Friendly,1,3,0,1,0,1,-2,0
Iran,1948,Friendly,1,1,0,0,1,1,0,0
Iran,1950,Friendly,5,6,1,1,0,2,-1,0
Iran,1951,Asian Games,5,3,2,1,1,4,2,0
Iran,1958,Asian Games,0,9,0,2,0,2,-9,0
Iran,1959,AFC Asian Cup qualification,4,1,1,0,1,2,3,0
Iran,1965,Friendly,7,4,2,1,1,4,3,0
Iran,1966,Asian Games,9,6,4,3,0,7,3,0
Iran,1966,Friendly,0,0,0,0,1,1,0,0
Iran,1967,Friendly,0,1,0,1,0,1,-1,0
Iran,1968,AFC Asian Cup,11,2,4,0,0,4,9,1
Iran,1969,Friendly,15,8,3,1,0,4,7,0
Iran,1970,Asian Games,2,3,0,1,1,2,-1,0
Iran,1970,Friendly,9,3,1,1,1,3,6,0
Iran,1971,Friendly,2,2,1,1,0,2,0,0
Iran,1972,AFC Asian Cup,12,4,5,0,0,5,8,1
Iran,1972,Brazil Independence Cup,3,8,0,3,1,4,-5,0
Iran,1973,FIFA World Cup qualification,9,6,5,2,1,8,3,0
Iran,1973,Friendly,0,0,0,0,1,1,0,0
Iran,1974,Asian Games,20,1,7,0,0,7,19,1
Iran,1974,Friendly,2,3,1,2,0,3,-1,0
Iran,1975,Friendly,1,2,0,1,0,1,-1,0
Iran,1976,AFC Asian Cup,13,0,4,0,0,4,13,1
Iran,1976,Friendly,2,2,0,0,1,1,0,0
Iran,1977,Beijing International Friendship Tournament,2,5,0,2,1,3,-3,0
Iran,1977,FIFA World Cup qualification,18,3,9,0,2,11,15,0
Iran,1977,Friendly,0,2,0,1,1,2,-2,0
Iran,1977,Real Madrid 75th Anniversary Cup,1,1,0,0,1,1,0,0
Iran,1978,FIFA World Cup,2,8,0,2,1,3,-6,0
Iran,1978,Friendly,5,5,1,3,2,6,0,0
Iran,1980,AFC Asian Cup,16,6,3,1,2,6,10,0
Iran,1980,Friendly,5,0,2,0,0,2,5,0
Iran,1982,Asian Games,3,2,2,2,0,4,1,0
Iran,1982,Friendly,2,0,1,0,0,1,2,0
Iran,1984,AFC Asian Cup,8,3,2,0,4,6,5,0
Iran,1984,AFC Asian Cup qualification,21,2,5,0,0,5,19,0
Iran,1984,Friendly,1,0,1,0,0,1,1,0
Iran,1985,Friendly,1,0,1,0,0,1,1,0
Iran,1985,Nehru Cup,1,5,0,2,0,2,-4,0
Iran,1986,Asian Games,13,2,3,1,1,5,11,0
Iran,1986,Friendly,9,2,3,1,0,4,7,0
Iran,1988,AFC Asian Cup,3,4,2,2,2,6,-1,0
Iran,1988,AFC Asian Cup qualification,6,1,2,0,2,4,5,0
Iran,1989,FIFA World Cup qualification,12,5,5,1,0,6,7,0
Iran,1989,Friendly,7,6,1,1,4,6,1,0
Iran,1990,Asian Games,7,1,4,0,1,5,6,0
Iran,1990,Friendly,0,3,0,2,0,2,-3,0
Iran,1991,Friendly,0,1,0,1,0,1,-1,0
Iran,1992,AFC Asian Cup,2,1,1,1,1,3,1,0
Iran,1992,AFC Asian Cup qualification,10,0,2,0,0,2,10,0
Iran,1992,Friendly,2,2,0,0,3,3,0,0
Iran,1993,FIFA World Cup qualification,23,13,5,3,3,11,10,0
Iran,1993,Friendly,10,2,4,0,0,4,8,0
Iran,1994,Asian Games,5,2,1,1,2,4,3,0
Iran,1996,AFC Asian Cup,14,6,3,1,2,6,8,0
Iran,1996,AFC Asian Cup qualification,27,1,6,0,0,6,26,0
Iran,1996,Friendly,6,2,4,1,2,7,4,0
Iran,1997,FIFA World Cup qualification,57,17,8,3,6,17,40,0
Iran,1997,Friendly,7,3,3,1,1,5,4,0
Iran,1998,Asian Games,24,6,7,1,0,8,18,1
Iran,1998,FIFA World Cup,2,4,1,2,0,3,-2,0
Iran,1998,Friendly,2,8,1,3,1,5,-6,0
Iran,1998,Lunar New Year Cup,1,2,0,1,1,2,-1,0
Iran,1999,Friendly,7,5,2,0,4,6,2,0
Iran,2000,AFC Asian Cup,7,3,2,1,1,4,4,0
Iran,2000,AFC Asian Cup qualification,16,2,4,1,1,6,14,1
Iran,2000,FIFA World Cup qualification,21,0,2,0,0,2,21,1
Iran,2000,Friendly,12,13,3,2,4,9,-1,0
Iran,2000,WAFF Championship,7,1,4,0,1,5,6,1
Iran,2001,Cup of Ancient Civilizations,4,0,1,0,0,1,4,1
Iran,2001,FIFA World Cup qualification,15,9,7,2,3,12,6,0
Iran,2001,Friendly,16,11,3,3,1,7,5,0
Iran,2002,Friendly,9,6,3,1,2,6,3,0
Iran,2002,WAFF Championship,4,3,1,1,2,4,1,0
Iran,2003,AFC Asian Cup qualification,16,5,5,1,0,6,11,0
Iran,2003,Friendly,4,3,1,2,0,3,1,0
Iran,2003,Lunar New Year Cup,1,1,0,0,1,1,0,0
Iran,2004,AFC Asian Cup,14,8,3,0,3,6,6,0
Iran,2004,FIFA World Cup qualification,22,4,5,1,0,6,18,0
Iran,2004,Friendly,1,2,1,1,0,2,-1,0
Iran,2004,WAFF Championship,17,3,4,0,0,4,14,0
Iran,2005,FIFA World Cup qualification,7,3,4,1,1,6,4,0
Iran,2005,Friendly,10,4,4,1,0,5,6,0
Iran,2006,AFC Asian Cup qualification,8,2,2,0,2,4,6,1
Iran,2006,FIFA World Cup,2,6,0,2,1,3,-4,0
Iran,2006,Friendly,13,6,4,0,2,6,7,0
Iran,2007,AFC Asian Cup,6,3,2,0,2,4,3,0
Iran,2007,Friendly,11,7,2,1,1,4,4,0
Iran,2007,WAFF Championship,5,1,3,0,1,4,4,1
Iran,2008,FIFA World Cup qualification,11,5,4,0,5,9,6,0
Iran,2008,Friendly,9,7,4,3,2,9,2,0
Iran,2008,WAFF Championship,13,2,4,0,0,4,11,1
Iran,2009,AFC Asian Cup qualification,7,1,2,1,1,4,6,0
Iran,2009,FIFA World Cup qualification,4,4,1,1,3,5,0,0
Iran,2009,Friendly,17,16,5,4,4,13,1,0
Iran,2010,AFC Asian Cup qualification,4,1,2,0,0,2,3,0
Iran,2010,Friendly,7,4,4,1,0,5,3,0
Iran,2010,WAFF Championship,8,5,2,1,1,4,3,0
Iran,2011,AFC Asian Cup,6,2,3,1,0,4,4,0
Iran,2011,FIFA World Cup qualification,20,3,5,0,2,7,17,0
Iran,2011,Friendly,10,0,4,0,0,4,10,0
Iran,2012,FIFA World Cup qualification,4,4,2,2,2,6,0,0
Iran,2012,Friendly,15,6,3,1,3,7,9,0
Iran,2012,WAFF Championship,2,1,1,0,2,3,1,0
Iran,2013,AFC Asian Cup qualification,15,3,4,0,1,5,12,0
Iran,2013,FIFA World Cup qualification,6,0,3,0,0,3,6,0
Iran,2013,Friendly,1,3,0,1,0,1,-2,0
Iran,2014,AFC Asian Cup qualification,3,2,1,0,0,1,1,0
Iran,2014,FIFA World Cup,1,4,0,2,1,3,-3,0
Iran,2014,Friendly,5,3,2,1,3,6,2,0
Iran,2015,AFC Asian Cup,7,3,3,0,1,4,4,0
Iran,2015,FIFA World Cup qualification,20,3,4,0,2,6,17,0
Iran,2015,Friendly,6,4,3,1,1,5,2,0
Iran,2016,FIFA World Cup qualification,10,0,5,0,2,7,10,0
Iran,2016,Friendly,17,2,3,0,0,3,15,0
Iran,2017,FIFA World Cup qualification,6,2,3,0,2,5,4,0
Iran,2017,Friendly,8,4,4,1,1,6,4,0
Iran,2018,FIFA World Cup,2,2,1,1,1,3,0,0
Iran,2018,Friendly,17,8,8,2,2,12,9,1
Iran,2019,AFC Asian Cup,12,3,4,1,1,6,9,0
Iran,2019,FIFA World Cup qualification,17,3,2,2,0,4,14,0
Iran,2019,Friendly,6,1,1,0,1,2,5,0
Iran,2020,Friendly,4,1,2,0,0,2,3,0
Iran,2021,FIFA World Cup qualification,28,3,9,0,1,10,25,0
Iran,2021,Friendly,3,0,1,0,0,1,3,0
Iran,2022,FIFA World Cup,4,7,1,2,0,3,-3,0
Iran,2022,FIFA World Cup qualification,4,2,3,1,0,4,2,0
Iran,2022,Friendly,4,5,2,2,1,5,-1,0
Iran,2023,CAFA Nations Cup,12,2,3,0,0,3,10,0
Iran,2023,FIFA World Cup qualification,6,2,1,0,1,2,4,0
Iran,2023,Friendly,8,2,3,0,1,4,6,0
Iran,2024,AFC Asian Cup,12,7,4,1,1,6,5,0
Iran,2024,FIFA World Cup qualification,22,7,8,0,2,10,15,0
Iran,2024,Friendly,7,1,2,0,0,2,6,0
Iran,2025,FIFA World Cup qualification,4,2,1,0,1,2,2,0
Iraq,1960,Friendly,4,4,1,1,0,2,0,1
Iraq,1964,Arab Cup,3,1,2,0,1,3,2,0
Iraq,1965,Friendly,0,0,0,0,1,1,0,0
Iraq,1966,Arab Cup,20,5,5,0,1,6,15,1
Iraq,1966,Friendly,3,3,1,2,0,3,0,0
Iraq,1967,Friendly,4,3,1,0,2,3,1,0
Iraq,1969,Friendly,4,6,0,2,2,4,-2,0
Iraq,1970,Friendly,0,7,0,2,0,2,-7,0
Iraq,1971,AFC Asian Cup qualification,14,2,5,0,1,6,12,0
Iraq,1971,Friendly,5,1,2,0,0,2,4,0
Iraq,1972,AFC Asian Cup,1,4,0,1,2,3,-3,0
Iraq,1972,Palestine Cup,10,5,3,1,1,5,5,0
Iraq,1973,FIFA World Cup qualification,11,6,3,1,2,6,5,0
Iraq,1973,Palestine Cup,5,3,2,1,3,6,2,0
Iraq,1974,Asian Games,6,2,3,1,2,6,4,0
Iraq,1974,Friendly,5,5,1,3,2,6,0,0
Iraq,1975,AFC Asian Cup qualification,14,3,5,0,1,6,11,0
Iraq,1975,Friendly,3,1,1,0,1,2,2,0
Iraq,1975,Palestine Cup,10,2,2,1,1,4,8,0
Iraq,1976,AFC Asian Cup,3,6,1,3,0,4,-3,0
Iraq,1976,Friendly,5,2,2,0,3,5,3,0
Iraq,1976,Gulf Cup,23,8,4,1,2,7,15,0
Iraq,1977,Friendly,4,1,1,0,2,3,3,0
Iraq,1977,Merdeka Tournament,9,2,2,1,3,6,7,0
Iraq,1978,Asian Games,11,4,4,2,1,7,7,0
Iraq,1978,Friendly,6,1,3,0,2,5,5,0
Iraq,1978,Merdeka Tournament,12,6,5,2,1,8,6,0
Iraq,1979,Friendly,6,2,3,0,1,4,4,0
Iraq,1979,Gulf Cup,23,1,6,0,0,6,22,0
Iraq,1980,Friendly,2,4,1,1,1,3,-2,0
Iraq,1981,FIFA World Cup qualification,5,2,3,1,0,4,3,0
Iraq,1981,Friendly,11,3,3,0,2,5,8,0
Iraq,1981,Merdeka Tournament,14,2,3,0,1,4,12,1
Iraq,1982,Asian Games,11,2,5,1,0,6,9,1
Iraq,1982,Friendly,4,1,1,0,2,3,3,0
Iraq,1983,Friendly,2,1,1,0,0,1,1,0
Iraq,1984,Friendly,2,1,1,0,1,2,1,0
Iraq,1984,Gulf Cup,12,5,4,1,2,7,7,0
Iraq,1985,Arab Cup,7,3,3,0,1,4,4,0
Iraq,1985,FIFA World Cup qualification,14,11,5,2,1,8,3,0
Iraq,1985,Korea Cup,6,3,1,1,0,2,3,0
Iraq,1986,Asian Games,13,5,3,1,1,5,8,0
Iraq,1986,FIFA World Cup,1,4,0,3,0,3,-3,0
Iraq,1986,Friendly,1,1,0,0,1,1,0,0
Iraq,1986,Gulf Cup,8,9,1,2,3,6,-1,0
Iraq,1987,Friendly,5,4,2,1,0,3,1,0
Iraq,1988,Arab Cup,5,2,1,0,4,5,3,0
Iraq,1988,Friendly,2,0,1,0,0,1,2,0
Iraq,1988,Gulf Cup,8,1,4,0,2,6,7,0
Iraq,1989,FIFA World Cup qualification,11,5,3,1,2,6,6,0
Iraq,1989,Friendly,10,5,3,1,2,6,5,0
Iraq,1990,Friendly,2,0,1,0,1,2,2,0
Iraq,1992,Jordan International Tournament,17,2,3,1,0,4,15,0
Iraq,1993,FIFA World Cup qualification,37,13,7,2,4,13,24,0
Iraq,1993,Friendly,3,3,0,0,2,2,0,0
Iraq,1995,Merdeka Tournament,2,1,1,0,0,1,1,1
Iraq,1995,Nehru Cup,7,3,2,0,1,3,4,0
Iraq,1996,AFC Asian Cup,6,4,2,2,0,4,2,0
Iraq,1996,AFC Asian Cup qualification,4,0,2,0,0,2,4,1
Iraq,1996,Friendly,4,0,1,0,0,1,4,0
Iraq,1997,FIFA World Cup qualification,14,8,2,2,0,4,6,0
Iraq,1997,Friendly,3,0,2,0,0,2,3,0
Iraq,1997,Nehru Cup,4,1,2,0,1,3,3,0
Iraq,1999,AFC Asian Cup qualification,9,2,3,0,0,3,7,0
Iraq,1999,Friendly,2,1,1,0,1,2,1,0
Iraq,1999,United Arab Emirates Friendship Tournament,6,3,1,0,2,3,3,0
Iraq,2000,AFC Asian Cup,5,7,1,2,1,4,-2,0
Iraq,2000,Friendly,7,7,3,2,1,6,0,0
Iraq,2000,WAFF Championship,10,2,3,0,2,5,8,0
Iraq,2001,FIFA World Cup qualification,37,15,6,5,3,14,22,0
Iraq,2001,Friendly,3,6,0,2,3,5,-3,0
Iraq,2002,Friendly,12,6,4,1,1,6,6,0
Iraq,2002,WAFF Championship,6,2,3,0,1,4,4,1
Iraq,2003,AFC Asian Cup qualification,16,4,4,1,1,6,12,0
Iraq,2003,Friendly,4,7,1,2,1,4,-3,0
Iraq,2003,Prime Minister's Cup,4,4,1,1,1,3,0,0
Iraq,2004,AFC Asian Cup,5,7,2,2,0,4,-2,0
Iraq,2004,FIFA World Cup qualification,17,7,3,1,2,6,10,0
Iraq,2004,Friendly,3,6,1,3,0,4,-3,0
Iraq,2004,Gulf Cup,5,7,0,1,2,3,-2,0
Iraq,2004,WAFF Championship,4,8,1,3,0,4,-4,0
Iraq,2005,Friendly,18,9,4,2,4,10,9,0
Iraq,2006,AFC Asian Cup qualification,12,8,3,1,2,6,4,0
Iraq,2006,Friendly,12,13,3,4,1,8,-1,0
Iraq,2007,AFC Asian Cup,7,2,3,0,3,6,5,1
Iraq,2007,FIFA World Cup qualification,7,0,1,0,1,2,7,0
Iraq,2007,Friendly,3,9,0,3,2,5,-6,0
Iraq,2007,Gulf Cup,2,2,1,1,1,3,0,0
Iraq,2007,WAFF Championship,5,2,2,1,1,4,3,0
Iraq,2008,FIFA World Cup qualification,4,6,2,3,1,6,-2,0
Iraq,2008,Friendly,6,7,1,2,3,6,-1,0
Iraq,2009,Confederations Cup,0,1,0,1,2,3,-1,0
Iraq,2009,Friendly,11,4,4,2,2,8,7,0
Iraq,2009,Gulf Cup,2,8,0,2,1,3,-6,0
Iraq,2010,Friendly,11,9,5,2,1,8,2,0
Iraq,2010,Gulf Cup,5,4,1,0,3,4,1,0
Iraq,2010,WAFF Championship,6,3,2,1,0,3,3,0
Iraq,2011,AFC Asian Cup,3,3,2,2,0,4,0,0
Iraq,2011,FIFA World Cup qualification,9,3,5,1,1,7,6,0
Iraq,2011,Friendly,6,11,2,5,1,8,-5,0
Iraq,2012,Arab Cup,3,1,2,0,1,3,2,1
Iraq,2012,FIFA World Cup qualification,11,6,2,2,2,6,5,1
Iraq,2012,Friendly,3,10,1,3,2,6,-7,0
Iraq,2012,WAFF Championship,4,2,2,1,1,4,2,0
Iraq,2013,AFC Asian Cup qualification,4,5,2,3,0,5,-1,1
Iraq,2013,FIFA World Cup qualification,0,3,0,3,0,3,-3,0
Iraq,2013,Friendly,6,11,2,2,1,5,-5,0
Iraq,2013,Gulf Cup,7,3,3,1,1,5,4,0
Iraq,2013,WAFF Championship,0,0,0,0,2,2,0,0
Iraq,2014,AFC Asian Cup qualification,3,1,1,0,0,1,2,1
Iraq,2014,Friendly,4,5,1,2,4,7,-1,0
Iraq,2014,Gulf Cup,1,4,0,2,1,3,-3,0
Iraq,2015,AFC Asian Cup,8,9,2,3,1,6,-1,0
Iraq,2015,FIFA World Cup qualification,10,4,2,0,2,4,6,0
Iraq,2015,Friendly,6,7,3,2,0,5,-1,0
Iraq,2015,Kirin Challenge Cup,0,4,0,1,0,1,-4,0
Iraq,2016,FIFA World Cup qualification,9,10,2,4,1,7,-1,0
Iraq,2016,Friendly,3,6,0,3,2,5,-3,0
Iraq,2017,FIFA World Cup qualification,5,4,2,1,2,5,1,0
Iraq,2017,Friendly,6,3,3,0,3,6,3,0
Iraq,2017,Gulf Cup,6,2,2,0,1,3,4,0
Iraq,2018,Friendly,16,13,4,2,5,11,3,0
Iraq,2018,Gulf Cup,0,0,0,0,1,1,0,0
Iraq,2019,AFC Asian Cup,6,3,2,1,1,4,3,0
Iraq,2019,FIFA World Cup qualification,9,2,3,0,2,5,7,0
Iraq,2019,Friendly,0,2,0,1,1,2,-2,0
Iraq,2019,Gulf Cup,6,3,2,0,2,4,3,0
Iraq,2019,WAFF Championship,5,3,3,1,1,5,2,0
Iraq,2020,Friendly,2,1,1,0,1,2,1,0
Iraq,2021,Arab Cup,1,4,0,1,2,3,-3,0
Iraq,2021,FIFA World Cup qualification,8,11,2,3,4,9,-3,0
Iraq,2021,Friendly,9,3,3,0,2,5,6,0
Iraq,2022,FIFA World Cup qualification,3,3,1,1,2,4,0,0
Iraq,2022,Friendly,5,5,3,1,1,5,0,0
Iraq,2022,Jordan International Tournament,2,1,1,0,1,2,1,1
Iraq,2023,FIFA World Cup qualification,6,1,2,0,0,2,5,0
Iraq,2023,Friendly,0,3,0,2,1,3,-3,0
Iraq,2023,Gulf Cup,12,3,4,0,1,5,9,1
Iraq,2023,King's Cup,4,4,0,0,2,2,0,0
Iraq,2024,AFC Asian Cup,10,7,3,1,0,4,3,0
Iraq,2024,FIFA World Cup qualification,16,4,7,1,2,10,12,0
Iraq,2024,Friendly,0,1,0,1,0,1,-1,0
Iraq,2024,Gulf Cup,2,5,1,2,0,3,-3,0
Iraq,2025,FIFA World Cup qualification,3,4,0,1,1,2,-1,0
Iraqi Kurdistan,2008,Viva World Cup,7,7,1,2,2,5,0,0
Iraqi Kurdistan,2009,Viva World Cup,11,4,2,2,0,4,7,0
Iraqi Kurdistan,2010,Viva World Cup,9,5,3,1,0,4,4,0
Iraqi Kurdistan,2012,Viva World Cup,11,2,4,0,0,4,9,0
Iraqi Kurdistan,2014,CONIFA World Football Cup,14,6,1,1,3,5,8,0
Iraqi Kurdistan,2016,CONIFA World Football Cup,9,3,2,0,3,5,6,0
Isle of Man,1993,Island Games,8,7,2,2,0,4,1,0
Isle of Man,1995,Island Games,2,12,0,4,0,4,-10,0
Isle of Man,1999,Island Games,20,6,3,1,1,5,14,0
Isle of Man,2001,Island Games,14,8,1,2,1,4,6,0
Isle of Man,2003,Island Games,9,5,3,1,0,4,4,0
Isle of Man,2005,Island Games,13,6,3,1,1,5,7,0
Isle of Man,2009,Island Games,12,10,3,2,0,5,2,0
Isle of Man,2011,Island Games,13,6,2,1,1,4,7,0
Isle of Man,2015,Island Games,21,5,4,1,0,5,16,0
Isle of Man,2017,Island Games,24,5,5,0,0,5,19,1
Isle of Man,2019,Inter Games Football Tournament,20,5,3,1,0,4,15,0
Isle of Man,2023,Island Games,7,5,2,2,0,4,2,0
Isle of Wight,1991,Island Games,5,8,1,2,1,4,-3,0
Isle of Wight,1993,Island Games,4,3,2,1,1,4,1,0
Isle of Wight,1995,Island Games,9,4,3,1,1,5,5,1
Isle of Wight,1997,Island Games,7,1,2,0,2,4,6,0
Isle of Wight,1999,Island Games,22,8,4,1,0,5,14,0
Isle of Wight,2001,Island Games,6,6,1,2,1,4,0,0
Isle of Wight,2003,Island Games,24,9,2,3,0,5,15,0
Isle of Wight,2009,Island Games,6,10,1,3,0,4,-4,0
Isle of Wight,2011,Island Games,16,4,5,0,0,5,12,0
Isle of Wight,2015,Island Games,7,3,2,1,1,4,4,0
Isle of Wight,2023,Island Games,7,4,3,1,0,4,3,0
Israel,1934,FIFA World Cup qualification,2,11,0,2,0,2,-9,0
Israel,1938,FIFA World Cup qualification,1,4,0,2,0,2,-3,0
Israel,1940,Friendly,5,1,1,0,0,1,4,0
Israel,1948,Friendly,1,3,0,1,0,1,-2,0
Israel,1949,FIFA World Cup qualification,2,11,0,2,0,2,-9,0
Israel,1949,Friendly,3,1,1,0,0,1,2,0
Israel,1950,Friendly,7,4,1,1,0,2,3,0
Israel,1953,FIFA World Cup qualification,0,2,0,2,0,2,-2,0
Israel,1954,FIFA World Cup qualification,0,3,0,2,0,2,-3,0
Israel,1954,Friendly,4,5,1,2,1,4,-1,0
Israel,1956,AFC Asian Cup,6,5,2,1,0,3,1,0
Israel,1958,Asian Games,6,3,2,1,0,3,3,0
Israel,1958,FIFA World Cup qualification,0,4,0,2,0,2,-4,0
Israel,1959,AFC Asian Cup qualification,8,7,2,1,2,5,1,0
Israel,1959,Friendly,3,8,0,1,1,2,-5,0
Israel,1960,AFC Asian Cup,6,4,2,1,0,3,2,1
Israel,1960,FIFA World Cup qualification,7,2,1,0,1,2,5,0
Israel,1961,FIFA World Cup qualification,6,12,2,2,0,4,-6,0
Israel,1961,Friendly,1,3,0,1,1,2,-2,0
Israel,1962,Friendly,1,4,0,2,1,3,-3,0
Israel,1963,Friendly,0,5,0,1,0,1,-5,0
Israel,1964,AFC Asian Cup,5,1,3,0,0,3,4,1
Israel,1964,Friendly,5,1,2,1,0,3,4,0
Israel,1965,FIFA World Cup qualification,1,12,0,4,0,4,-11,0
Israel,1965,Friendly,0,1,0,1,1,2,-1,0
Israel,1966,Friendly,14,11,2,4,1,7,3,0
Israel,1967,Friendly,1,2,0,1,0,1,-1,0
Israel,1968,AFC Asian Cup,11,5,2,2,0,4,6,0
Israel,1968,Friendly,11,12,2,3,1,6,-1,0
Israel,1969,FIFA World Cup qualification,8,1,3,0,1,4,7,0
Israel,1969,Friendly,5,7,0,1,2,3,-2,0
Israel,1970,FIFA World Cup,1,3,0,1,2,3,-2,0
Israel,1970,Friendly,5,2,1,1,0,2,3,0
Israel,1971,Friendly,5,4,1,1,1,3,1,0
Israel,1972,Friendly,2,1,1,0,0,1,1,0
Israel,1973,FIFA World Cup qualification,12,2,4,1,1,6,10,0
Israel,1973,Friendly,7,4,2,1,1,4,3,0
Israel,1974,Asian Games,24,4,6,1,0,7,20,0
Israel,1974,Friendly,2,2,1,1,0,2,0,0
Israel,1975,Friendly,1,0,1,0,0,1,1,0
Israel,1976,Friendly,4,6,1,2,2,5,-2,0
Israel,1977,FIFA World Cup qualification,5,3,2,1,1,4,2,0
Israel,1977,Friendly,6,6,0,0,4,4,0,0
Israel,1978,Friendly,5,3,2,1,1,4,2,0
Israel,1979,Friendly,4,2,1,1,0,2,2,0
Israel,1980,FIFA World Cup qualification,1,4,0,1,3,4,-3,0
Israel,1980,Friendly,0,1,0,1,0,1,-1,0
Israel,1981,FIFA World Cup qualification,5,6,1,3,0,4,-1,0
Israel,1981,Friendly,2,1,1,0,0,1,1,0
Israel,1983,Friendly,3,3,0,0,2,2,0,0
Israel,1984,Friendly,10,7,3,1,4,8,3,0
Israel,1985,FIFA World Cup qualification,17,6,3,2,1,6,11,0
Israel,1985,Friendly,1,3,0,1,2,3,-2,0
Israel,1986,Friendly,3,7,0,3,0,3,-4,0
Israel,1987,Friendly,4,19,0,6,2,8,-15,0
Israel,1988,Friendly,6,12,1,4,2,7,-6,0
Israel,1989,FIFA World Cup qualification,5,5,1,1,4,6,0,0
Israel,1989,Friendly,5,6,1,1,1,3,-1,0
Israel,1990,Friendly,6,10,1,3,0,4,-4,0
Israel,1992,FIFA World Cup qualification,3,10,0,3,0,3,-7,0
Israel,1992,Friendly,9,7,2,1,4,7,2,0
Israel,1993,FIFA World Cup qualification,7,17,1,3,3,7,-10,0
Israel,1993,Friendly,5,6,0,1,4,5,-1,0
Israel,1994,Friendly,8,11,3,2,1,6,-3,0
Israel,1994,UEFA Euro qualification,7,4,2,0,2,4,3,0
Israel,1995,Friendly,11,7,3,2,0,5,4,0
Israel,1995,UEFA Euro qualification,6,9,1,4,1,6,-3,0
Israel,1996,FIFA World Cup qualification,4,4,2,1,1,4,0,0
Israel,1996,Friendly,9,13,1,4,0,5,-4,0
Israel,1997,FIFA World Cup qualification,5,3,2,2,0,4,2,0
Israel,1997,Friendly,5,7,1,3,1,5,-2,0
Israel,1998,Friendly,16,6,6,2,0,8,10,0
Israel,1998,UEFA Euro qualification,7,3,1,1,1,3,4,0
Israel,1999,Friendly,13,3,4,2,0,6,10,0
Israel,1999,UEFA Euro qualification,18,14,3,4,0,7,4,0
Israel,2000,FIFA World Cup qualification,5,3,2,1,0,3,2,0
Israel,2000,Friendly,8,11,1,4,1,6,-3,0
Israel,2001,FIFA World Cup qualification,6,4,1,1,3,5,2,0
Israel,2001,Friendly,8,5,3,1,0,4,3,0
Israel,2002,Friendly,14,14,3,2,0,5,0,0
Israel,2002,UEFA Euro qualification,2,0,1,0,0,1,2,0
Israel,2003,Friendly,4,1,2,0,1,3,3,0
Israel,2003,UEFA Euro qualification,7,11,1,3,3,7,-4,0
Israel,2004,FIFA World Cup qualification,6,4,2,0,2,4,2,0
Israel,2004,Friendly,4,3,2,1,1,4,1,0
Israel,2005,FIFA World Cup qualification,9,6,2,0,4,6,3,0
Israel,2005,Friendly,5,6,0,1,2,3,-1,0
Israel,2006,Friendly,1,3,0,1,1,2,-2,0
Israel,2006,UEFA Euro qualification,9,6,2,1,1,4,3,0
Israel,2007,Friendly,4,4,1,1,1,3,0,0
Israel,2007,UEFA Euro qualification,11,6,5,2,1,8,5,0
Israel,2008,FIFA World Cup qualification,8,5,2,0,2,4,3,0
Israel,2008,Friendly,4,4,2,1,1,4,0,0
Israel,2009,FIFA World Cup qualification,12,5,2,2,2,6,7,0
Israel,2009,Friendly,2,1,1,0,1,2,1,0
Israel,2010,Friendly,6,9,2,2,0,4,-3,0
Israel,2010,UEFA Euro qualification,5,5,1,2,1,4,0,0
Israel,2011,Friendly,3,6,0,2,0,2,-3,0
Israel,2011,UEFA Euro qualification,8,6,4,2,0,6,2,0
Israel,2012,FIFA World Cup qualification,10,5,2,1,1,4,5,0
Israel,2012,Friendly,5,10,0,4,1,5,-5,0
Israel,2013,FIFA World Cup qualification,9,9,1,1,4,6,0,0
Israel,2013,Friendly,4,3,2,1,0,3,1,0
Israel,2014,Friendly,5,5,1,1,0,2,0,0
Israel,2014,UEFA Euro qualification,9,2,3,0,0,3,7,1
Israel,2015,UEFA Euro qualification,7,12,1,5,1,7,-5,0
Israel,2016,FIFA World Cup qualification,8,5,3,1,0,4,3,0
Israel,2016,Friendly,1,5,0,2,0,2,-4,0
Israel,2017,FIFA World Cup qualification,2,10,1,5,0,6,-8,0
Israel,2017,Friendly,1,1,0,0,1,1,0,0
Israel,2018,Friendly,8,5,1,2,0,3,3,0
Israel,2018,UEFA Nations League,6,5,2,2,0,4,1,0
Israel,2019,UEFA Euro qualification,16,18,3,5,2,10,-2,0
Israel,2020,UEFA Euro qualification,0,0,0,0,1,1,0,0
Israel,2020,UEFA Nations League,7,7,2,2,2,6,0,0
Israel,2021,FIFA World Cup qualification,23,21,5,4,1,10,2,0
Israel,2021,Friendly,3,5,1,1,0,2,-2,0
Israel,2022,Friendly,9,11,1,3,1,5,-2,0
Israel,2022,UEFA Nations League,8,6,2,0,2,4,2,0
Israel,2023,UEFA Euro qualification,11,11,4,3,3,10,0,0
Israel,2024,Friendly,4,3,1,1,0,2,1,0
Israel,2024,UEFA Euro qualification,1,4,0,1,0,1,-3,0
Israel,2024,UEFA Nations League,5,13,1,4,1,6,-8,0
Israel,2025,FIFA World Cup qualification,4,5,1,1,0,2,-1,0
Italy,1910,Friendly,7,8,1,1,0,2,-1,0
Italy,1911,Friendly,4,8,0,2,2,4,-4,0
Italy,1912,Friendly,4,7,0,2,0,2,-3,0
Italy,1912,Olympic Games,4,8,1,2,0,3,-4,0
Italy,1913,Friendly,1,3,1,2,0,3,-2,0
Italy,1914,Friendly,4,1,2,0,2,4,3,0
Italy,1915,Friendly,3,1,1,0,0,1,2,0
Italy,1919,Inter-Allied Games,16,3,2,1,0,3,13,0
Italy,1920,Friendly,10,8,1,1,1,3,2,0
Italy,1920,Olympic Games,5,7,2,2,0,4,-2,0
Italy,1921,Friendly,10,7,3,0,2,5,3,0
Italy,1922,Friendly,10,8,1,0,3,4,2,0
Italy,1923,Friendly,4,6,1,1,2,4,-2,0
Italy,1924,Friendly,4,13,1,2,2,5,-9,0
Italy,1924,Olympic Games,4,2,2,1,0,3,2,0
Italy,1925,Friendly,10,4,2,2,1,5,6,0
Italy,1926,Friendly,14,12,3,2,1,6,2,0
Italy,1927,Central European International Cup,2,3,0,1,1,2,-1,0
Italy,1927,Friendly,15,7,3,0,2,5,8,0
Italy,1928,Central European International Cup,10,7,3,0,0,3,3,0
Italy,1928,Friendly,7,9,1,1,2,4,-2,0
Italy,1928,Olympic Games,25,11,3,1,1,5,14,0
Italy,1929,Central European International Cup,4,5,1,1,0,2,-1,0
Italy,1929,Friendly,7,3,1,1,0,2,4,1
Italy,1930,Central European International Cup,5,0,1,0,0,1,5,1
Italy,1930,Friendly,9,6,2,1,1,4,3,0
Italy,1931,Central European International Cup,8,6,2,0,2,4,2,1
Italy,1931,Friendly,10,0,3,0,1,4,10,0
Italy,1932,Central European International Cup,6,5,1,2,1,4,1,0
Italy,1932,Friendly,6,3,2,0,0,2,3,0
Italy,1933,Central European International Cup,11,2,4,0,0,4,9,1
Italy,1933,Friendly,7,4,2,0,1,3,3,0
Italy,1934,Central European International Cup,2,4,0,1,0,1,-2,0
Italy,1934,FIFA World Cup,12,3,4,0,1,5,9,1
Italy,1934,FIFA World Cup qualification,4,0,1,0,0,1,4,0
Italy,1934,Friendly,6,5,1,1,0,2,1,0
Italy,1935,Central European International Cup,5,4,1,1,1,3,1,0
Italy,1935,Friendly,2,1,1,0,0,1,1,0
Italy,1936,Central European International Cup,4,2,1,0,0,1,2,0
Italy,1936,Friendly,10,6,3,0,2,5,4,1
Italy,1937,Central European International Cup,5,2,2,0,1,3,3,0
Italy,1937,Friendly,3,1,1,0,1,2,2,0
Italy,1938,FIFA World Cup,11,5,4,0,0,4,6,1
Italy,1938,Friendly,13,1,4,0,0,4,12,0
Italy,1939,Friendly,17,16,5,2,1,8,1,0
Italy,1940,Friendly,7,5,2,0,2,4,2,0
Italy,1942,Friendly,8,0,2,0,0,2,8,0
Italy,1945,Friendly,4,4,0,0,1,1,0,0
Italy,1946,Friendly,3,2,1,0,0,1,1,1
Italy,1947,Friendly,12,10,3,1,0,4,2,1
Italy,1948,Friendly,3,5,1,1,0,2,-2,0
Italy,1949,Central European International Cup,4,2,1,0,1,2,2,0
Italy,1949,Friendly,7,4,2,1,0,3,3,0
Italy,1950,Central European International Cup,0,1,0,1,0,1,-1,0
Italy,1950,FIFA World Cup,4,3,1,1,0,2,1,0
Italy,1950,Friendly,3,1,1,0,0,1,2,0
Italy,1951,Central European International Cup,1,1,0,0,1,1,0,0
Italy,1951,Friendly,9,3,2,0,2,4,6,0
Italy,1952,Central European International Cup,2,0,1,0,0,1,2,1
Italy,1952,Friendly,2,4,0,1,2,3,-2,0
Italy,1953,Central European International Cup,3,5,1,2,0,3,-2,1
Italy,1953,FIFA World Cup qualification,2,1,1,0,0,1,1,0
Italy,1954,FIFA World Cup,6,7,1,2,0,3,-1,0
Italy,1954,FIFA World Cup qualification,5,1,1,0,0,1,4,0
Italy,1954,Friendly,5,1,2,0,0,2,4,0
Italy,1955,Central European International Cup,0,6,0,2,0,2,-6,0
Italy,1955,Friendly,5,2,3,0,0,3,3,0
Italy,1956,Central European International Cup,3,2,1,0,1,2,1,1
Italy,1956,Friendly,5,3,2,2,0,4,2,0
Italy,1957,Central European International Cup,1,6,0,1,0,1,-5,0
Italy,1957,FIFA World Cup qualification,4,3,2,1,0,3,1,1
Italy,1957,Friendly,2,2,0,0,1,1,0,0
Italy,1958,Central European International Cup,3,4,0,1,1,2,-1,0
Italy,1958,FIFA World Cup qualification,1,2,0,1,0,1,-1,0
Italy,1958,Friendly,2,2,0,0,1,1,0,0
Italy,1959,Central European International Cup,2,3,0,1,1,2,-1,0
Italy,1959,Friendly,3,3,0,0,2,2,0,0
Italy,1960,Central European International Cup,3,0,1,0,0,1,3,1
Italy,1960,Friendly,2,5,0,2,0,2,-3,0
Italy,1961,FIFA World Cup qualification,10,2,2,0,0,2,8,0
Italy,1961,Friendly,9,6,2,1,0,3,3,0
Italy,1962,FIFA World Cup,3,2,1,1,1,3,1,0
Italy,1962,Friendly,7,3,3,0,0,3,4,0
Italy,1962,UEFA Euro qualification,6,0,1,0,0,1,6,0
Italy,1963,Friendly,5,0,3,0,0,3,5,0
Italy,1963,UEFA Euro qualification,2,3,1,1,1,3,-1,0
Italy,1964,FIFA World Cup qualification,6,1,1,0,0,1,5,0
Italy,1964,Friendly,6,2,2,0,1,3,4,0
Italy,1965,FIFA World Cup qualification,11,2,3,1,1,5,9,0
Italy,1965,Friendly,8,6,1,1,2,4,2,0
Italy,1966,FIFA World Cup,2,2,1,2,0,3,0,0
Italy,1966,Friendly,16,1,5,0,1,6,15,0
Italy,1966,UEFA Euro qualification,3,1,1,0,0,1,2,0
Italy,1967,Friendly,1,1,0,0,1,1,0,0
Italy,1967,UEFA Euro qualification,14,2,4,0,1,5,12,1
Italy,1968,FIFA World Cup qualification,1,0,1,0,0,1,1,0
Italy,1968,UEFA Euro,3,1,1,0,2,3,2,1
Italy,1968,UEFA Euro qualification,4,3,1,1,0,2,1,0
Italy,1969,FIFA World Cup qualification,9,3,2,0,1,3,6,0
Italy,1969,Friendly,4,3,1,0,2,3,1,0
Italy,1970,FIFA World Cup,10,8,3,1,2,6,2,0
Italy,1970,Friendly,5,4,1,0,2,3,1,0
Italy,1970,UEFA Euro qualification,5,1,2,0,0,2,4,0
Italy,1971,Friendly,3,2,1,1,0,2,1,0
Italy,1971,UEFA Euro qualification,7,3,2,0,2,4,4,0
Italy,1972,FIFA World Cup qualification,4,0,1,0,1,2,4,0
Italy,1972,Friendly,8,7,1,1,2,4,1,0
Italy,1972,UEFA Euro qualification,1,2,0,1,1,2,-1,0
Italy,1973,FIFA World Cup qualification,8,0,3,0,1,4,8,0
Italy,1973,Friendly,7,0,4,0,0,4,7,0
Italy,1974,FIFA World Cup,5,4,1,1,1,3,1,0
Italy,1974,Friendly,0,1,0,1,3,4,-1,0
Italy,1974,UEFA Euro qualification,1,3,0,1,0,1,-2,0
Italy,1975,Friendly,17,4,3,1,0,4,13,1
Italy,1975,UEFA Euro qualification,2,0,2,0,3,5,2,0
Italy,1976,FIFA World Cup qualification,6,1,2,0,0,2,5,0
Italy,1976,Friendly,15,12,4,3,0,7,3,0
Italy,1977,FIFA World Cup qualification,12,3,3,1,0,4,9,0
Italy,1977,Friendly,4,3,2,1,0,3,1,0
Italy,1978,FIFA World Cup,9,6,4,2,1,7,3,0
Italy,1978,Friendly,6,7,3,2,2,7,-1,1
Italy,1979,Friendly,9,6,3,1,1,5,3,0
Italy,1980,FIFA World Cup qualification,8,0,4,0,0,4,8,0
Italy,1980,Friendly,8,4,3,0,1,4,4,0
Italy,1980,UEFA Euro,2,1,1,0,3,4,1,0
Italy,1981,FIFA World Cup qualification,4,5,1,1,2,4,-1,0
Italy,1981,Friendly,3,2,1,0,1,2,1,0
Italy,1981,Mundialito,1,3,0,1,1,2,-2,0
Italy,1982,FIFA World Cup,12,6,4,0,3,7,6,1
Italy,1982,Friendly,1,5,0,3,1,4,-4,0
Italy,1982,UEFA Euro qualification,2,2,0,0,2,2,0,0
Italy,1983,Friendly,3,0,1,0,0,1,3,0
Italy,1983,UEFA Euro qualification,4,10,1,4,1,6,-6,1
Italy,1984,Friendly,14,4,5,1,3,9,10,0
Italy,1985,Friendly,8,6,3,2,2,7,2,0
Italy,1986,FIFA World Cup,5,6,1,1,2,4,-1,0
Italy,1986,Friendly,7,3,3,1,0,4,4,0
Italy,1986,UEFA Euro qualification,5,2,2,0,0,2,3,0
Italy,1987,Friendly,4,1,2,0,2,4,3,0
Italy,1987,UEFA Euro qualification,11,2,4,1,1,6,9,0
Italy,1988,Friendly,13,4,5,1,1,7,9,0
Italy,1988,UEFA Euro,4,3,2,1,1,4,1,0
Italy,1989,Friendly,12,3,5,2,3,10,9,0
Italy,1990,FIFA World Cup,10,2,6,0,1,7,8,0
Italy,1990,Friendly,2,0,2,0,2,4,2,0
Italy,1990,UEFA Euro qualification,5,1,1,0,2,3,4,1
Italy,1991,Friendly,1,2,0,1,1,2,-1,0
Italy,1991,Scania 100 Tournament,3,1,1,0,1,2,2,0
Italy,1991,UEFA Euro qualification,7,4,2,1,2,5,3,0
Italy,1992,FIFA World Cup qualification,4,3,1,0,2,3,1,0
Italy,1992,Friendly,8,2,3,0,0,3,6,0
Italy,1992,USA Cup,3,1,1,0,2,3,2,0
Italy,1993,FIFA World Cup qualification,18,4,6,1,0,7,14,0
Italy,1993,Friendly,2,0,1,0,0,1,2,0
Italy,1994,FIFA World Cup,8,5,4,1,2,7,3,0
Italy,1994,Friendly,8,4,4,2,0,6,4,0
Italy,1994,UEFA Euro qualification,4,3,1,1,1,3,1,0
Italy,1995,Friendly,1,2,1,1,0,2,-1,0
Italy,1995,UEFA Euro qualification,16,3,6,0,1,7,13,0
Italy,1996,FIFA World Cup qualification,4,1,2,0,0,2,3,0
Italy,1996,Friendly,5,4,1,1,1,3,1,0
Italy,1996,UEFA Euro,3,3,1,1,1,3,0,0
Italy,1997,FIFA World Cup qualification,9,1,4,0,4,8,8,0
Italy,1997,Friendly,2,0,1,0,0,1,2,0
Italy,1997,Tournoi de France,5,7,0,1,2,3,-2,0
Italy,1998,FIFA World Cup,8,3,3,0,2,5,5,0
Italy,1998,Friendly,8,4,2,1,1,4,4,0
Italy,1998,UEFA Euro qualification,4,0,2,0,0,2,4,0
Italy,1999,Friendly,1,3,0,1,2,3,-2,0
Italy,1999,UEFA Euro qualification,9,5,2,1,3,6,4,0
Italy,2000,FIFA World Cup qualification,7,2,2,0,1,3,5,0
Italy,2000,Friendly,4,3,3,2,0,5,1,0
Italy,2000,UEFA Euro,9,4,4,1,1,6,5,0
Italy,2001,FIFA World Cup qualification,9,1,4,0,1,5,8,0
Italy,2001,Friendly,4,3,2,1,1,4,1,0
Italy,2002,FIFA World Cup,5,5,1,2,1,4,0,0
Italy,2002,Friendly,5,5,2,2,2,6,0,0
Italy,2002,UEFA Euro qualification,4,3,1,1,1,3,1,0
Italy,2003,Friendly,8,4,5,1,0,6,4,0
Italy,2003,UEFA Euro qualification,13,1,4,0,1,5,12,0
Italy,2004,FIFA World Cup qualification,7,5,3,1,0,4,2,0
Italy,2004,Friendly,10,6,3,1,2,6,4,0
Italy,2004,UEFA Euro,3,2,1,0,2,3,1,0
Italy,2005,FIFA World Cup qualification,10,3,4,0,2,6,7,0
Italy,2005,Friendly,10,5,3,0,4,7,5,0
Italy,2006,FIFA World Cup,12,2,5,0,2,7,10,0
Italy,2006,Friendly,6,5,1,1,3,5,1,0
Italy,2006,UEFA Euro qualification,7,5,2,1,1,4,2,0
Italy,2007,Friendly,3,3,1,1,0,2,0,0
Italy,2007,UEFA Euro qualification,15,4,7,0,1,8,11,0
Italy,2008,FIFA World Cup qualification,6,2,3,0,1,4,4,0
Italy,2008,Friendly,9,6,2,1,2,5,3,0
Italy,2008,UEFA Euro,3,4,1,1,2,4,-1,0
Italy,2009,Confederations Cup,3,5,1,2,0,3,-2,0
Italy,2009,FIFA World Cup qualification,12,5,4,0,2,6,7,0
Italy,2009,Friendly,8,5,3,1,2,6,3,0
Italy,2010,FIFA World Cup,4,5,0,1,2,3,-1,0
Italy,2010,Friendly,3,5,0,2,3,5,-2,0
Italy,2010,UEFA Euro qualification,10,1,3,0,1,4,9,0
Italy,2011,Friendly,7,5,3,2,1,6,2,0
Italy,2011,UEFA Euro qualification,10,1,5,0,1,6,9,0
Italy,2012,FIFA World Cup qualification,10,4,3,0,1,4,6,0
Italy,2012,Friendly,2,8,0,4,0,4,-6,0
Italy,2012,UEFA Euro,6,7,2,1,3,6,-1,0
Italy,2013,Confederations Cup,10,10,2,1,2,5,0,0
Italy,2013,FIFA World Cup qualification,9,5,3,0,3,6,4,0
Italy,2013,Friendly,13,10,1,1,5,7,3,0
Italy,2014,FIFA World Cup,2,3,1,2,0,3,-1,0
Italy,2014,Friendly,4,2,2,1,2,5,2,0
Italy,2014,UEFA Euro qualification,6,2,3,0,1,4,4,0
Italy,2015,Friendly,4,7,0,2,2,4,-3,0
Italy,2015,UEFA Euro qualification,10,5,4,0,2,6,5,0
Italy,2016,FIFA World Cup qualification,11,4,3,0,1,4,7,0
Italy,2016,Friendly,6,8,2,2,2,6,-2,0
Italy,2016,UEFA Euro,6,2,3,1,1,5,4,0
Italy,2017,FIFA World Cup qualification,10,5,4,2,2,8,5,0
Italy,2017,Friendly,13,1,3,0,0,3,12,0
Italy,2018,Friendly,7,9,2,2,3,7,-2,0
Italy,2018,UEFA Nations League,2,2,1,1,2,4,0,0
Italy,2019,UEFA Euro qualification,37,4,10,0,0,10,33,0
Italy,2020,Friendly,10,0,2,0,0,2,10,0
Italy,2020,UEFA Nations League,7,2,3,0,3,6,5,1
Italy,2021,FIFA World Cup qualification,13,2,4,0,4,8,11,0
Italy,2021,Friendly,11,0,2,0,0,2,11,0
Italy,2021,UEFA Euro,13,4,5,0,2,7,9,0
Italy,2021,UEFA Nations League,3,3,1,1,0,2,0,0
Italy,2022,CONMEBOL–UEFA Cup of Champions,0,3,0,1,0,1,-3,0
Italy,2022,FIFA World Cup qualification,0,1,0,1,0,1,-1,0
Italy,2022,Friendly,6,5,2,1,0,3,1,0
Italy,2022,UEFA Nations League,8,7,3,1,2,6,1,0
Italy,2023,UEFA Euro qualification,16,9,4,2,2,8,7,0
Italy,2023,UEFA Nations League,4,4,1,1,0,2,0,1
Italy,2024,Friendly,5,1,3,0,1,4,4,0
Italy,2024,UEFA Euro,3,5,1,2,1,4,-2,0
Italy,2024,UEFA Nations League,13,8,4,1,1,6,5,0
Italy,2025,UEFA Nations League,4,5,0,1,1,2,-1,0
Ivory Coast,1960,African Friendship Games,5,5,1,1,0,2,0,0
Ivory Coast,1960,Friendly,5,5,1,1,0,2,0,0
Ivory Coast,1961,African Friendship Games,9,2,3,0,1,4,7,0
Ivory Coast,1962,Friendly,3,5,1,1,1,3,-2,0
Ivory Coast,1963,African Friendship Games,6,6,2,2,0,4,0,0
Ivory Coast,1963,Friendly,3,0,1,0,0,1,3,0
Ivory Coast,1964,Friendly,1,1,0,0,1,1,0,0
Ivory Coast,1965,African Cup of Nations,5,4,2,1,0,3,1,1
Ivory Coast,1965,African Cup of Nations qualification,9,4,3,1,0,4,5,1
Ivory Coast,1965,All-African Games,9,2,3,1,1,5,7,0
Ivory Coast,1965,Friendly,2,3,1,1,0,2,-1,0
Ivory Coast,1966,Friendly,3,2,1,0,1,2,1,0
Ivory Coast,1967,African Cup of Nations qualification,7,0,3,0,1,4,7,0
Ivory Coast,1967,Friendly,8,6,1,1,2,4,2,0
Ivory Coast,1968,African Cup of Nations,9,6,3,2,0,5,3,1
Ivory Coast,1968,Friendly,1,2,0,1,0,1,-1,0
Ivory Coast,1969,African Cup of Nations qualification,4,0,1,0,1,2,4,1
Ivory Coast,1969,Friendly,2,1,1,0,1,2,1,0
Ivory Coast,1970,African Cup of Nations,11,9,2,3,0,5,2,0
Ivory Coast,1970,African Cup of Nations qualification,3,1,2,0,0,2,2,0
Ivory Coast,1970,Friendly,6,11,1,3,1,5,-5,0
Ivory Coast,1971,African Cup of Nations qualification,3,4,1,1,0,2,-1,0
Ivory Coast,1971,Friendly,2,6,0,1,0,1,-4,0
Ivory Coast,1972,FIFA World Cup qualification,3,0,2,0,0,2,3,0
Ivory Coast,1972,Friendly,2,1,1,0,0,1,1,0
Ivory Coast,1973,African Cup of Nations qualification,11,5,3,1,0,4,6,1
Ivory Coast,1973,FIFA World Cup qualification,5,7,1,1,2,4,-2,0
Ivory Coast,1974,African Cup of Nations,2,5,0,2,1,3,-3,0
Ivory Coast,1974,Friendly,2,8,0,2,1,3,-6,0
Ivory Coast,1975,African Cup of Nations qualification,2,2,1,1,0,2,0,0
Ivory Coast,1975,Friendly,2,8,0,3,2,5,-6,0
Ivory Coast,1976,FIFA World Cup qualification,3,1,1,0,1,2,2,0
Ivory Coast,1976,Friendly,11,5,3,1,0,4,6,0
Ivory Coast,1977,African Cup of Nations qualification,5,1,2,0,0,2,4,0
Ivory Coast,1977,FIFA World Cup qualification,8,9,2,1,1,4,-1,0
Ivory Coast,1978,Friendly,1,3,0,1,0,1,-2,0
Ivory Coast,1979,African Cup of Nations qualification,8,4,2,2,0,4,4,0
Ivory Coast,1979,Friendly,8,7,2,4,0,6,1,0
Ivory Coast,1980,African Cup of Nations,2,3,0,1,2,3,-1,0
Ivory Coast,1980,Friendly,12,9,2,1,3,6,3,0
Ivory Coast,1982,West African Cup,11,11,0,0,5,5,0,0
Ivory Coast,1983,Friendly,10,9,5,2,1,8,1,1
Ivory Coast,1983,West African Cup,5,3,2,1,1,4,2,0
Ivory Coast,1984,African Cup of Nations,4,4,1,2,0,3,0,0
Ivory Coast,1984,FIFA World Cup qualification,6,3,1,1,0,2,3,0
Ivory Coast,1984,Friendly,36,14,11,0,2,13,22,0
Ivory Coast,1984,West African Cup,7,6,2,1,2,5,1,0
Ivory Coast,1985,African Cup of Nations qualification,9,1,2,0,2,4,8,0
Ivory Coast,1985,FIFA World Cup qualification,0,2,0,1,1,2,-2,0
Ivory Coast,1985,Friendly,13,14,6,5,4,15,-1,0
Ivory Coast,1986,African Cup of Nations,7,5,3,2,0,5,2,0
Ivory Coast,1986,Friendly,7,4,3,2,0,5,3,0
Ivory Coast,1987,African Cup of Nations qualification,8,2,4,0,0,4,6,1
Ivory Coast,1987,All-African Games,4,3,2,1,1,4,1,0
Ivory Coast,1987,Friendly,9,9,4,4,0,8,0,1
Ivory Coast,1987,West African Cup,1,2,1,1,0,2,-1,0
Ivory Coast,1988,African Cup of Nations,2,2,0,0,3,3,0,0
Ivory Coast,1988,Friendly,2,1,1,0,1,2,1,0
Ivory Coast,1989,African Cup of Nations qualification,11,4,3,0,1,4,7,0
Ivory Coast,1989,FIFA World Cup qualification,6,1,2,1,2,5,5,0
Ivory Coast,1989,Friendly,1,1,0,0,1,1,0,0
Ivory Coast,1990,African Cup of Nations,3,5,1,2,0,3,-2,0
Ivory Coast,1990,African Cup of Nations qualification,3,0,2,0,0,2,3,0
Ivory Coast,1990,Friendly,2,4,1,2,0,3,-2,0
Ivory Coast,1991,African Cup of Nations qualification,4,3,2,1,0,3,1,0
Ivory Coast,1991,Dakar Tournament,1,1,0,0,2,2,0,0
Ivory Coast,1991,Friendly,20,9,7,1,3,11,11,0
Ivory Coast,1992,African Cup of Nations,4,0,2,0,3,5,4,0
Ivory Coast,1992,Confederations Cup,2,9,0,2,0,2,-7,0
Ivory Coast,1992,FIFA World Cup qualification,6,0,1,0,1,2,6,0
Ivory Coast,1992,Friendly,4,4,1,1,1,3,0,0
Ivory Coast,1993,FIFA World Cup qualification,6,6,3,1,2,6,0,0
Ivory Coast,1993,Friendly,4,3,2,1,0,3,1,0
Ivory Coast,1994,African Cup of Nations,11,5,3,1,1,5,6,0
Ivory Coast,1994,African Cup of Nations qualification,0,1,0,1,0,1,-1,0
Ivory Coast,1994,Friendly,13,12,4,3,0,7,1,0
Ivory Coast,1994,Simba Tournament,3,2,1,0,2,3,1,0
Ivory Coast,1995,African Cup of Nations qualification,5,3,1,0,2,3,2,0
Ivory Coast,1995,Friendly,15,6,5,1,5,11,9,0
Ivory Coast,1996,African Cup of Nations,2,5,1,2,0,3,-3,0
Ivory Coast,1996,African Cup of Nations qualification,1,4,0,1,0,1,-3,0
Ivory Coast,1996,FIFA World Cup qualification,1,3,0,1,1,2,-2,0
Ivory Coast,1996,Friendly,2,1,1,0,1,2,1,0
Ivory Coast,1997,African Cup of Nations qualification,9,4,4,0,1,5,5,0
Ivory Coast,1997,Friendly,6,4,2,1,1,4,2,0
Ivory Coast,1998,African Cup of Nations,10,6,2,0,2,4,4,0
Ivory Coast,1998,African Cup of Nations qualification,1,0,1,0,0,1,1,0
Ivory Coast,1998,Friendly,6,3,2,1,2,5,3,0
Ivory Coast,1999,African Cup of Nations qualification,6,2,2,1,2,5,4,0
Ivory Coast,1999,Friendly,6,6,2,2,0,4,0,1
Ivory Coast,2000,African Cup of Nations,3,4,1,1,1,3,-1,0
Ivory Coast,2000,African Cup of Nations qualification,9,2,3,1,0,4,7,0
Ivory Coast,2000,FIFA World Cup qualification,6,4,1,0,2,3,2,0
Ivory Coast,2000,Friendly,2,0,1,0,0,1,2,0
Ivory Coast,2001,African Cup of Nations qualification,7,2,2,0,2,4,5,0
Ivory Coast,2001,FIFA World Cup qualification,16,6,4,1,2,7,10,0
Ivory Coast,2001,Friendly,3,0,1,0,0,1,3,0
Ivory Coast,2002,African Cup of Nations,1,4,0,2,1,3,-3,0
Ivory Coast,2002,African Cup of Nations qualification,0,0,0,0,1,1,0,0
Ivory Coast,2002,Friendly,6,1,1,0,1,2,5,0
Ivory Coast,2003,African Cup of Nations qualification,8,3,2,1,0,3,5,0
Ivory Coast,2003,Friendly,6,4,2,2,0,4,2,0
Ivory Coast,2004,FIFA World Cup qualification,10,3,4,1,0,5,7,0
Ivory Coast,2004,Friendly,8,3,3,0,0,3,5,0
Ivory Coast,2005,FIFA World Cup qualification,10,4,3,1,1,5,6,0
Ivory Coast,2005,Friendly,5,7,1,1,2,4,-2,0
Ivory Coast,2006,African Cup of Nations,6,5,3,1,2,6,1,0
Ivory Coast,2006,African Cup of Nations qualification,5,0,1,0,0,1,5,0
Ivory Coast,2006,FIFA World Cup,5,6,1,2,0,3,-1,0
Ivory Coast,2006,Friendly,10,6,3,2,2,7,4,0
Ivory Coast,2007,African Cup of Nations qualification,8,0,2,0,1,3,8,0
Ivory Coast,2007,Friendly,13,6,3,2,1,6,7,0
Ivory Coast,2008,African Cup of Nations,16,9,4,2,0,6,7,0
Ivory Coast,2008,FIFA World Cup qualification,10,2,3,0,3,6,8,0
Ivory Coast,2008,Friendly,6,5,2,1,1,4,1,0
Ivory Coast,2008,Kirin Cup,1,2,0,1,1,2,-1,0
Ivory Coast,2009,FIFA World Cup qualification,19,4,5,0,1,6,15,0
Ivory Coast,2009,Friendly,5,4,1,0,3,4,1,0
Ivory Coast,2010,African Cup of Nations,5,4,1,1,1,3,1,0
Ivory Coast,2010,African Cup of Nations qualification,4,0,2,0,0,2,4,0
Ivory Coast,2010,FIFA World Cup,4,3,1,1,1,3,1,0
Ivory Coast,2010,Friendly,9,7,4,2,1,7,2,0
Ivory Coast,2011,African Cup of Nations qualification,15,4,4,0,0,4,11,0
Ivory Coast,2011,Friendly,6,4,2,0,1,3,2,0
Ivory Coast,2012,African Cup of Nations,9,0,5,0,1,6,9,0
Ivory Coast,2012,African Cup of Nations qualification,6,2,2,0,0,2,4,0
Ivory Coast,2012,FIFA World Cup qualification,4,2,1,0,1,2,2,0
Ivory Coast,2012,Friendly,7,1,3,0,2,5,6,0
Ivory Coast,2013,African Cup of Nations,8,5,2,1,1,4,3,0
Ivory Coast,2013,FIFA World Cup qualification,15,5,4,0,2,6,10,0
Ivory Coast,2013,Friendly,7,9,1,2,1,4,-2,0
Ivory Coast,2014,African Cup of Nations qualification,13,11,3,2,1,6,2,0
Ivory Coast,2014,FIFA World Cup,4,5,1,2,0,3,-1,0
Ivory Coast,2014,Friendly,6,8,1,2,2,5,-2,0
Ivory Coast,2015,African Cup of Nations,9,4,3,0,3,6,5,0
Ivory Coast,2015,African Cup of Nations qualification,0,0,0,0,1,1,0,0
Ivory Coast,2015,FIFA World Cup qualification,4,0,2,0,0,2,4,0
Ivory Coast,2015,Friendly,5,3,3,1,2,6,2,0
Ivory Coast,2016,African Cup of Nations qualification,3,2,1,0,2,3,1,0
Ivory Coast,2016,FIFA World Cup qualification,3,1,1,0,1,2,2,0
Ivory Coast,2016,Friendly,2,1,1,0,3,4,1,0
Ivory Coast,2017,African Cup of Nations,2,3,0,1,2,3,-1,0
Ivory Coast,2017,African Cup of Nations qualification,2,3,0,1,0,1,-1,0
Ivory Coast,2017,FIFA World Cup qualification,4,4,1,2,1,4,0,0
Ivory Coast,2017,Friendly,9,8,3,1,2,6,1,0
Ivory Coast,2018,African Cup of Nations qualification,7,2,2,0,2,4,5,0
Ivory Coast,2018,Friendly,4,3,1,0,1,2,1,0
Ivory Coast,2019,African Cup of Nations,7,3,3,1,1,5,4,0
Ivory Coast,2019,African Cup of Nations qualification,5,2,2,1,0,3,3,0
Ivory Coast,2019,Friendly,14,7,5,2,0,7,7,0
Ivory Coast,2020,African Cup of Nations qualification,3,2,1,0,1,2,1,0
Ivory Coast,2020,Friendly,1,2,0,1,1,2,-1,0
Ivory Coast,2021,African Cup of Nations qualification,6,1,2,0,0,2,5,0
Ivory Coast,2021,FIFA World Cup qualification,10,3,4,1,1,6,7,0
Ivory Coast,2021,Friendly,2,1,1,0,1,2,1,0
Ivory Coast,2022,African Cup of Nations,6,3,2,0,2,4,3,0
Ivory Coast,2022,African Cup of Nations qualification,3,1,1,0,1,2,2,0
Ivory Coast,2022,Friendly,11,9,3,3,0,6,2,0
Ivory Coast,2023,African Cup of Nations qualification,6,4,3,1,0,4,2,0
Ivory Coast,2023,FIFA World Cup qualification,11,0,2,0,0,2,11,0
Ivory Coast,2023,Friendly,2,2,0,0,2,2,0,0
Ivory Coast,2024,African Cup of Nations,8,8,4,2,1,7,0,1
Ivory Coast,2024,African Cup of Nations qualification,8,2,3,1,0,4,6,0
Ivory Coast,2024,FIFA World Cup qualification,1,0,1,0,1,2,1,0
Ivory Coast,2024,Friendly,9,4,2,0,1,3,5,0
Ivory Coast,2025,FIFA World Cup qualification,2,0,2,0,0,2,2,0
Jamaica,1925,Friendly,6,1,3,0,0,3,5,0
Jamaica,1926,Friendly,8,0,2,0,0,2,8,0
Jamaica,1930,Central American and Caribbean Games,5,8,0,2,0,2,-3,0
Jamaica,1932,Friendly,2,4,1,1,0,2,-2,0
Jamaica,1935,Friendly,2,3,0,1,0,1,-1,0
Jamaica,1936,Friendly,1,3,0,2,0,2,-2,0
Jamaica,1938,Friendly,2,9,0,3,0,3,-7,0
Jamaica,1947,Friendly,4,18,2,5,2,9,-14,0
Jamaica,1948,Friendly,9,3,3,1,1,5,6,0
Jamaica,1949,Friendly,11,8,3,2,0,5,3,0
Jamaica,1950,Friendly,2,1,1,0,0,1,1,0
Jamaica,1951,Friendly,7,12,2,3,1,6,-5,1
Jamaica,1952,Friendly,6,12,0,3,1,4,-6,0
Jamaica,1953,Friendly,4,8,1,3,0,4,-4,0
Jamaica,1957,Friendly,5,1,3,0,0,3,4,0
Jamaica,1958,Friendly,1,5,1,2,0,3,-4,0
Jamaica,1959,Friendly,6,5,1,1,1,3,1,0
Jamaica,1962,Friendly,13,19,1,4,1,6,-6,0
Jamaica,1963,CONCACAF Championship,1,16,0,3,0,3,-15,0
Jamaica,1963,Friendly,2,7,0,3,2,5,-5,0
Jamaica,1963,Phillip Seaga Cup,4,4,1,1,0,2,0,0
Jamaica,1965,FIFA World Cup qualification,8,21,2,4,2,8,-13,0
Jamaica,1965,Friendly,7,0,2,0,0,2,7,1
Jamaica,1966,Friendly,4,12,0,3,2,5,-8,0
Jamaica,1967,CONCACAF Championship qualification,4,4,1,1,2,4,0,0
Jamaica,1967,Friendly,0,2,0,2,0,2,-2,0
Jamaica,1968,FIFA World Cup qualification,2,11,0,4,0,4,-9,0
Jamaica,1969,CONCACAF Championship,3,10,0,4,1,5,-7,0
Jamaica,1969,CONCACAF Championship qualification,3,2,1,0,1,2,1,1
Jamaica,1969,Friendly,2,4,1,1,0,2,-2,0
Jamaica,1971,CONCACAF Championship qualification,0,1,0,1,1,2,-1,0
Jamaica,1972,Friendly,5,0,2,0,1,3,5,0
Jamaica,1973,Friendly,1,2,0,1,0,1,-1,0
Jamaica,1974,Friendly,3,4,2,1,0,3,-1,0
Jamaica,1975,Friendly,4,4,2,2,0,4,0,0
Jamaica,1976,CONCACAF Championship qualification,1,5,0,2,0,2,-4,0
Jamaica,1977,Friendly,0,4,0,2,0,2,-4,0
Jamaica,1978,CFU Caribbean Cup qualification,1,3,0,2,0,2,-2,0
Jamaica,1979,CFU Caribbean Cup qualification,4,9,2,2,0,4,-5,0
Jamaica,1984,Friendly,0,1,0,1,0,1,-1,0
Jamaica,1985,Friendly,3,3,0,0,3,3,0,0
Jamaica,1986,Miami Cup,1,4,0,1,0,1,-3,0
Jamaica,1987,Friendly,5,1,2,0,0,2,4,0
Jamaica,1988,CONCACAF Championship qualification,4,6,2,1,1,4,-2,0
Jamaica,1988,Friendly,0,4,0,1,1,2,-4,0
Jamaica,1989,CFU Caribbean Cup qualification,2,5,0,2,2,4,-3,0
Jamaica,1989,Friendly,2,5,0,1,2,3,-3,0
Jamaica,1990,CFU Caribbean Cup,0,0,0,0,1,1,0,0
Jamaica,1990,CFU Caribbean Cup qualification,4,0,2,0,1,3,4,0
Jamaica,1990,Friendly,3,2,2,1,0,3,1,0
Jamaica,1991,CFU Caribbean Cup,13,2,4,0,0,4,11,1
Jamaica,1991,Friendly,5,3,2,1,1,4,2,0
Jamaica,1991,Gold Cup,3,12,0,3,0,3,-9,0
Jamaica,1992,CFU Caribbean Cup,3,3,2,1,1,4,0,0
Jamaica,1992,FIFA World Cup qualification,12,12,4,3,3,10,0,0
Jamaica,1992,Friendly,6,17,1,3,2,6,-11,0
Jamaica,1993,CFU Caribbean Cup,10,1,4,0,1,5,9,0
Jamaica,1993,Friendly,1,2,0,1,1,2,-1,0
Jamaica,1993,Gold Cup,6,10,1,2,2,5,-4,0
Jamaica,1994,CFU Caribbean Cup qualification,17,5,2,1,0,3,12,0
Jamaica,1994,Friendly,0,3,0,1,0,1,-3,0
Jamaica,1995,CFU Caribbean Cup,4,3,2,1,0,3,1,0
Jamaica,1995,Friendly,25,14,9,3,3,15,11,0
Jamaica,1996,CFU Caribbean Cup,5,5,1,2,0,3,0,0
Jamaica,1996,CFU Caribbean Cup qualification,2,2,1,1,0,2,0,0
Jamaica,1996,FIFA World Cup qualification,17,3,8,1,1,10,14,0
Jamaica,1996,Friendly,7,7,2,3,3,8,0,0
Jamaica,1997,CFU Caribbean Cup,8,3,2,0,2,4,5,1
Jamaica,1997,CFU Caribbean Cup qualification,10,2,3,0,0,3,8,0
Jamaica,1997,FIFA World Cup qualification,7,12,3,2,5,10,-5,0
Jamaica,1997,Friendly,19,10,6,1,3,10,9,0
Jamaica,1998,CFU Caribbean Cup,12,4,5,0,0,5,8,1
Jamaica,1998,FIFA World Cup,3,9,1,2,0,3,-6,0
Jamaica,1998,Friendly,4,7,0,3,6,9,-3,0
Jamaica,1998,Gold Cup,5,4,2,2,1,5,1,0
Jamaica,1999,CFU Caribbean Cup,7,5,2,2,0,4,2,0
Jamaica,1999,Friendly,20,37,4,8,4,16,-17,0
Jamaica,2000,FIFA World Cup qualification,7,4,4,2,0,6,3,0
Jamaica,2000,Friendly,19,8,5,2,2,9,11,0
Jamaica,2000,Gold Cup,0,3,0,2,0,2,-3,0
Jamaica,2000,King Hassan II Tournament,0,5,0,2,0,2,-5,0
Jamaica,2001,CFU Caribbean Cup,4,3,2,1,0,3,1,0
Jamaica,2001,FIFA World Cup qualification,7,14,2,6,2,10,-7,0
Jamaica,2001,Friendly,4,3,1,1,2,4,1,0
Jamaica,2001,SKN Football Festival,0,0,0,0,2,2,0,0
Jamaica,2002,Friendly,8,8,3,2,3,8,0,0
Jamaica,2002,Gold Cup qualification,7,2,2,0,1,3,5,0
Jamaica,2003,Friendly,13,14,4,7,2,13,-1,0
Jamaica,2003,Gold Cup,2,6,1,2,0,3,-4,0
Jamaica,2003,Gold Cup qualification,10,2,2,0,1,3,8,0
Jamaica,2004,CFU Caribbean Cup qualification,29,4,4,0,1,5,25,0
Jamaica,2004,FIFA World Cup qualification,11,6,2,1,5,8,5,0
Jamaica,2004,Friendly,8,8,2,2,2,6,0,0
Jamaica,2005,CFU Caribbean Cup,4,1,3,0,0,3,3,1
Jamaica,2005,CFU Caribbean Cup qualification,5,0,1,0,1,2,5,0
Jamaica,2005,Friendly,3,6,2,1,1,4,-3,0
Jamaica,2005,Gold Cup,8,10,1,2,1,4,-2,0
Jamaica,2006,CFU Caribbean Cup qualification,6,0,2,0,0,2,6,0
Jamaica,2006,Friendly,5,14,1,3,2,6,-9,0
Jamaica,2007,Friendly,10,17,3,5,1,9,-7,0
Jamaica,2008,CFU Caribbean Cup,11,2,4,0,1,5,9,0
Jamaica,2008,FIFA World Cup qualification,19,6,5,2,1,8,13,1
Jamaica,2008,Friendly,7,6,1,1,4,6,1,0
Jamaica,2009,Friendly,10,5,3,0,5,8,5,0
Jamaica,2009,Gold Cup,1,2,1,2,0,3,-1,0
Jamaica,2010,CFU Caribbean Cup,12,3,4,0,1,5,9,0
Jamaica,2010,Friendly,8,7,4,3,1,8,1,0
Jamaica,2011,Friendly,6,14,1,5,0,6,-8,0
Jamaica,2011,Gold Cup,7,2,3,1,0,4,5,0
Jamaica,2012,CFU Caribbean Cup,1,3,0,2,1,3,-2,0
Jamaica,2012,FIFA World Cup qualification,9,6,3,2,1,6,3,0
Jamaica,2012,Friendly,11,5,5,2,1,8,6,0
Jamaica,2013,FIFA World Cup qualification,5,13,0,5,5,10,-8,0
Jamaica,2013,Friendly,0,3,0,2,0,2,-3,0
Jamaica,2014,CFU Caribbean Cup,0,0,0,0,1,1,0,0
Jamaica,2014,Friendly,8,14,1,4,1,6,-6,0
Jamaica,2015,Copa América,0,3,0,3,0,3,-3,0
Jamaica,2015,FIFA World Cup qualification,5,5,2,2,0,4,0,0
Jamaica,2015,Friendly,3,3,1,1,0,2,0,0
Jamaica,2015,Gold Cup,8,6,4,1,1,6,2,0
Jamaica,2016,CFU Caribbean Cup qualification,1,0,1,0,0,1,1,1
Jamaica,2016,Copa América,0,6,0,3,0,3,-6,0
Jamaica,2016,FIFA World Cup qualification,1,8,0,3,1,4,-7,0
Jamaica,2017,CFU Caribbean Cup,2,3,0,1,1,2,-1,0
Jamaica,2017,Friendly,5,11,1,3,0,4,-6,0
Jamaica,2017,Gold Cup,7,4,3,1,2,6,3,0
Jamaica,2018,CONCACAF Nations League qualification,12,1,3,0,0,3,11,0
Jamaica,2018,Friendly,15,9,3,1,3,7,6,0
Jamaica,2019,CONCACAF Nations League,21,1,5,0,1,6,20,0
Jamaica,2019,CONCACAF Nations League qualification,0,2,0,1,0,1,-2,0
Jamaica,2019,Friendly,1,1,1,1,0,2,0,0
Jamaica,2019,Gold Cup,6,6,2,1,2,5,0,0
Jamaica,2020,Friendly,2,4,1,1,0,2,-2,0
Jamaica,2021,FIFA World Cup qualification,6,10,1,3,4,8,-4,0
Jamaica,2021,Friendly,2,5,0,1,1,2,-3,0
Jamaica,2021,Gold Cup,4,3,2,2,0,4,1,0
Jamaica,2022,CONCACAF Nations League,5,3,1,0,2,3,2,0
Jamaica,2022,FIFA World Cup qualification,6,12,1,4,1,6,-6,0
Jamaica,2022,Friendly,1,7,0,2,1,3,-6,0
Jamaica,2023,CONCACAF Nations League,16,11,4,1,2,7,5,0
Jamaica,2023,Friendly,2,5,0,3,2,5,-3,0
Jamaica,2023,Gold Cup,11,5,3,1,1,5,6,0
Jamaica,2024,CONCACAF Nations League,8,9,3,3,2,8,-1,0
Jamaica,2024,Copa América,1,7,0,3,0,3,-6,0
Jamaica,2024,FIFA World Cup qualification,4,2,2,0,0,2,2,0
Jamaica,2024,Friendly,1,0,1,0,1,2,1,0
Jamaica,2025,Friendly,2,1,1,0,1,2,1,0
Jamaica,2025,Gold Cup qualification,4,1,1,0,1,2,3,0
Japan,1917,Far Eastern Championship Games,2,20,0,2,0,2,-18,0
Japan,1917,Friendly,2,15,0,1,0,1,-13,0
Japan,1921,Far Eastern Championship Games,1,7,0,2,0,2,-6,0
Japan,1921,Friendly,0,3,0,1,0,1,-3,0
Japan,1921,Open International Championship,0,3,0,1,0,1,-3,0
Japan,1923,Far Eastern Championship Games,2,7,0,2,0,2,-5,0
Japan,1923,Friendly,1,5,0,1,0,1,-4,0
Japan,1925,Far Eastern Championship Games,0,6,0,2,0,2,-6,0
Japan,1925,Friendly,0,2,0,1,0,1,-2,0
Japan,1927,Far Eastern Championship Games,3,6,1,1,0,2,-3,0
Japan,1927,Friendly,3,6,1,1,0,2,-3,0
Japan,1930,Far Eastern Championship Games,10,5,1,0,1,2,5,0
Japan,1930,Friendly,3,3,0,0,1,1,0,0
Japan,1934,Far Eastern Championship Games,8,14,1,2,0,3,-6,0
Japan,1934,Friendly,4,11,0,2,0,2,-7,0
Japan,1939,Friendly,9,0,2,0,0,2,9,0
Japan,1940,Friendly,14,0,3,0,0,3,14,0
Japan,1942,Friendly,21,1,3,0,0,3,20,0
Japan,1951,Asian Games,4,3,1,1,1,3,1,0
Japan,1954,Asian Games,5,8,0,2,0,2,-3,0
Japan,1954,FIFA World Cup qualification,3,7,0,1,1,2,-4,0
Japan,1955,Friendly,1,0,1,0,1,2,1,0
Japan,1958,Asian Games,0,3,0,2,0,2,-3,0
Japan,1958,Friendly,4,11,0,2,0,2,-7,0
Japan,1959,Friendly,9,7,2,1,0,3,2,0
Japan,1959,Merdeka Tournament,5,4,1,1,1,3,1,0
Japan,1960,FIFA World Cup qualification,1,2,0,1,0,1,-1,0
Japan,1960,Merdeka Tournament,4,7,1,2,0,3,-3,0
Japan,1961,FIFA World Cup qualification,0,2,0,1,0,1,-2,0
Japan,1961,Friendly,3,4,1,1,0,2,-1,0
Japan,1961,Merdeka Tournament,7,7,1,2,0,3,0,0
Japan,1962,Asian Games,3,4,1,2,0,3,-1,0
Japan,1962,Friendly,1,2,0,1,0,1,-1,0
Japan,1962,Merdeka Tournament,4,6,0,1,2,3,-2,0
Japan,1963,Friendly,2,1,1,0,0,1,1,0
Japan,1963,Merdeka Tournament,14,8,3,1,1,5,6,0
Japan,1964,Friendly,2,1,1,0,0,1,1,0
Japan,1965,Friendly,12,5,3,0,2,5,7,0
Japan,1965,Merdeka Tournament,8,9,2,1,3,6,-1,0
Japan,1966,Asian Games,18,5,6,1,0,7,13,0
Japan,1966,Merdeka Tournament,6,9,2,3,0,5,-3,0
Japan,1967,AFC Asian Cup qualification,6,2,3,0,0,3,4,0
Japan,1967,Friendly,0,1,0,1,1,2,-1,0
Japan,1968,Friendly,6,10,1,2,1,4,-4,0
Japan,1969,FIFA World Cup qualification,4,8,0,2,2,4,-4,0
Japan,1970,Asian Games,8,5,5,2,0,7,3,0
Japan,1970,Merdeka Tournament,13,8,3,1,2,6,5,1
Japan,1971,Friendly,4,3,1,1,0,2,1,0
Japan,1972,Friendly,6,4,1,1,1,3,2,0
Japan,1972,Merdeka Tournament,15,8,3,2,0,5,7,0
Japan,1973,FIFA World Cup qualification,5,4,1,3,0,4,1,0
Japan,1973,Friendly,0,2,0,1,0,1,-2,0
Japan,1974,Asian Games,5,4,1,1,1,3,1,0
Japan,1974,Friendly,5,1,2,0,1,3,4,0
Japan,1975,AFC Asian Cup qualification,1,3,0,2,1,3,-2,0
Japan,1975,Friendly,0,3,0,1,0,1,-3,0
Japan,1975,Merdeka Tournament,14,8,4,3,0,7,6,0
Japan,1976,Friendly,3,9,0,3,1,4,-6,0
Japan,1976,Merdeka Tournament,17,9,2,1,4,7,8,0
Japan,1977,FIFA World Cup qualification,0,5,0,3,1,4,-5,0
Japan,1977,Friendly,1,2,0,1,0,1,-1,0
Japan,1978,Asian Games,5,5,1,2,0,3,0,0
Japan,1978,Friendly,2,11,0,3,0,3,-9,0
Japan,1978,Kirin Cup,3,0,1,0,0,1,3,1
Japan,1978,Merdeka Tournament,10,14,2,4,1,7,-4,0
Japan,1979,Friendly,3,5,1,1,1,3,-2,0
Japan,1979,Kirin Cup,4,0,1,0,0,1,4,1
Japan,1979,Merdeka Tournament,7,2,3,0,2,5,5,0
Japan,1980,FIFA World Cup qualification,4,2,2,2,0,4,2,0
Japan,1980,Friendly,1,0,1,0,0,1,1,0
Japan,1980,Guangzhou International Friendship Tournament,5,2,2,1,0,3,3,1
Japan,1981,Friendly,2,5,1,3,2,6,-3,0
Japan,1981,Kirin Cup,0,0,0,0,1,1,0,0
Japan,1981,Korea Cup,2,2,1,1,0,2,0,0
Japan,1981,Merdeka Tournament,10,7,4,2,0,6,3,0
Japan,1982,Asian Games,6,3,3,1,0,4,3,0
Japan,1982,Friendly,0,3,0,1,0,1,-3,0
Japan,1982,Kirin Cup,2,0,1,0,0,1,2,1
Japan,1983,Friendly,3,3,0,0,2,2,0,0
Japan,1983,Kirin Cup,1,0,1,0,0,1,1,1
Japan,1984,Friendly,9,2,2,0,0,2,7,0
Japan,1984,Kirin Cup,1,0,1,0,0,1,1,0
Japan,1985,FIFA World Cup qualification,15,5,5,2,1,8,10,0
Japan,1985,Kirin Cup,1,4,0,1,0,1,-3,0
Japan,1986,Asian Games,9,4,2,2,0,4,5,0
Japan,1986,Kirin Cup,2,1,1,0,0,1,1,1
Japan,1986,Merdeka Tournament,3,3,1,1,0,2,0,0
Japan,1987,Kirin Cup,2,2,0,0,1,1,0,0
Japan,1988,AFC Asian Cup,0,6,0,3,1,4,-6,0
Japan,1988,AFC Asian Cup qualification,6,3,2,1,1,4,3,0
Japan,1988,Friendly,2,5,0,2,2,4,-3,0
Japan,1988,Kirin Cup,0,3,0,1,0,1,-3,0
Japan,1989,FIFA World Cup qualification,7,3,2,1,3,6,4,0
Japan,1989,Friendly,6,6,1,2,2,5,0,0
Japan,1990,Asian Games,3,3,1,2,0,3,0,0
Japan,1990,Dynasty Cup,0,4,0,3,0,3,-4,0
Japan,1991,Friendly,0,1,0,1,0,1,-1,0
Japan,1991,Kirin Cup,1,0,1,0,0,1,1,1
Japan,1992,AFC Asian Cup,6,3,3,0,2,5,3,1
Japan,1992,Dynasty Cup,8,3,2,0,2,4,5,0
Japan,1992,Kirin Cup,0,2,0,2,0,2,-2,0
Japan,1993,FIFA World Cup qualification,35,6,9,1,3,13,29,0
Japan,1993,Friendly,2,1,1,0,1,2,1,0
Japan,1993,Kirin Cup,3,2,1,1,0,2,1,1
Japan,1994,Asian Games,9,5,1,1,2,4,4,0
Japan,1994,Friendly,5,3,2,0,1,3,2,0
Japan,1994,Kirin Cup,2,5,0,1,1,2,-3,0
Japan,1995,Confederations Cup,1,8,0,2,0,2,-7,0
Japan,1995,Dynasty Cup,8,4,2,0,2,4,4,0
Japan,1995,Friendly,13,18,3,5,1,9,-5,0
Japan,1995,King's Cup,2,3,0,1,0,1,-1,0
Japan,1995,Kirin Cup,3,0,1,0,1,2,3,1
Japan,1996,AFC Asian Cup,7,3,3,1,0,4,4,0
Japan,1996,Friendly,11,7,4,1,0,5,4,0
Japan,1996,Kirin Cup,4,2,2,0,0,2,2,1
Japan,1996,Lunar New Year Cup,6,1,1,0,1,2,5,0
Japan,1997,East Asian Games,19,4,2,1,1,4,15,0
Japan,1997,FIFA World Cup qualification,51,12,9,1,5,15,39,0
Japan,1997,Friendly,2,7,0,2,1,3,-5,0
Japan,1997,King's Cup,1,2,0,1,1,2,-1,0
Japan,1997,Kirin Cup,5,3,2,0,0,2,2,1
Japan,1998,Asian Games,8,4,3,2,0,5,4,0
Japan,1998,Dynasty Cup,7,4,2,1,0,3,3,0
Japan,1998,FIFA World Cup,1,4,0,3,0,3,-3,0
Japan,1998,Friendly,6,5,2,3,0,5,1,0
Japan,1998,Kirin Cup,1,1,0,0,2,2,0,0
Japan,1999,Copa América,3,8,0,2,1,3,-5,0
Japan,1999,Friendly,1,3,0,1,1,2,-2,0
Japan,1999,Kirin Cup,0,0,0,0,2,2,0,0
Japan,2000,AFC Asian Cup,21,6,5,0,1,6,15,1
Japan,2000,AFC Asian Cup qualification,15,0,3,0,0,3,15,0
Japan,2000,Friendly,4,3,1,1,2,4,1,0
Japan,2000,King Hassan II Tournament,6,2,1,0,1,2,4,0
Japan,2000,Kirin Cup,3,1,1,0,1,2,2,1
Japan,2000,Lunar New Year Cup,0,1,0,1,0,1,-1,0
Japan,2001,Confederations Cup,6,1,3,1,1,5,5,0
Japan,2001,Friendly,6,11,1,3,2,6,-5,0
Japan,2001,Kirin Cup,3,0,2,0,0,2,3,1
Japan,2001,Millennium Cup,0,1,0,1,0,1,-1,0
Japan,2002,FIFA World Cup,5,3,2,1,1,4,2,0
Japan,2002,Friendly,6,8,2,2,3,7,-2,0
Japan,2002,Kirin Cup,4,3,1,0,1,2,1,0
Japan,2003,Confederations Cup,4,3,1,2,0,3,1,0
Japan,2003,EAFF Championship,2,0,1,0,1,2,2,0
Japan,2003,Friendly,8,5,3,2,3,8,3,0
Japan,2003,Kirin Cup,1,4,0,1,1,2,-3,0
Japan,2004,AFC Asian Cup,13,6,4,0,2,6,7,1
Japan,2004,FIFA World Cup qualification,16,1,6,0,0,6,15,0
Japan,2004,Friendly,14,11,4,3,1,8,3,0
Japan,2004,Kirin Cup,4,1,2,0,0,2,3,1
Japan,2005,Confederations Cup,4,4,1,1,1,3,0,0
Japan,2005,EAFF Championship,3,3,1,1,1,3,0,1
Japan,2005,FIFA World Cup qualification,9,4,5,1,0,6,5,0
Japan,2005,Friendly,15,7,4,1,1,6,8,0
Japan,2005,Kirin Cup,0,2,0,2,0,2,-2,0
Japan,2006,AFC Asian Cup qualification,15,2,5,1,0,6,13,0
Japan,2006,FIFA World Cup,2,7,0,2,1,3,-5,0
Japan,2006,Friendly,12,8,4,2,2,8,4,0
Japan,2006,Kirin Cup,1,2,0,1,1,2,-1,0
Japan,2007,AFC Asian Cup,11,7,2,1,3,6,4,0
Japan,2007,Friendly,12,4,4,0,1,5,8,0
Japan,2007,Kirin Cup,2,0,1,0,1,2,2,0
Japan,2008,EAFF Championship,3,2,1,0,2,3,1,0
Japan,2008,FIFA World Cup qualification,19,6,6,1,2,9,13,0
Japan,2008,Friendly,8,5,2,1,2,5,3,0
Japan,2008,Kirin Cup,1,0,1,0,1,2,1,0
Japan,2009,AFC Asian Cup qualification,12,2,3,1,0,4,10,0
Japan,2009,FIFA World Cup qualification,4,3,2,1,2,5,1,0
Japan,2009,Friendly,16,7,4,1,1,6,9,0
Japan,2009,Kirin Cup,8,0,2,0,0,2,8,1
Japan,2010,AFC Asian Cup qualification,5,2,2,0,0,2,3,0
Japan,2010,EAFF Championship,4,3,1,1,1,3,1,0
Japan,2010,FIFA World Cup,4,2,2,1,1,4,2,0
Japan,2010,Friendly,5,10,3,4,2,9,-5,0
Japan,2011,AFC Asian Cup,14,6,4,0,2,6,8,1
Japan,2011,FIFA World Cup qualification,14,2,3,1,1,5,12,0
Japan,2011,Friendly,4,0,2,0,0,2,4,0
Japan,2011,Kirin Cup,0,0,0,0,2,2,0,0
Japan,2012,FIFA World Cup qualification,13,3,4,1,1,6,10,0
Japan,2012,Friendly,8,6,4,1,1,6,2,0
Japan,2013,Confederations Cup,4,9,0,3,0,3,-5,0
Japan,2013,EAFF Championship,8,6,2,0,1,3,2,1
Japan,2013,FIFA World Cup qualification,3,3,1,1,1,3,0,0
Japan,2013,Friendly,18,13,5,3,1,9,5,0
Japan,2013,Kirin Challenge Cup,0,2,0,1,0,1,-2,0
Japan,2014,FIFA World Cup,2,6,0,2,1,3,-4,0
Japan,2014,Friendly,23,13,7,1,1,9,10,0
Japan,2014,Kirin Challenge Cup,0,2,0,1,0,1,-2,0
Japan,2015,AFC Asian Cup,8,1,3,0,1,4,7,0
Japan,2015,EAFF Championship,3,4,0,1,2,3,-1,0
Japan,2015,FIFA World Cup qualification,17,0,5,0,1,6,17,0
Japan,2015,Friendly,6,2,1,0,1,2,4,0
Japan,2015,Kirin Challenge Cup,6,0,2,0,0,2,6,1
Japan,2016,FIFA World Cup qualification,18,5,5,1,1,7,13,0
Japan,2016,Kirin Challenge Cup,4,0,1,0,0,1,4,1
Japan,2016,Kirin Cup,8,4,1,1,0,2,4,0
Japan,2017,EAFF Championship,4,5,2,1,0,3,-1,0
Japan,2017,FIFA World Cup qualification,9,2,3,1,1,5,7,0
Japan,2017,Friendly,1,4,0,2,0,2,-3,0
Japan,2017,Kirin Challenge Cup,6,5,1,0,2,3,1,0
Japan,2018,FIFA World Cup,6,7,1,2,1,4,-1,0
Japan,2018,Friendly,6,9,1,3,1,5,-3,0
Japan,2018,Kirin Challenge Cup,15,4,4,0,1,5,11,1
Japan,2019,AFC Asian Cup,12,6,6,1,0,7,6,0
Japan,2019,Copa América,3,7,0,1,2,3,-4,0
Japan,2019,EAFF Championship,7,2,2,1,0,3,5,0
Japan,2019,FIFA World Cup qualification,13,0,4,0,0,4,13,0
Japan,2019,Kirin Challenge Cup,6,5,3,2,1,6,1,0
Japan,2020,Friendly,2,2,2,1,1,4,0,0
Japan,2021,FIFA World Cup qualification,38,5,8,2,0,10,33,0
Japan,2021,Friendly,3,0,1,0,0,1,3,0
Japan,2021,Kirin Challenge Cup,1,0,1,0,0,1,1,1
Japan,2022,EAFF Championship,9,0,2,0,1,3,9,1
Japan,2022,FIFA World Cup,5,4,2,1,1,4,1,0
Japan,2022,FIFA World Cup qualification,7,1,3,0,1,4,6,0
Japan,2022,Friendly,5,4,1,2,0,3,1,0
Japan,2022,Kirin Challenge Cup,2,0,1,0,1,2,2,0
Japan,2022,Kirin Cup,4,4,1,1,0,2,0,0
Japan,2023,FIFA World Cup qualification,10,0,2,0,0,2,10,0
Japan,2023,Friendly,24,8,5,1,1,7,16,0
Japan,2024,AFC Asian Cup,12,8,3,2,0,5,4,0
Japan,2024,FIFA World Cup qualification,33,2,8,0,1,9,31,0
Japan,2024,Friendly,11,1,2,0,0,2,10,0
Japan,2025,FIFA World Cup qualification,2,0,1,0,1,2,2,0
Jersey,1905,Muratti Vase,0,1,0,1,0,1,-1,0
Jersey,1906,Muratti Vase,1,2,0,1,0,1,-1,0
Jersey,1907,Muratti Vase,4,4,1,1,0,2,0,0
Jersey,1908,Muratti Vase,4,0,1,0,0,1,4,1
Jersey,1909,Muratti Vase,0,3,0,1,0,1,-3,0
Jersey,1910,Muratti Vase,10,3,2,0,0,2,7,1
Jersey,1911,Muratti Vase,4,1,1,0,0,1,3,1
Jersey,1912,Muratti Vase,5,8,0,1,1,2,-3,0
Jersey,1913,Muratti Vase,7,6,1,1,0,2,1,0
Jersey,1914,Muratti Vase,1,2,0,1,0,1,-1,0
Jersey,1919,Muratti Vase,0,2,0,1,0,1,-2,0
Jersey,1920,Muratti Vase,0,1,0,1,0,1,-1,0
Jersey,1921,Muratti Vase,3,0,2,0,0,2,3,1
Jersey,1922,Muratti Vase,1,2,0,1,0,1,-1,0
Jersey,1923,Muratti Vase,0,1,0,1,0,1,-1,0
Jersey,1924,Muratti Vase,2,0,2,0,0,2,2,1
Jersey,1925,Muratti Vase,1,2,0,1,0,1,-1,0
Jersey,1926,Muratti Vase,12,2,2,0,0,2,10,1
Jersey,1927,Muratti Vase,3,1,1,1,0,2,2,0
Jersey,1928,Muratti Vase,2,1,1,0,0,1,1,1
Jersey,1929,Muratti Vase,1,7,0,1,0,1,-6,0
Jersey,1930,Muratti Vase,5,5,1,1,0,2,0,0
Jersey,1931,Muratti Vase,4,2,1,0,0,1,2,1
Jersey,1932,Muratti Vase,0,2,0,1,0,1,-2,0
Jersey,1933,Muratti Vase,7,4,1,1,0,2,3,0
Jersey,1934,Muratti Vase,0,1,0,1,0,1,-1,0
Jersey,1935,Muratti Vase,0,1,0,1,0,1,-1,0
Jersey,1936,Muratti Vase,10,2,1,1,0,2,8,0
Jersey,1937,Muratti Vase,5,5,0,0,2,2,0,0
Jersey,1938,Muratti Vase,3,4,0,1,0,1,-1,0
Jersey,1939,Muratti Vase,3,1,2,0,0,2,2,1
Jersey,1946,Muratti Vase,11,0,2,0,0,2,11,1
Jersey,1947,Muratti Vase,3,1,1,0,0,1,2,1
Jersey,1948,Muratti Vase,6,3,1,0,0,1,3,1
Jersey,1949,Muratti Vase,11,1,2,0,0,2,10,1
Jersey,1950,Muratti Vase,0,2,0,1,0,1,-2,0
Jersey,1951,Muratti Vase,9,4,1,1,0,2,5,0
Jersey,1952,Muratti Vase,1,3,0,1,0,1,-2,0
Jersey,1953,Muratti Vase,6,0,2,0,0,2,6,1
Jersey,1954,Muratti Vase,3,5,0,1,0,1,-2,0
Jersey,1955,Muratti Vase,4,0,2,0,1,3,4,1
Jersey,1956,Muratti Vase,2,1,1,0,0,1,1,1
Jersey,1957,Muratti Vase,11,7,1,1,0,2,4,0
Jersey,1958,Muratti Vase,2,1,1,0,0,1,1,1
Jersey,1959,Muratti Vase,9,2,2,0,0,2,7,1
Jersey,1960,Muratti Vase,5,1,1,0,0,1,4,1
Jersey,1961,Muratti Vase,6,3,2,0,0,2,3,1
Jersey,1962,Muratti Vase,2,1,1,0,0,1,1,1
Jersey,1963,Muratti Vase,10,1,2,0,0,2,9,1
Jersey,1964,Muratti Vase,1,0,1,0,0,1,1,1
Jersey,1965,Muratti Vase,12,2,2,0,0,2,10,1
Jersey,1966,Muratti Vase,2,4,0,1,1,2,-2,0
Jersey,1967,Muratti Vase,6,2,2,0,0,2,4,1
Jersey,1968,Muratti Vase,2,1,1,0,0,1,1,1
Jersey,1969,Muratti Vase,6,2,1,1,0,2,4,0
Jersey,1970,Muratti Vase,2,0,1,0,0,1,2,1
Jersey,1971,Muratti Vase,12,0,2,0,0,2,12,1
Jersey,1972,Muratti Vase,0,3,0,1,0,1,-3,0
Jersey,1973,Muratti Vase,10,2,2,0,0,2,8,1
Jersey,1974,Muratti Vase,1,2,0,1,0,1,-1,0
Jersey,1975,Muratti Vase,7,6,1,1,1,3,1,0
Jersey,1976,Muratti Vase,3,1,1,0,0,1,2,1
Jersey,1977,Muratti Vase,8,1,2,0,0,2,7,1
Jersey,1978,Muratti Vase,0,2,0,1,0,1,-2,0
Jersey,1979,Muratti Vase,8,5,1,1,0,2,3,0
Jersey,1980,Muratti Vase,1,2,0,1,0,1,-1,0
Jersey,1981,Muratti Vase,9,1,2,0,0,2,8,1
Jersey,1982,Muratti Vase,2,1,1,0,0,1,1,1
Jersey,1983,Muratti Vase,7,3,1,1,0,2,4,0
Jersey,1984,Muratti Vase,6,2,1,0,0,1,4,1
Jersey,1985,Muratti Vase,8,4,1,1,0,2,4,0
Jersey,1986,Muratti Vase,3,2,1,0,0,1,1,1
Jersey,1987,Muratti Vase,14,3,2,0,0,2,11,1
Jersey,1988,Muratti Vase,0,1,0,1,0,1,-1,0
Jersey,1989,Muratti Vase,8,0,2,0,0,2,8,1
Jersey,1990,Muratti Vase,2,1,1,0,0,1,1,1
Jersey,1991,Island Games,11,8,3,1,0,4,3,0
Jersey,1991,Muratti Vase,4,4,1,1,0,2,0,0
Jersey,1992,Muratti Vase,2,3,0,1,0,1,-1,0
Jersey,1993,Island Games,13,6,3,0,1,4,7,1
Jersey,1993,Muratti Vase,2,1,1,0,0,1,1,1
Jersey,1994,Muratti Vase,21,1,2,0,0,2,20,1
Jersey,1995,Island Games,6,3,3,2,0,5,3,0
Jersey,1995,Muratti Vase,9,2,2,0,0,2,7,1
Jersey,1996,Muratti Vase,1,0,1,0,1,2,1,1
Jersey,1997,Island Games,15,5,5,0,0,5,10,1
Jersey,1997,Muratti Vase,1,2,0,1,0,1,-1,0
Jersey,1998,Muratti Vase,4,0,2,0,0,2,4,1
Jersey,1999,Island Games,6,4,2,2,0,4,2,0
Jersey,1999,Muratti Vase,0,2,0,1,0,1,-2,0
Jersey,2000,Muratti Vase,11,0,2,0,0,2,11,1
Jersey,2001,Island Games,18,3,3,0,1,4,15,0
Jersey,2001,Muratti Vase,1,4,0,1,0,1,-3,0
Jersey,2002,Friendly,0,3,0,1,0,1,-3,0
Jersey,2002,Muratti Vase,4,2,2,0,0,2,2,1
Jersey,2003,Friendly,0,1,0,1,0,1,-1,0
Jersey,2003,Island Games,14,3,3,1,1,5,11,0
Jersey,2003,Muratti Vase,4,3,1,0,1,2,1,1
Jersey,2004,Friendly,1,4,0,1,0,1,-3,0
Jersey,2004,Muratti Vase,7,0,2,0,0,2,7,1
Jersey,2005,Friendly,2,3,0,1,0,1,-1,0
Jersey,2005,Muratti Vase,3,3,0,0,2,2,0,0
Jersey,2006,Muratti Vase,7,3,2,0,0,2,4,1
Jersey,2007,Island Games,4,1,3,0,1,4,3,0
Jersey,2007,Muratti Vase,0,0,0,0,1,1,0,0
Jersey,2008,Friendly,2,1,1,0,0,1,1,0
Jersey,2008,Muratti Vase,8,1,1,0,1,2,7,0
Jersey,2009,Island Games,10,2,5,0,0,5,8,1
Jersey,2009,Muratti Vase,1,0,1,0,0,1,1,1
Jersey,2010,Muratti Vase,3,1,1,1,0,2,2,0
Jersey,2011,Island Games,11,3,4,1,0,5,8,1
Jersey,2011,Muratti Vase,1,1,0,0,1,1,0,0
Jersey,2012,Muratti Vase,0,2,0,1,0,1,-2,0
Jersey,2013,Muratti Vase,10,4,1,1,0,2,6,0
Jersey,2014,Muratti Vase,1,4,0,1,0,1,-3,0
Jersey,2015,Island Games,11,2,3,1,0,4,9,0
Jersey,2015,Muratti Vase,8,2,2,0,0,2,6,1
Jersey,2016,Friendly,2,0,1,0,0,1,2,0
Jersey,2016,Muratti Vase,1,0,1,0,0,1,1,1
Jersey,2017,Friendly,0,2,0,1,0,1,-2,0
Jersey,2017,Island Games,12,5,3,0,1,4,7,0
Jersey,2017,Muratti Vase,3,3,1,1,0,2,0,0
Jersey,2018,Muratti Vase,1,0,1,0,0,1,1,1
Jersey,2019,Inter Games Football Tournament,15,2,3,1,0,4,13,0
Jersey,2019,Muratti Vase,2,0,1,0,1,2,2,0
Jersey,2022,Muratti Vase,9,2,3,0,0,3,7,1
Jersey,2023,Island Games,18,4,5,0,0,5,14,1
Jordan,1963,Arab Cup,0,17,0,4,0,4,-17,0
Jordan,1963,Friendly,1,2,0,1,0,1,-1,0
Jordan,1964,Arab Cup,2,7,0,2,1,3,-5,0
Jordan,1965,Friendly,0,0,0,0,1,1,0,0
Jordan,1966,Arab Cup,7,9,1,3,0,4,-2,0
Jordan,1971,AFC Asian Cup qualification,5,9,2,3,1,6,-4,0
Jordan,1974,Kuneitra Cup,0,6,0,1,0,1,-6,0
Jordan,1981,Friendly,4,7,2,4,0,6,-3,0
Jordan,1983,Friendly,1,2,0,1,0,1,-1,0
Jordan,1984,AFC Asian Cup qualification,7,10,1,2,1,4,-3,0
Jordan,1985,Arab Cup,0,6,0,2,0,2,-6,0
Jordan,1985,FIFA World Cup qualification,3,7,1,3,0,4,-4,0
Jordan,1985,Friendly,1,3,0,1,1,2,-2,0
Jordan,1987,Friendly,2,1,1,0,0,1,1,0
Jordan,1988,AFC Asian Cup qualification,2,1,1,0,3,4,1,0
Jordan,1988,Arab Cup,2,5,1,2,1,4,-3,0
Jordan,1988,Friendly,5,6,1,3,0,4,-1,0
Jordan,1989,FIFA World Cup qualification,5,7,2,3,1,6,-2,0
Jordan,1990,Friendly,0,2,0,1,0,1,-2,0
Jordan,1992,Arab Cup,2,5,0,1,1,2,-3,0
Jordan,1992,Jordan International Tournament,10,1,5,0,0,5,9,1
Jordan,1993,FIFA World Cup qualification,12,15,2,3,3,8,-3,0
Jordan,1993,Friendly,6,5,2,2,1,5,1,0
Jordan,1996,AFC Asian Cup qualification,4,1,1,1,0,2,3,0
Jordan,1997,FIFA World Cup qualification,4,4,1,2,1,4,0,0
Jordan,1997,Friendly,1,3,0,2,4,6,-2,0
Jordan,1998,Arab Cup,2,3,1,1,0,2,-1,0
Jordan,1998,Arab Cup qualification,3,4,1,1,1,3,-1,0
Jordan,1999,Friendly,7,6,2,3,1,6,1,0
Jordan,2000,AFC Asian Cup qualification,12,4,2,1,1,4,8,0
Jordan,2000,Friendly,9,8,2,2,9,13,1,0
Jordan,2000,WAFF Championship,3,5,1,2,2,5,-2,0
Jordan,2001,FIFA World Cup qualification,12,7,2,2,2,6,5,0
Jordan,2001,Friendly,2,5,1,2,1,4,-3,0
Jordan,2001,Millennium Cup,3,0,2,0,0,2,3,0
Jordan,2002,Arab Cup,6,5,2,1,1,4,1,0
Jordan,2002,Friendly,5,2,2,0,2,4,3,0
Jordan,2002,Malta International Tournament,4,4,1,2,0,3,0,1
Jordan,2002,Prime Minister's Cup,6,0,2,0,1,3,6,1
Jordan,2002,WAFF Championship,6,4,3,1,0,4,2,0
Jordan,2003,AFC Asian Cup qualification,10,6,4,1,0,5,4,0
Jordan,2003,Friendly,3,3,1,1,1,3,0,0
Jordan,2004,AFC Asian Cup,3,1,1,0,3,4,2,0
Jordan,2004,FIFA World Cup qualification,10,6,4,2,0,6,4,0
Jordan,2004,Friendly,14,13,4,3,6,13,1,0
Jordan,2004,WAFF Championship,7,3,2,0,2,4,4,1
Jordan,2005,Friendly,3,6,0,3,2,5,-3,0
Jordan,2006,AFC Asian Cup qualification,10,5,3,2,1,6,5,0
Jordan,2006,Friendly,11,8,4,4,3,11,3,0
Jordan,2007,FIFA World Cup qualification,2,2,1,1,0,2,0,0
Jordan,2007,Friendly,7,2,2,0,2,4,5,0
Jordan,2007,WAFF Championship,3,2,1,2,0,3,1,0
Jordan,2008,FIFA World Cup qualification,6,6,2,3,1,6,0,0
Jordan,2008,Friendly,10,14,2,5,2,9,-4,0
Jordan,2008,WAFF Championship,4,2,1,1,1,3,2,0
Jordan,2009,AFC Asian Cup qualification,2,3,1,2,1,4,-1,0
Jordan,2009,Friendly,8,15,1,4,3,8,-7,0
Jordan,2010,AFC Asian Cup qualification,2,1,1,0,1,2,1,0
Jordan,2010,Friendly,7,5,2,2,1,5,2,0
Jordan,2010,WAFF Championship,3,3,0,0,2,2,0,0
Jordan,2011,AFC Asian Cup,5,4,2,1,1,4,1,0
Jordan,2011,FIFA World Cup qualification,20,5,5,1,1,7,15,0
Jordan,2011,Friendly,15,12,2,1,7,10,3,0
Jordan,2012,FIFA World Cup qualification,5,14,1,4,1,6,-9,0
Jordan,2012,Friendly,10,7,3,2,2,7,3,0
Jordan,2012,WAFF Championship,1,3,0,2,0,2,-2,0
Jordan,2013,AFC Asian Cup qualification,5,1,1,0,2,3,4,0
Jordan,2013,FIFA World Cup qualification,5,12,2,2,3,7,-7,0
Jordan,2013,Friendly,12,2,6,0,1,7,10,0
Jordan,2013,WAFF Championship,0,0,0,0,1,1,0,0
Jordan,2014,AFC Asian Cup qualification,5,2,2,0,1,3,3,0
Jordan,2014,Friendly,3,13,0,7,2,9,-10,0
Jordan,2014,WAFF Championship,3,3,2,1,0,3,0,0
Jordan,2015,AFC Asian Cup,5,4,1,2,0,3,1,0
Jordan,2015,FIFA World Cup qualification,12,2,4,1,1,6,10,0
Jordan,2015,Friendly,11,6,3,3,2,8,5,0
Jordan,2016,FIFA World Cup qualification,9,5,1,1,0,2,4,0
Jordan,2016,Friendly,5,6,1,2,5,8,-1,0
Jordan,2016,King's Cup,3,3,1,1,0,2,0,0
Jordan,2017,AFC Asian Cup qualification,15,4,3,0,2,5,11,0
Jordan,2017,Friendly,6,2,2,1,3,6,4,0
Jordan,2018,AFC Asian Cup qualification,1,1,0,0,1,1,0,0
Jordan,2018,Friendly,10,11,3,5,4,12,-1,0
Jordan,2019,AFC Asian Cup,4,1,2,0,2,4,3,0
Jordan,2019,FIFA World Cup qualification,10,2,3,1,1,5,8,0
Jordan,2019,Friendly,8,10,2,2,1,5,-2,0
Jordan,2019,WAFF Championship,4,2,1,1,1,3,2,0
Jordan,2020,Friendly,1,0,1,0,1,2,1,0
Jordan,2021,Arab Cup,7,8,2,2,0,4,-1,0
Jordan,2021,FIFA World Cup qualification,3,1,1,1,1,3,2,0
Jordan,2021,Friendly,18,14,7,5,2,14,4,0
Jordan,2022,AFC Asian Cup qualification,6,0,3,0,0,3,6,0
Jordan,2022,Friendly,7,6,2,2,0,4,1,0
Jordan,2022,Jordan International Tournament,3,0,2,0,0,2,3,0
Jordan,2023,FIFA World Cup qualification,1,3,0,1,1,2,-2,0
Jordan,2023,Friendly,9,12,2,3,0,5,-3,0
Jordan,2024,AFC Asian Cup,13,8,4,2,1,7,5,0
Jordan,2024,FIFA World Cup qualification,24,6,6,1,3,10,18,0
Jordan,2024,Friendly,5,8,2,1,1,4,-3,0
Jordan,2025,FIFA World Cup qualification,4,2,1,0,1,2,2,0
Jordan,2025,Friendly,1,1,0,0,2,2,0,0
Kabylia,2018,CONIFA World Football Cup,8,15,1,3,2,6,-7,0
Kazakhstan,1979,Friendly,1,0,1,0,0,1,1,0
Kazakhstan,1992,Friendly,8,3,4,0,3,7,5,0
Kazakhstan,1994,Friendly,1,1,1,1,2,4,0,0
Kazakhstan,1995,Friendly,0,3,0,1,1,2,-3,0
Kazakhstan,1996,AFC Asian Cup qualification,1,6,1,3,0,4,-5,0
Kazakhstan,1996,Friendly,1,2,0,1,0,1,-1,0
Kazakhstan,1997,East Asian Games,33,6,2,0,2,4,27,0
Kazakhstan,1997,FIFA World Cup qualification,22,21,5,4,3,12,1,0
Kazakhstan,1997,Friendly,0,3,0,1,0,1,-3,0
Kazakhstan,1998,Asian Games,8,6,2,2,1,5,2,0
Kazakhstan,2000,AFC Asian Cup qualification,8,3,3,1,0,4,5,0
Kazakhstan,2000,Friendly,1,1,1,1,0,2,0,0
Kazakhstan,2000,WAFF Championship,3,9,1,2,0,3,-6,0
Kazakhstan,2001,FIFA World Cup qualification,20,2,4,0,2,6,18,0
Kazakhstan,2001,Friendly,0,0,0,0,1,1,0,0
Kazakhstan,2002,Friendly,2,3,0,1,1,2,-1,0
Kazakhstan,2003,Friendly,5,11,0,4,1,5,-6,0
Kazakhstan,2004,Cyprus International Tournament,5,8,0,2,1,3,-3,0
Kazakhstan,2004,FIFA World Cup qualification,2,10,0,4,0,4,-8,0
Kazakhstan,2004,Friendly,2,3,0,1,0,1,-1,0
Kazakhstan,2005,FIFA World Cup qualification,4,19,0,7,1,8,-15,0
Kazakhstan,2005,Friendly,0,4,0,1,0,1,-4,0
Kazakhstan,2006,Cyprus International Tournament,0,2,0,1,1,2,-2,0
Kazakhstan,2006,Friendly,5,3,2,1,1,4,2,0
Kazakhstan,2006,King's Cup,3,4,0,1,2,3,-1,0
Kazakhstan,2006,UEFA Euro qualification,1,7,0,3,2,5,-6,0
Kazakhstan,2007,Friendly,6,4,2,1,2,5,2,0
Kazakhstan,2007,UEFA Euro qualification,10,14,2,5,2,9,-4,0
Kazakhstan,2008,FIFA World Cup qualification,5,11,1,3,0,4,-6,0
Kazakhstan,2008,Friendly,0,11,0,4,1,5,-11,0
Kazakhstan,2009,FIFA World Cup qualification,6,18,1,5,0,6,-12,0
Kazakhstan,2009,Friendly,2,0,1,0,0,1,2,0
Kazakhstan,2010,Friendly,3,2,1,1,0,2,1,0
Kazakhstan,2010,UEFA Euro qualification,0,10,0,4,0,4,-10,0
Kazakhstan,2011,Friendly,2,2,0,0,2,2,0,0
Kazakhstan,2011,UEFA Euro qualification,6,14,1,4,1,6,-8,0
Kazakhstan,2012,FIFA World Cup qualification,1,8,0,3,1,4,-7,0
Kazakhstan,2012,Friendly,5,5,1,1,1,3,0,0
Kazakhstan,2013,FIFA World Cup qualification,5,13,1,4,1,6,-8,0
Kazakhstan,2013,Friendly,5,3,2,1,0,3,2,0
Kazakhstan,2014,Friendly,10,6,2,1,1,4,4,0
Kazakhstan,2014,UEFA Euro qualification,4,10,0,3,1,4,-6,0
Kazakhstan,2015,Friendly,1,1,0,0,3,3,0,0
Kazakhstan,2015,UEFA Euro qualification,3,8,1,4,1,6,-5,0
Kazakhstan,2016,FIFA World Cup qualification,3,11,0,2,2,4,-8,0
Kazakhstan,2016,Friendly,3,3,2,1,1,4,0,0
Kazakhstan,2017,FIFA World Cup qualification,3,15,0,5,1,6,-12,0
Kazakhstan,2017,Friendly,1,3,0,1,0,1,-2,0
Kazakhstan,2018,Friendly,7,4,2,1,0,3,3,0
Kazakhstan,2018,UEFA Nations League,8,7,1,2,3,6,1,0
Kazakhstan,2019,Friendly,1,0,1,0,0,1,1,0
Kazakhstan,2019,UEFA Euro qualification,13,17,3,6,1,10,-4,0
Kazakhstan,2020,Friendly,0,0,0,0,1,1,0,0
Kazakhstan,2020,UEFA Nations League,5,9,1,4,1,6,-4,0
Kazakhstan,2021,FIFA World Cup qualification,5,20,0,5,3,8,-15,0
Kazakhstan,2021,Friendly,1,4,1,1,0,2,-3,0
Kazakhstan,2022,Friendly,1,4,0,2,0,2,-3,0
Kazakhstan,2022,UEFA Nations League,10,8,5,2,1,8,2,0
Kazakhstan,2023,UEFA Euro qualification,16,12,6,4,0,10,4,0
Kazakhstan,2024,Friendly,5,5,1,2,0,3,0,0
Kazakhstan,2024,UEFA Euro qualification,0,5,0,1,0,1,-5,0
Kazakhstan,2024,UEFA Nations League,0,15,0,5,1,6,-15,0
Kazakhstan,2025,FIFA World Cup qualification,3,3,1,1,0,2,0,0
Kazakhstan,2025,Friendly,2,0,1,0,0,1,2,0
Kenya,1926,Friendly,3,2,1,0,1,2,1,0
Kenya,1928,Friendly,0,4,0,1,0,1,-4,0
Kenya,1929,Friendly,3,5,0,1,0,1,-2,0
Kenya,1930,Friendly,0,5,0,1,1,2,-5,0
Kenya,1931,Friendly,2,1,1,0,0,1,1,0
Kenya,1932,Friendly,1,13,0,1,0,1,-12,0
Kenya,1935,Friendly,2,8,0,2,0,2,-6,0
Kenya,1937,Friendly,5,9,0,1,0,1,-4,0
Kenya,1938,Friendly,1,3,0,1,0,1,-2,0
Kenya,1939,Friendly,2,5,0,1,0,1,-3,0
Kenya,1940,Friendly,3,6,0,1,0,1,-3,0
Kenya,1941,Friendly,4,3,1,0,0,1,1,0
Kenya,1942,Friendly,4,3,1,0,0,1,1,0
Kenya,1943,Friendly,1,2,0,1,0,1,-1,0
Kenya,1944,Friendly,2,1,1,0,0,1,1,0
Kenya,1945,Friendly,1,4,0,1,0,1,-3,0
Kenya,1946,Friendly,5,1,2,0,0,2,4,0
Kenya,1947,Friendly,2,3,0,1,0,1,-1,0
Kenya,1948,Friendly,4,3,1,1,0,2,1,0
Kenya,1949,Friendly,3,4,1,1,0,2,-1,0
Kenya,1950,Friendly,5,4,1,1,1,3,1,0
Kenya,1951,Friendly,4,4,1,1,0,2,0,0
Kenya,1952,Friendly,10,7,1,1,0,2,3,0
Kenya,1953,Friendly,13,3,2,0,0,2,10,0
Kenya,1954,Friendly,8,6,1,1,1,3,2,0
Kenya,1955,Friendly,8,1,1,1,0,2,7,0
Kenya,1956,Friendly,11,3,1,1,0,2,8,0
Kenya,1957,Friendly,6,3,1,1,0,2,3,0
Kenya,1958,Friendly,9,1,3,0,0,3,8,0
Kenya,1959,Friendly,8,0,3,0,1,4,8,0
Kenya,1960,Friendly,10,2,2,0,1,3,8,0
Kenya,1961,African Cup of Nations qualification,1,3,1,2,0,3,-2,0
Kenya,1961,Friendly,26,7,5,1,1,7,19,0
Kenya,1962,Friendly,18,23,3,4,0,7,-5,0
Kenya,1963,African Cup of Nations qualification,0,6,0,2,0,2,-6,0
Kenya,1963,Friendly,15,8,4,2,1,7,7,0
Kenya,1964,Friendly,11,13,2,3,0,5,-2,0
Kenya,1964,Zambian Independence Tournament,5,5,1,1,0,2,0,1
Kenya,1965,Friendly,24,31,3,3,3,9,-7,0
Kenya,1966,Friendly,23,19,6,3,2,11,4,1
Kenya,1967,African Cup of Nations qualification,4,5,0,1,1,2,-1,0
Kenya,1967,Friendly,23,18,5,3,1,9,5,0
Kenya,1968,Friendly,13,10,2,1,4,7,3,0
Kenya,1969,African Cup of Nations qualification,1,2,0,1,1,2,-1,0
Kenya,1969,Friendly,4,7,2,3,0,5,-3,0
Kenya,1970,African Cup of Nations qualification,3,0,2,0,0,2,3,0
Kenya,1970,Friendly,3,7,0,3,0,3,-4,0
Kenya,1971,African Cup of Nations qualification,2,1,1,0,1,2,1,0
Kenya,1971,Friendly,18,11,6,2,2,10,7,0
Kenya,1972,African Cup of Nations,3,4,0,1,2,3,-1,0
Kenya,1972,FIFA World Cup qualification,7,4,2,1,1,4,3,0
Kenya,1972,Friendly,5,5,2,2,0,4,0,0
Kenya,1973,African Cup of Nations qualification,1,3,0,2,0,2,-2,0
Kenya,1973,CECAFA Cup,3,2,1,1,0,2,1,0
Kenya,1973,FIFA World Cup qualification,2,4,0,1,1,2,-2,0
Kenya,1973,Friendly,5,3,1,0,1,2,2,0
Kenya,1974,CECAFA Cup,2,3,0,1,0,1,-1,0
Kenya,1974,Friendly,2,3,0,1,0,1,-1,0
Kenya,1975,African Cup of Nations qualification,0,3,0,2,0,2,-3,0
Kenya,1975,CECAFA Cup,8,6,2,0,2,4,2,0
Kenya,1975,Friendly,12,10,4,1,1,6,2,0
Kenya,1976,CECAFA Cup,3,5,0,1,2,3,-2,0
Kenya,1976,Friendly,8,4,2,1,1,4,4,0
Kenya,1977,African Cup of Nations qualification,3,5,1,1,0,2,-2,0
Kenya,1977,CECAFA Cup,7,9,1,3,0,4,-2,0
Kenya,1977,FIFA World Cup qualification,0,1,0,1,1,2,-1,0
Kenya,1977,Friendly,1,1,0,0,1,1,0,0
Kenya,1978,CECAFA Cup,3,13,2,4,0,6,-10,0
Kenya,1978,Friendly,2,4,2,2,1,5,-2,0
Kenya,1979,African Cup of Nations qualification,3,4,1,1,0,2,-1,0
Kenya,1979,CECAFA Cup,10,5,3,1,1,5,5,0
Kenya,1979,Friendly,2,7,0,2,2,4,-5,0
Kenya,1980,CECAFA Cup,1,3,0,2,0,2,-2,0
Kenya,1980,FIFA World Cup qualification,3,6,1,1,0,2,-3,0
Kenya,1980,Friendly,5,7,2,1,1,4,-2,0
Kenya,1981,African Cup of Nations qualification,3,7,0,2,0,2,-4,0
Kenya,1981,CECAFA Cup,7,3,4,1,0,5,4,1
Kenya,1981,Friendly,7,5,3,1,1,5,2,0
Kenya,1982,CECAFA Cup,7,4,2,0,2,4,3,0
Kenya,1983,CECAFA Cup,8,1,5,0,1,6,7,1
Kenya,1983,Friendly,8,7,2,1,4,7,1,0
Kenya,1984,African Cup of Nations qualification,1,1,1,1,0,2,0,0
Kenya,1984,CECAFA Cup,4,8,1,3,1,5,-4,0
Kenya,1984,FIFA World Cup qualification,5,4,1,0,1,2,1,0
Kenya,1984,Friendly,5,8,1,3,1,5,-3,0
Kenya,1985,African Cup of Nations qualification,0,3,0,1,1,2,-3,0
Kenya,1985,CECAFA Cup,4,5,1,1,2,4,-1,0
Kenya,1985,FIFA World Cup qualification,1,6,0,2,0,2,-5,0
Kenya,1985,Friendly,0,2,0,2,0,2,-2,0
Kenya,1986,Friendly,5,7,1,2,0,3,-2,0
Kenya,1987,African Cup of Nations qualification,4,3,1,1,2,4,1,0
Kenya,1987,All-African Games,7,6,2,1,2,5,1,0
Kenya,1987,CECAFA Cup,4,4,1,1,1,3,0,0
Kenya,1988,African Cup of Nations,0,6,0,2,1,3,-6,0
Kenya,1988,CECAFA Cup,4,4,2,2,1,5,0,0
Kenya,1989,African Cup of Nations qualification,4,3,2,1,1,4,1,0
Kenya,1989,CECAFA Cup,7,4,4,1,0,5,3,0
Kenya,1989,FIFA World Cup qualification,2,4,1,2,3,6,-2,0
Kenya,1989,Friendly,0,1,0,1,0,1,-1,0
Kenya,1990,African Cup of Nations,0,3,0,2,1,3,-3,0
Kenya,1990,African Cup of Nations qualification,1,2,0,1,0,1,-1,0
Kenya,1990,CECAFA Cup,3,4,0,1,1,2,-1,0
Kenya,1990,King's Cup,4,4,1,1,0,2,0,0
Kenya,1991,African Cup of Nations qualification,3,2,2,1,0,3,1,0
Kenya,1991,CECAFA Cup,7,6,3,2,0,5,1,0
Kenya,1991,Friendly,7,4,2,0,3,5,3,0
Kenya,1992,African Cup of Nations,1,5,0,2,0,2,-4,0
Kenya,1992,African Cup of Nations qualification,3,5,0,1,1,2,-2,0
Kenya,1992,CECAFA Cup,3,2,1,0,1,2,1,0
Kenya,1992,FIFA World Cup qualification,0,4,0,1,0,1,-4,0
Kenya,1992,Friendly,4,1,2,0,0,2,3,0
Kenya,1993,African Cup of Nations qualification,8,1,3,0,1,4,7,0
Kenya,1993,FIFA World Cup qualification,2,0,1,0,0,1,2,0
Kenya,1993,Friendly,4,2,2,0,0,2,2,0
Kenya,1994,CECAFA Cup,8,4,3,2,0,5,4,1
Kenya,1994,Friendly,0,3,0,2,0,2,-3,0
Kenya,1995,CECAFA Cup,5,1,3,0,1,4,4,1
Kenya,1996,CECAFA Cup,3,3,2,1,0,3,0,0
Kenya,1996,FIFA World Cup qualification,4,5,1,2,0,3,-1,0
Kenya,1996,Friendly,5,5,2,1,2,5,0,0
Kenya,1996,Simba Tournament,0,6,0,3,0,3,-6,0
Kenya,1997,African Cup of Nations qualification,1,2,0,1,1,2,-1,0
Kenya,1997,FIFA World Cup qualification,10,9,3,1,1,5,1,0
Kenya,1997,Friendly,2,3,2,1,1,4,-1,0
Kenya,1998,African Cup of Nations qualification,13,2,2,0,1,3,11,0
Kenya,1998,Friendly,5,4,1,0,2,3,1,0
Kenya,1999,African Cup of Nations qualification,2,6,0,4,1,5,-4,0
Kenya,1999,CECAFA Cup,4,0,2,0,0,2,4,1
Kenya,1999,Friendly,4,5,0,1,3,4,-1,0
Kenya,2000,African Cup of Nations qualification,5,4,1,2,1,4,1,0
Kenya,2000,CECAFA Cup,1,2,0,1,0,1,-1,0
Kenya,2000,FIFA World Cup qualification,0,2,0,1,1,2,-2,0
Kenya,2000,Friendly,11,11,2,4,3,9,0,0
Kenya,2001,African Cup of Nations qualification,5,7,1,1,2,4,-2,0
Kenya,2001,CECAFA Cup,7,3,3,1,1,5,4,0
Kenya,2001,Friendly,5,5,2,1,2,5,0,0
Kenya,2002,African Cup of Nations qualification,4,0,2,0,0,2,4,0
Kenya,2002,CECAFA Cup,12,6,4,1,1,6,6,0
Kenya,2002,Friendly,9,6,2,1,5,8,3,0
Kenya,2003,African Cup of Nations qualification,5,2,2,1,1,4,3,0
Kenya,2003,CECAFA Cup,7,5,2,0,2,4,2,0
Kenya,2003,FIFA World Cup qualification,3,0,1,0,1,2,3,0
Kenya,2003,Friendly,14,7,3,0,4,7,7,0
Kenya,2003,Prime Minister's Cup,1,5,0,3,0,3,-4,0
Kenya,2004,African Cup of Nations,4,6,1,2,0,3,-2,0
Kenya,2004,CECAFA Cup,7,7,1,1,3,5,0,0
Kenya,2004,FIFA World Cup qualification,6,5,2,1,0,3,1,0
Kenya,2004,Friendly,5,6,1,2,1,4,-1,0
Kenya,2005,FIFA World Cup qualification,2,12,1,5,1,7,-10,0
Kenya,2005,Friendly,3,3,0,0,2,2,0,0
Kenya,2006,African Cup of Nations qualification,2,5,0,2,0,2,-3,0
Kenya,2006,Friendly,0,2,0,2,1,3,-2,0
Kenya,2007,African Cup of Nations qualification,4,2,2,1,1,4,2,0
Kenya,2007,CECAFA Cup,4,4,1,2,1,4,0,0
Kenya,2007,Friendly,5,4,1,1,2,4,1,0
Kenya,2008,CECAFA Cup,0,0,0,0,1,1,0,0
Kenya,2008,FIFA World Cup qualification,8,5,3,2,1,6,3,0
Kenya,2009,CECAFA Cup,12,6,5,3,1,9,6,0
Kenya,2009,FIFA World Cup qualification,5,11,1,5,0,6,-6,0
Kenya,2009,Friendly,1,9,0,4,1,5,-8,0
Kenya,2010,African Cup of Nations qualification,0,1,0,1,1,2,-1,0
Kenya,2010,CECAFA Cup,3,7,0,3,0,3,-4,0
Kenya,2010,Friendly,6,8,1,3,1,5,-2,0
Kenya,2011,African Cup of Nations qualification,4,3,2,1,1,4,1,0
Kenya,2011,CECAFA Cup,2,3,1,2,0,3,-1,0
Kenya,2011,FIFA World Cup qualification,7,0,2,0,0,2,7,0
Kenya,2011,Friendly,1,8,0,4,0,4,-7,0
Kenya,2011,Nile Basin Tournament,2,7,1,3,0,4,-5,0
Kenya,2012,African Cup of Nations qualification,2,2,1,1,0,2,0,0
Kenya,2012,CECAFA Cup,9,6,3,2,1,6,3,0
Kenya,2012,FIFA World Cup qualification,0,1,0,1,1,2,-1,0
Kenya,2012,Friendly,4,9,1,3,0,4,-5,0
Kenya,2013,CECAFA Cup,9,1,5,0,1,6,8,0
Kenya,2013,COSAFA Cup,5,4,1,1,1,3,1,0
Kenya,2013,FIFA World Cup qualification,4,4,1,1,2,4,0,0
Kenya,2013,Friendly,3,0,1,0,0,1,3,0
Kenya,2014,African Cup of Nations qualification,2,2,1,1,2,4,0,0
Kenya,2014,Friendly,0,4,0,2,1,3,-4,0
Kenya,2015,African Cup of Nations qualification,2,3,0,1,1,2,-1,0
Kenya,2015,CECAFA Cup,4,4,1,1,2,4,0,0
Kenya,2015,FIFA World Cup qualification,6,4,2,1,1,4,2,0
Kenya,2015,Friendly,2,0,1,0,1,2,2,0
Kenya,2016,African Cup of Nations qualification,3,4,1,2,1,4,-1,0
Kenya,2016,Friendly,5,2,3,0,3,6,3,0
Kenya,2017,CECAFA Cup,6,2,3,0,3,6,4,0
Kenya,2017,Friendly,6,7,1,2,3,6,-1,0
Kenya,2018,African Cup of Nations qualification,4,0,2,0,1,3,4,0
Kenya,2018,Friendly,6,6,2,2,1,5,0,0
Kenya,2018,Intercontinental Cup,6,6,2,2,0,4,0,0
Kenya,2019,African Cup of Nations,3,7,1,2,0,3,-4,0
Kenya,2019,African Cup of Nations qualification,2,3,0,1,2,3,-1,0
Kenya,2019,Friendly,3,3,1,1,2,4,0,0
Kenya,2020,African Cup of Nations qualification,2,3,0,1,1,2,-1,0
Kenya,2020,Friendly,2,1,1,0,0,1,1,0
Kenya,2021,African Cup of Nations qualification,3,2,1,0,1,2,1,0
Kenya,2021,FIFA World Cup qualification,4,9,1,2,3,6,-5,0
Kenya,2021,Friendly,3,1,2,0,0,2,2,0
Kenya,2023,FIFA World Cup qualification,6,2,1,1,0,2,4,0
Kenya,2023,Friendly,5,6,1,2,1,4,-1,0
Kenya,2023,Mauritius Four Nations Cup,1,1,1,1,0,2,0,0
Kenya,2024,African Cup of Nations qualification,3,6,1,2,1,4,-3,0
Kenya,2024,FIFA World Cup qualification,1,1,0,0,2,2,0,0
Kenya,2025,FIFA World Cup qualification,4,5,0,1,1,2,-1,0
Kenya,2025,Mapinduzi Cup,3,2,1,1,1,3,1,0
Kernow,1953,Friendly,6,11,0,2,1,3,-5,0
Kernow,1998,Friendly,6,1,1,0,0,1,5,0
Kernow,2000,Friendly,1,2,0,1,0,1,-1,0
Kernow,2002,Friendly,3,0,1,0,0,1,3,0
Kernow,2003,Friendly,1,0,1,0,0,1,1,0
Kernow,2004,Friendly,4,1,1,0,0,1,3,0
Kernow,2005,Friendly,3,2,1,0,0,1,1,0
Kernow,2007,Friendly,1,1,0,0,1,1,0,0
Kernow,2019,Friendly,5,0,1,0,0,1,5,0
Kernow,2023,CONIFA World Football Cup qualification,2,1,1,0,0,1,1,1
Kiribati,1979,South Pacific Games,3,40,0,2,1,3,-37,0
Kiribati,2003,South Pacific Games,2,40,0,4,0,4,-38,0
Kiribati,2011,Pacific Games,2,46,0,4,0,4,-44,0
Kosovo,2006,Friendly,7,1,1,0,0,1,6,0
Kosovo,2014,Friendly,3,9,1,2,1,4,-6,0
Kosovo,2015,Friendly,4,2,1,0,1,2,2,0
Kosovo,2016,FIFA World Cup qualification,1,12,0,3,1,4,-11,0
Kosovo,2016,Friendly,2,0,1,0,0,1,2,0
Kosovo,2017,FIFA World Cup qualification,2,12,0,6,0,6,-10,0
Kosovo,2017,Friendly,4,3,1,0,0,1,1,0
Kosovo,2018,Friendly,6,0,3,0,0,3,6,0
Kosovo,2018,UEFA Nations League,15,2,4,0,2,6,13,1
Kosovo,2019,Friendly,3,2,1,0,1,2,1,0
Kosovo,2019,UEFA Euro qualification,13,16,3,3,2,8,-3,0
Kosovo,2020,Friendly,1,3,0,2,0,2,-2,0
Kosovo,2020,UEFA Euro qualification,1,2,0,1,0,1,-1,0
Kosovo,2020,UEFA Nations League,4,6,1,3,2,6,-2,0
Kosovo,2021,FIFA World Cup qualification,5,15,1,5,2,8,-10,0
Kosovo,2021,Friendly,12,6,4,2,0,6,6,0
Kosovo,2022,Friendly,9,4,1,0,3,4,5,0
Kosovo,2022,UEFA Nations League,11,8,3,3,0,6,3,0
Kosovo,2023,UEFA Euro qualification,10,10,2,3,5,10,0,0
Kosovo,2024,Friendly,1,5,1,2,0,3,-4,0
Kosovo,2024,UEFA Nations League,10,4,4,1,1,6,6,0
Kosovo,2025,UEFA Nations League,5,2,2,0,0,2,3,0
Kuwait,1963,Arab Cup,5,15,1,3,0,4,-10,0
Kuwait,1963,Friendly,3,3,1,1,0,2,0,0
Kuwait,1964,Arab Cup,5,5,1,2,1,4,0,0
Kuwait,1965,Friendly,1,6,0,2,0,2,-5,0
Kuwait,1966,Arab Cup,10,9,1,2,1,4,1,0
Kuwait,1970,Gulf Cup,10,4,3,0,0,3,6,1
Kuwait,1971,AFC Asian Cup qualification,6,4,2,1,2,5,2,0
Kuwait,1971,Friendly,1,5,0,2,0,2,-4,0
Kuwait,1972,AFC Asian Cup,4,5,2,1,0,3,-1,0
Kuwait,1972,Gulf Cup,16,2,3,0,1,4,14,0
Kuwait,1972,Palestine Cup,4,7,1,2,0,3,-3,0
Kuwait,1973,FIFA World Cup qualification,4,8,1,4,1,6,-4,0
Kuwait,1973,Friendly,13,1,2,0,0,2,12,0
Kuwait,1973,Merdeka Tournament,8,7,4,2,1,7,1,0
Kuwait,1974,Asian Games,12,8,3,2,0,5,4,0
Kuwait,1974,Friendly,4,7,1,3,0,4,-3,0
Kuwait,1974,Gulf Cup,18,0,5,0,0,5,18,1
Kuwait,1975,Friendly,4,3,1,0,1,2,1,0
Kuwait,1976,AFC Asian Cup,6,3,3,1,0,4,3,0
Kuwait,1976,Gulf Cup,26,7,5,0,2,7,19,1
Kuwait,1977,FIFA World Cup qualification,23,10,8,3,1,12,13,0
Kuwait,1977,Friendly,0,0,0,0,2,2,0,0
Kuwait,1978,Asian Games,13,8,3,2,1,6,5,0
Kuwait,1979,Gulf Cup,15,4,4,1,1,6,11,0
Kuwait,1980,AFC Asian Cup,13,6,4,1,1,6,7,1
Kuwait,1980,Friendly,1,1,0,0,1,1,0,0
Kuwait,1980,Merdeka Tournament,6,17,1,6,0,7,-11,0
Kuwait,1981,FIFA World Cup qualification,20,6,7,1,1,9,14,0
Kuwait,1982,Asian Games,13,5,5,1,0,6,8,0
Kuwait,1982,FIFA World Cup,2,6,0,2,1,3,-4,0
Kuwait,1982,Friendly,1,0,1,0,1,2,1,0
Kuwait,1982,Gulf Cup,8,2,4,1,0,5,6,0
Kuwait,1984,AFC Asian Cup,5,4,2,2,2,6,1,0
Kuwait,1984,Friendly,2,1,1,0,1,2,1,0
Kuwait,1984,Gulf Cup,4,8,1,3,2,6,-4,0
Kuwait,1985,FIFA World Cup qualification,8,2,2,1,1,4,6,0
Kuwait,1985,Friendly,1,1,0,0,2,2,0,0
Kuwait,1986,Asian Games,20,3,5,0,2,7,17,0
Kuwait,1986,Friendly,1,0,1,0,0,1,1,0
Kuwait,1986,Gulf Cup,11,4,5,0,1,6,7,0
Kuwait,1987,Friendly,5,4,2,2,1,5,1,0
Kuwait,1988,AFC Asian Cup,2,3,0,1,3,4,-1,0
Kuwait,1988,AFC Asian Cup qualification,9,0,3,0,1,4,9,0
Kuwait,1988,Friendly,2,5,0,2,3,5,-3,0
Kuwait,1988,Gulf Cup,3,4,1,3,2,6,-1,0
Kuwait,1989,FIFA World Cup qualification,6,3,3,1,0,4,3,0
Kuwait,1989,Friendly,13,6,4,2,3,9,7,0
Kuwait,1990,Asian Games,3,4,1,2,1,4,-1,0
Kuwait,1990,Friendly,2,5,0,3,1,4,-3,0
Kuwait,1990,Gulf Cup,10,2,3,0,1,4,8,1
Kuwait,1991,Friendly,0,2,0,1,0,1,-2,0
Kuwait,1992,Arab Cup,6,5,2,2,0,4,1,1
Kuwait,1992,Friendly,7,3,1,0,5,6,4,0
Kuwait,1992,Gulf Cup,5,8,2,3,0,5,-3,0
Kuwait,1993,FIFA World Cup qualification,21,4,3,1,2,6,17,0
Kuwait,1993,Friendly,12,8,5,2,1,8,4,0
Kuwait,1994,Asian Games,15,6,4,1,1,6,9,0
Kuwait,1994,Friendly,4,3,1,1,2,4,1,0
Kuwait,1994,Gulf Cup,2,6,1,3,1,5,-4,0
Kuwait,1995,Friendly,3,3,1,1,1,3,0,0
Kuwait,1996,AFC Asian Cup,9,7,2,2,2,6,2,0
Kuwait,1996,AFC Asian Cup qualification,9,5,2,0,2,4,4,0
Kuwait,1996,Friendly,17,14,5,4,2,11,3,0
Kuwait,1996,Gulf Cup,7,4,4,1,0,5,3,0
Kuwait,1997,FIFA World Cup qualification,17,9,6,4,2,12,8,0
Kuwait,1997,Friendly,8,7,3,2,0,5,1,0
Kuwait,1998,Arab Cup,9,3,2,1,0,3,6,0
Kuwait,1998,Asian Games,23,8,3,3,2,8,15,0
Kuwait,1998,Friendly,9,4,2,1,3,6,5,0
Kuwait,1998,Gulf Cup,18,5,4,1,0,5,13,0
Kuwait,1999,Friendly,1,2,0,1,0,1,-1,0
Kuwait,2000,AFC Asian Cup,3,3,1,1,2,4,0,0
Kuwait,2000,AFC Asian Cup qualification,33,1,4,0,0,4,32,0
Kuwait,2000,Friendly,9,6,2,1,2,5,3,0
Kuwait,2000,United Arab Emirates Friendship Tournament,0,2,0,2,0,2,-2,0
Kuwait,2001,FIFA World Cup qualification,9,3,4,1,1,6,6,0
Kuwait,2001,Friendly,15,15,2,3,5,10,0,0
Kuwait,2002,Arab Cup,5,5,1,1,1,3,0,0
Kuwait,2002,Friendly,4,10,1,2,1,4,-6,0
Kuwait,2002,Gulf Cup,4,6,1,2,2,5,-2,0
Kuwait,2003,AFC Asian Cup qualification,17,5,5,0,1,6,12,0
Kuwait,2003,Friendly,4,8,2,1,1,4,-4,0
Kuwait,2003,Gulf Cup,0,2,0,1,1,2,-2,0
Kuwait,2004,AFC Asian Cup,3,7,1,2,0,3,-4,0
Kuwait,2004,FIFA World Cup qualification,15,2,5,1,0,6,13,0
Kuwait,2004,Friendly,17,11,4,3,5,12,6,0
Kuwait,2004,Gulf Cup,13,14,3,4,2,9,-1,0
Kuwait,2005,FIFA World Cup qualification,4,13,1,4,1,6,-9,0
Kuwait,2005,Friendly,8,7,2,2,4,8,1,0
Kuwait,2006,AFC Asian Cup qualification,4,5,1,2,2,5,-1,0
Kuwait,2006,Friendly,13,1,3,0,0,3,12,0
Kuwait,2007,Friendly,2,2,0,0,2,2,0,0
Kuwait,2007,Gulf Cup,4,6,0,2,1,3,-2,0
Kuwait,2008,FIFA World Cup qualification,8,12,1,4,1,6,-4,0
Kuwait,2008,Friendly,6,11,1,4,4,9,-5,0
Kuwait,2009,AFC Asian Cup qualification,4,3,2,1,1,4,1,0
Kuwait,2009,Friendly,16,11,4,4,4,12,5,0
Kuwait,2009,Gulf Cup,2,2,1,1,2,4,0,0
Kuwait,2010,AFC Asian Cup qualification,2,2,0,0,2,2,0,0
Kuwait,2010,Friendly,31,15,6,2,4,12,16,0
Kuwait,2010,Gulf Cup,7,2,3,0,2,5,5,1
Kuwait,2010,WAFF Championship,7,5,2,0,2,4,2,1
Kuwait,2011,AFC Asian Cup,1,7,0,3,0,3,-6,0
Kuwait,2011,FIFA World Cup qualification,13,8,4,1,2,7,5,0
Kuwait,2011,Friendly,12,4,4,2,4,10,8,0
Kuwait,2012,Arab Cup,2,4,1,1,0,2,-2,0
Kuwait,2012,FIFA World Cup qualification,0,2,0,1,0,1,-2,0
Kuwait,2012,Friendly,8,13,3,3,4,10,-5,0
Kuwait,2012,WAFF Championship,4,4,2,1,0,3,0,0
Kuwait,2013,AFC Asian Cup qualification,8,4,2,0,3,5,4,0
Kuwait,2013,Friendly,10,5,4,1,1,6,5,0
Kuwait,2013,Gulf Cup,9,3,3,2,0,5,6,1
Kuwait,2013,WAFF Championship,2,0,1,0,0,1,2,0
Kuwait,2014,AFC Asian Cup qualification,2,3,0,1,0,1,-1,0
Kuwait,2014,Friendly,12,12,3,2,5,10,0,0
Kuwait,2014,Gulf Cup,3,7,1,1,1,3,-4,0
Kuwait,2014,WAFF Championship,1,5,0,2,1,3,-4,0
Kuwait,2015,AFC Asian Cup,1,6,0,3,0,3,-5,0
Kuwait,2015,FIFA World Cup qualification,12,4,3,2,1,6,8,0
Kuwait,2015,Friendly,3,5,0,1,1,2,-2,0
Kuwait,2017,Friendly,0,0,0,0,1,1,0,0
Kuwait,2017,Gulf Cup,1,3,0,2,1,3,-2,0
Kuwait,2018,Friendly,10,13,3,4,2,9,-3,0
Kuwait,2019,FIFA World Cup qualification,17,3,3,1,1,5,14,0
Kuwait,2019,Friendly,2,1,1,0,2,3,1,0
Kuwait,2019,Gulf Cup,6,7,1,2,0,3,-1,0
Kuwait,2019,WAFF Championship,3,3,1,1,1,3,0,0
Kuwait,2021,Arab Cup qualification,0,2,0,1,0,1,-2,0
Kuwait,2021,FIFA World Cup qualification,2,4,1,1,1,3,-2,0
Kuwait,2021,Friendly,3,14,0,5,2,7,-11,0
Kuwait,2022,AFC Asian Cup qualification,5,6,1,2,0,3,-1,0
Kuwait,2022,Friendly,7,6,3,3,1,7,1,0
Kuwait,2023,FIFA World Cup qualification,4,1,1,1,0,2,3,0
Kuwait,2023,Friendly,10,7,4,2,0,6,3,0
Kuwait,2023,Gulf Cup,2,3,1,1,1,3,-1,0
Kuwait,2023,SAFF Cup,10,3,3,0,2,5,7,0
Kuwait,2024,FIFA World Cup qualification,7,16,1,4,5,10,-9,0
Kuwait,2024,Friendly,1,5,0,2,0,2,-4,0
Kuwait,2024,Gulf Cup,4,4,1,1,2,4,0,0
Kuwait,2025,FIFA World Cup qualification,2,3,0,1,1,2,-1,0
Kyrgyzstan,1956,Friendly,0,1,0,1,0,1,-1,0
Kyrgyzstan,1979,Friendly,0,0,0,0,1,1,0,0
Kyrgyzstan,1992,Friendly,3,16,0,4,1,5,-13,0
Kyrgyzstan,1993,Friendly,3,4,0,1,1,2,-1,0
Kyrgyzstan,1994,Friendly,1,9,0,3,1,4,-8,0
Kyrgyzstan,1996,AFC Asian Cup qualification,3,7,1,3,0,4,-4,0
Kyrgyzstan,1997,FIFA World Cup qualification,12,11,3,2,0,5,1,0
Kyrgyzstan,1999,AFC Asian Cup qualification,3,11,0,3,0,3,-8,0
Kyrgyzstan,2000,Friendly,0,1,0,1,0,1,-1,0
Kyrgyzstan,2000,WAFF Championship,0,8,0,3,0,3,-8,0
Kyrgyzstan,2001,FIFA World Cup qualification,3,9,1,4,1,6,-6,0
Kyrgyzstan,2001,Friendly,1,3,0,1,0,1,-2,0
Kyrgyzstan,2003,AFC Asian Cup qualification,3,2,1,1,0,2,1,0
Kyrgyzstan,2003,FIFA World Cup qualification,6,0,2,0,0,2,6,0
Kyrgyzstan,2004,FIFA World Cup qualification,5,12,1,4,1,6,-7,0
Kyrgyzstan,2004,Friendly,0,3,0,1,1,2,-3,0
Kyrgyzstan,2006,AFC Challenge Cup,4,3,3,2,0,5,1,0
Kyrgyzstan,2006,ELF Cup,11,7,2,2,1,5,4,0
Kyrgyzstan,2006,Friendly,2,4,0,2,0,2,-2,0
Kyrgyzstan,2007,FIFA World Cup qualification,2,2,1,1,0,2,0,0
Kyrgyzstan,2007,Friendly,0,9,0,3,0,3,-9,0
Kyrgyzstan,2007,Nehru Cup,8,10,2,2,0,4,-2,0
Kyrgyzstan,2008,AFC Challenge Cup qualification,2,2,1,1,0,2,0,0
Kyrgyzstan,2008,Friendly,0,2,0,1,0,1,-2,0
Kyrgyzstan,2009,AFC Challenge Cup qualification,2,2,0,0,2,2,0,0
Kyrgyzstan,2009,Friendly,0,3,0,1,0,1,-3,0
Kyrgyzstan,2009,Nehru Cup,6,6,1,2,1,4,0,0
Kyrgyzstan,2010,AFC Challenge Cup,0,5,0,2,0,2,-5,0
Kyrgyzstan,2011,AFC Challenge Cup qualification,5,6,1,2,0,3,-1,0
Kyrgyzstan,2011,FIFA World Cup qualification,0,7,0,2,0,2,-7,0
Kyrgyzstan,2012,Friendly,2,5,0,1,0,1,-3,0
Kyrgyzstan,2013,AFC Challenge Cup qualification,3,0,3,0,0,3,3,0
Kyrgyzstan,2013,Friendly,4,14,0,4,2,6,-10,0
Kyrgyzstan,2014,AFC Challenge Cup,1,3,1,2,0,3,-2,0
Kyrgyzstan,2014,Friendly,3,10,0,2,2,4,-7,0
Kyrgyzstan,2015,FIFA World Cup qualification,9,8,3,2,2,7,1,0
Kyrgyzstan,2016,FIFA World Cup qualification,1,0,1,0,0,1,1,0
Kyrgyzstan,2016,Friendly,4,9,2,3,2,7,-5,0
Kyrgyzstan,2017,AFC Asian Cup qualification,7,6,2,1,1,4,1,0
Kyrgyzstan,2017,Friendly,8,0,3,0,0,3,8,0
Kyrgyzstan,2018,AFC Asian Cup qualification,7,2,2,0,0,2,5,0
Kyrgyzstan,2018,Friendly,7,7,4,2,1,7,0,0
Kyrgyzstan,2018,Kirin Challenge Cup,0,4,0,1,0,1,-4,0
Kyrgyzstan,2019,AFC Asian Cup,6,7,1,3,0,4,-1,0
Kyrgyzstan,2019,FIFA World Cup qualification,10,5,2,2,1,5,5,0
Kyrgyzstan,2019,Friendly,3,5,0,1,1,2,-2,0
Kyrgyzstan,2021,FIFA World Cup qualification,9,7,1,2,0,3,2,0
Kyrgyzstan,2021,Friendly,4,5,1,1,0,2,-1,0
Kyrgyzstan,2021,Three Nations Cup,5,1,2,0,0,2,4,1
Kyrgyzstan,2022,AFC Asian Cup qualification,4,1,2,0,1,3,3,0
Kyrgyzstan,2022,Friendly,1,2,0,1,0,1,-1,0
Kyrgyzstan,2022,Navruz Cup,1,4,0,2,0,2,-3,0
Kyrgyzstan,2023,CAFA Nations Cup,1,6,0,2,0,2,-5,0
Kyrgyzstan,2023,FIFA World Cup qualification,4,4,1,1,0,2,0,0
Kyrgyzstan,2023,Friendly,3,4,1,2,0,3,-1,0
Kyrgyzstan,2023,Tri Nation Tournament,1,3,0,1,1,2,-2,0
Kyrgyzstan,2024,AFC Asian Cup,1,5,0,2,1,3,-4,0
Kyrgyzstan,2024,FIFA World Cup qualification,15,16,3,5,2,10,-1,0
Kyrgyzstan,2024,Friendly,3,2,1,0,1,2,1,0
Kyrgyzstan,2025,FIFA World Cup qualification,3,2,1,1,0,2,1,0
Kárpátalja,2016,Hungary Heritage Cup,1,1,0,0,1,1,0,0
Kárpátalja,2017,CONIFA European Football Cup,9,7,1,1,2,4,2,0
Kárpátalja,2018,CONIFA World Football Cup,15,5,4,0,2,6,10,0
Laos,1961,Southeast Asian Peninsular Games,2,12,0,2,0,2,-10,0
Laos,1963,Friendly,1,24,0,2,0,2,-23,0
Laos,1967,Southeast Asian Peninsular Games,2,12,0,3,0,3,-10,0
Laos,1968,King's Cup,0,9,0,3,0,3,-9,0
Laos,1969,King's Cup,6,16,1,3,1,5,-10,0
Laos,1969,Southeast Asian Peninsular Games,1,6,0,2,1,3,-5,0
Laos,1970,King's Cup,5,9,1,3,0,4,-4,0
Laos,1971,Southeast Asian Peninsular Games,0,10,0,3,0,3,-10,0
Laos,1972,Indonesia Tournament,3,11,0,3,0,3,-8,0
Laos,1973,King's Cup,4,9,1,2,0,3,-5,0
Laos,1973,Southeast Asian Peninsular Games,1,13,0,2,0,2,-12,0
Laos,1974,King's Cup,3,10,0,2,1,3,-7,0
Laos,1974,Vietnam Independence Cup,1,3,0,2,1,3,-2,0
Laos,1993,Southeast Asian Games,5,22,1,3,0,4,-17,0
Laos,1995,Southeast Asian Games,4,1,2,1,1,4,3,0
Laos,1996,AFF Championship,5,10,1,2,1,4,-5,0
Laos,1997,Southeast Asian Games,8,8,2,2,0,4,0,0
Laos,1998,AFF Championship,2,8,0,2,1,3,-6,0
Laos,1998,AFF Championship qualification,2,4,1,1,0,2,-2,0
Laos,1998,Asian Games,1,11,0,2,0,2,-10,0
Laos,1999,Southeast Asian Games,4,15,1,2,1,4,-11,0
Laos,2000,AFC Asian Cup qualification,2,14,1,2,0,3,-12,0
Laos,2000,AFF Championship,0,16,0,4,0,4,-16,0
Laos,2001,FIFA World Cup qualification,3,40,1,4,1,6,-37,0
Laos,2002,AFF Championship,3,8,0,2,1,3,-5,0
Laos,2003,AFC Asian Cup qualification,3,6,1,1,0,2,-3,0
Laos,2003,FIFA World Cup qualification,0,3,0,1,1,2,-3,0
Laos,2004,AFF Championship,4,16,1,3,0,4,-12,0
Laos,2004,FIFA World Cup qualification,3,33,0,6,0,6,-30,0
Laos,2006,AFF Championship qualification,11,6,3,0,1,4,5,0
Laos,2007,AFF Championship,1,23,0,3,0,3,-22,0
Laos,2007,Merdeka Tournament,1,4,0,2,0,2,-3,0
Laos,2008,AFF Championship,0,13,0,3,0,3,-13,0
Laos,2008,AFF Championship qualification,9,7,3,1,0,4,2,1
Laos,2010,AFF Championship,3,13,0,2,1,3,-10,0
Laos,2010,AFF Championship qualification,8,3,1,0,2,3,5,0
Laos,2010,Friendly,0,4,0,1,0,1,-4,0
Laos,2011,AFC Challenge Cup qualification,1,1,0,0,1,1,0,0
Laos,2011,FIFA World Cup qualification,11,19,1,3,0,4,-8,0
Laos,2012,AFF Championship,6,10,0,2,1,3,-4,0
Laos,2012,AFF Championship qualification,5,4,2,1,1,4,1,0
Laos,2012,Friendly,3,3,1,1,0,2,0,0
Laos,2012,VFF Cup,2,8,0,2,0,2,-6,0
Laos,2013,AFC Challenge Cup qualification,6,4,1,0,2,3,2,0
Laos,2013,Friendly,2,7,0,3,0,3,-5,0
Laos,2014,AFC Challenge Cup,1,7,0,2,1,3,-6,0
Laos,2014,AFF Championship,2,12,0,3,0,3,-10,0
Laos,2014,AFF Championship qualification,10,6,3,1,0,4,4,0
Laos,2014,Friendly,0,2,0,1,0,1,-2,0
Laos,2015,FIFA World Cup qualification,3,29,0,6,1,7,-26,0
Laos,2015,Friendly,4,7,1,2,1,4,-3,0
Laos,2016,AFC Asian Cup qualification,2,12,0,3,1,4,-10,0
Laos,2016,AFC Challenge Cup,11,9,3,1,1,5,2,0
Laos,2016,AFF Championship qualification,7,6,2,1,0,3,1,0
Laos,2016,Friendly,1,5,0,1,1,2,-4,0
Laos,2017,Friendly,4,17,1,5,0,6,-13,0
Laos,2018,AFF Championship,3,12,0,4,0,4,-9,0
Laos,2018,Friendly,3,10,0,3,1,4,-7,0
Laos,2019,FIFA World Cup qualification,0,1,0,1,1,2,-1,0
Laos,2019,Friendly,4,3,1,0,1,2,1,0
Laos,2021,AFF Championship,1,14,0,4,0,4,-13,0
Laos,2022,AFF Championship,2,15,0,3,1,4,-13,0
Laos,2022,Friendly,5,6,2,2,0,4,-1,0
Laos,2023,FIFA World Cup qualification,1,2,0,1,1,2,-1,0
Laos,2023,Tri Nation Tournament,3,5,1,2,0,3,-2,0
Laos,2024,ASEAN Championship,7,11,0,2,2,4,-4,0
Laos,2024,Friendly,2,4,0,1,1,2,-2,0
Laos,2025,AFC Asian Cup qualification,0,5,0,1,0,1,-5,0
Laos,2025,Friendly,1,2,0,1,0,1,-1,0
Latvia,1922,Friendly,1,1,0,0,1,1,0,0
Latvia,1923,Friendly,1,1,0,0,1,1,0,0
Latvia,1924,Friendly,3,5,1,2,0,3,-2,0
Latvia,1924,Olympic Games,0,7,0,1,0,1,-7,0
Latvia,1925,Friendly,5,7,0,1,2,3,-2,0
Latvia,1926,Friendly,8,8,2,2,0,4,0,0
Latvia,1927,Friendly,12,23,2,3,0,5,-11,0
Latvia,1928,Baltic Cup,4,0,2,0,0,2,4,1
Latvia,1928,Friendly,4,7,1,1,2,4,-3,0
Latvia,1929,Baltic Cup,5,3,1,0,1,2,2,0
Latvia,1929,Friendly,2,17,0,3,0,3,-15,0
Latvia,1930,Baltic Cup,6,5,1,0,1,2,1,0
Latvia,1930,Friendly,4,12,1,2,1,4,-8,0
Latvia,1931,Baltic Cup,2,3,1,1,0,2,-1,0
Latvia,1931,Friendly,7,19,2,4,0,6,-12,0
Latvia,1932,Baltic Cup,5,1,2,0,0,2,4,1
Latvia,1932,Friendly,6,9,2,3,1,6,-3,0
Latvia,1933,Baltic Cup,3,2,1,0,1,2,1,0
Latvia,1933,Friendly,10,5,2,1,1,4,5,0
Latvia,1934,Friendly,5,15,0,4,1,5,-10,0
Latvia,1935,Baltic Cup,3,3,0,0,2,2,0,0
Latvia,1935,Friendly,12,13,1,2,3,6,-1,0
Latvia,1936,Baltic Cup,4,2,2,0,0,2,2,1
Latvia,1936,Friendly,12,7,2,0,1,3,5,0
Latvia,1937,Baltic Cup,3,1,1,0,1,2,2,1
Latvia,1937,FIFA World Cup qualification,10,5,2,1,0,3,5,0
Latvia,1937,Friendly,5,10,1,3,0,4,-5,0
Latvia,1938,Baltic Cup,2,2,0,0,2,2,0,0
Latvia,1938,Friendly,9,4,3,0,1,4,5,0
Latvia,1939,Friendly,6,10,1,2,1,4,-4,0
Latvia,1940,Baltic Cup,3,2,1,0,1,2,1,0
Latvia,1940,Friendly,4,6,0,2,0,2,-2,0
Latvia,1942,Friendly,12,1,2,0,0,2,11,0
Latvia,1945,Friendly,3,7,0,1,0,1,-4,0
Latvia,1947,Friendly,6,2,2,0,0,2,4,0
Latvia,1948,Baltic Cup,1,2,0,1,1,2,-1,0
Latvia,1949,Baltic Cup,2,2,1,1,0,2,0,0
Latvia,1979,Friendly,1,2,0,1,0,1,-1,0
Latvia,1991,Baltic Cup,3,1,1,0,1,2,2,0
Latvia,1992,Baltic Cup,4,4,1,1,0,2,0,0
Latvia,1992,FIFA World Cup qualification,3,13,0,3,4,7,-10,0
Latvia,1992,Friendly,0,4,0,3,0,3,-4,0
Latvia,1993,Baltic Cup,2,0,1,0,1,2,2,0
Latvia,1993,FIFA World Cup qualification,1,8,0,4,1,5,-7,0
Latvia,1993,Four Nations Tournament,3,2,1,1,0,2,1,0
Latvia,1994,Baltic Cup,2,1,1,1,0,2,1,0
Latvia,1994,Friendly,3,3,1,1,1,3,0,0
Latvia,1994,UEFA Euro qualification,2,6,1,2,0,3,-4,0
Latvia,1995,Baltic Cup,4,0,2,0,0,2,4,1
Latvia,1995,Friendly,1,3,0,1,0,1,-2,0
Latvia,1995,UEFA Euro qualification,9,14,3,4,0,7,-5,0
Latvia,1996,Baltic Cup,2,3,0,1,1,2,-1,0
Latvia,1996,FIFA World Cup qualification,3,7,0,3,1,4,-4,0
Latvia,1996,Friendly,0,1,0,1,1,2,-1,0
Latvia,1997,Baltic Cup,2,2,1,1,0,2,0,0
Latvia,1997,Cyprus International Tournament,3,5,1,2,0,3,-2,0
Latvia,1997,FIFA World Cup qualification,7,7,3,3,0,6,0,0
Latvia,1997,Friendly,4,2,1,1,1,3,2,0
Latvia,1998,Baltic Cup,3,2,1,1,0,2,1,0
Latvia,1998,Friendly,4,16,1,4,0,5,-12,0
Latvia,1998,Malta International Tournament,4,6,0,2,1,3,-2,0
Latvia,1998,UEFA Euro qualification,4,2,2,1,0,3,2,0
Latvia,1999,Friendly,0,5,0,2,0,2,-5,0
Latvia,1999,UEFA Euro qualification,9,10,1,2,4,7,-1,0
Latvia,2000,Baltic Cup,1,2,0,1,0,1,-1,0
Latvia,2000,Cyprus International Tournament,1,4,0,2,0,2,-3,0
Latvia,2000,FIFA World Cup qualification,1,5,1,2,0,3,-4,0
Latvia,2000,Friendly,1,1,1,1,0,2,0,0
Latvia,2001,Baltic Cup,7,2,2,0,0,2,5,1
Latvia,2001,FIFA World Cup qualification,4,11,0,4,1,5,-7,0
Latvia,2001,Friendly,3,4,1,2,0,3,-1,0
Latvia,2002,Friendly,8,7,2,2,1,5,1,0
Latvia,2002,UEFA Euro qualification,2,0,2,0,1,3,2,0
Latvia,2003,Baltic Cup,2,1,1,0,1,2,1,0
Latvia,2003,Friendly,2,8,1,4,0,5,-6,0
Latvia,2003,UEFA Euro qualification,11,8,4,2,1,7,3,0
Latvia,2004,Cyprus International Tournament,5,7,1,2,0,3,-2,0
Latvia,2004,FIFA World Cup qualification,10,12,2,2,1,5,-2,0
Latvia,2004,Friendly,3,4,1,1,2,4,-1,0
Latvia,2004,Prime Minister's Cup,4,5,0,1,1,2,-1,0
Latvia,2004,UEFA Euro,1,5,0,2,1,3,-4,0
Latvia,2005,Baltic Cup,0,2,0,1,0,1,-2,0
Latvia,2005,Cyprus International Tournament,2,3,0,1,1,2,-1,0
Latvia,2005,FIFA World Cup qualification,8,9,2,3,2,7,-1,0
Latvia,2005,Friendly,3,5,0,1,1,2,-2,0
Latvia,2005,King's Cup,4,3,1,0,2,3,1,1
Latvia,2006,Friendly,0,2,0,2,1,3,-2,0
Latvia,2006,UEFA Euro qualification,4,2,1,2,0,3,2,0
Latvia,2007,Cyprus International Tournament,0,4,0,2,0,2,-4,0
Latvia,2007,Friendly,1,2,0,1,0,1,-1,0
Latvia,2007,UEFA Euro qualification,11,15,3,6,0,9,-4,0
Latvia,2008,Baltic Cup,3,1,2,0,0,2,2,1
Latvia,2008,FIFA World Cup qualification,4,6,1,2,1,4,-2,0
Latvia,2008,Friendly,7,3,2,1,1,4,4,0
Latvia,2009,FIFA World Cup qualification,14,9,4,1,1,6,5,0
Latvia,2009,Friendly,1,3,0,2,1,3,-2,0
Latvia,2010,Baltic Cup,0,0,0,0,2,2,0,0
Latvia,2010,Friendly,2,8,0,4,1,5,-6,0
Latvia,2010,UEFA Euro qualification,3,5,1,2,1,4,-2,0
Latvia,2011,Friendly,3,6,1,2,0,3,-3,0
Latvia,2011,UEFA Euro qualification,6,7,2,3,1,6,-1,0
Latvia,2012,Baltic Cup,6,1,1,0,1,2,5,0
Latvia,2012,FIFA World Cup qualification,5,8,1,3,0,4,-3,0
Latvia,2012,Friendly,0,3,0,2,1,3,-3,0
Latvia,2013,FIFA World Cup qualification,5,12,1,3,2,6,-7,0
Latvia,2013,Friendly,5,13,0,3,2,5,-8,0
Latvia,2014,Baltic Cup,1,0,1,0,1,2,1,0
Latvia,2014,Friendly,3,2,1,1,0,2,1,0
Latvia,2014,UEFA Euro qualification,1,10,0,2,2,4,-9,0
Latvia,2015,Friendly,1,2,0,1,1,2,-1,0
Latvia,2015,UEFA Euro qualification,5,9,0,3,3,6,-4,0
Latvia,2016,Baltic Cup,2,1,1,0,1,2,1,0
Latvia,2016,FIFA World Cup qualification,2,8,1,3,0,4,-6,0
Latvia,2016,Friendly,8,1,2,0,1,3,7,0
Latvia,2017,FIFA World Cup qualification,5,10,1,4,1,6,-5,0
Latvia,2017,Friendly,4,11,0,3,0,3,-7,0
Latvia,2018,Baltic Cup,2,1,1,0,1,2,1,0
Latvia,2018,Friendly,2,6,0,3,1,4,-4,0
Latvia,2018,UEFA Nations League,2,6,0,2,4,6,-4,0
Latvia,2019,UEFA Euro qualification,3,28,1,9,0,10,-25,0
Latvia,2020,Friendly,4,1,1,0,1,2,3,0
Latvia,2020,UEFA Nations League,8,4,1,1,4,6,4,0
Latvia,2021,Baltic Cup,4,3,1,1,0,2,1,0
Latvia,2021,FIFA World Cup qualification,11,14,2,5,3,10,-3,0
Latvia,2021,Friendly,1,7,0,1,0,1,-6,0
Latvia,2022,Baltic Cup,2,2,0,0,2,2,0,0
Latvia,2022,Friendly,2,1,1,0,1,2,1,0
Latvia,2022,UEFA Nations League,12,5,4,1,1,6,7,0
Latvia,2023,Friendly,2,5,0,2,0,2,-3,0
Latvia,2023,UEFA Euro qualification,5,19,1,7,0,8,-14,0
Latvia,2024,Baltic Cup,1,2,1,1,0,2,-1,0
Latvia,2024,Friendly,2,2,0,0,2,2,0,0
Latvia,2024,UEFA Nations League,4,11,1,4,1,6,-7,0
Latvia,2025,FIFA World Cup qualification,1,3,1,1,0,2,-2,0
Lebanon,1940,Friendly,1,5,0,1,0,1,-4,0
Lebanon,1955,Friendly,2,3,0,1,0,1,-1,0
Lebanon,1956,Friendly,1,4,0,1,0,1,-3,0
Lebanon,1963,Arab Cup,13,4,2,2,0,4,9,0
Lebanon,1963,Friendly,0,2,0,1,0,1,-2,0
Lebanon,1964,Arab Cup,4,5,1,2,1,4,-1,0
Lebanon,1964,Friendly,1,0,1,0,0,1,1,0
Lebanon,1965,Friendly,0,2,0,1,0,1,-2,0
Lebanon,1966,Arab Cup,11,10,3,2,1,6,1,0
Lebanon,1971,AFC Asian Cup qualification,6,10,2,3,0,5,-4,1
Lebanon,1974,Kuneitra Cup,1,4,0,1,0,1,-3,0
Lebanon,1975,Korea Cup,0,1,0,1,0,1,-1,0
Lebanon,1978,Korea Cup,1,7,0,1,0,1,-6,0
Lebanon,1988,Arab Cup,1,4,0,1,2,3,-3,0
Lebanon,1989,Friendly,0,7,0,2,0,2,-7,0
Lebanon,1993,FIFA World Cup qualification,8,9,2,2,4,8,-1,0
Lebanon,1993,Friendly,1,2,1,1,0,2,-1,0
Lebanon,1995,Friendly,1,1,0,0,1,1,0,0
Lebanon,1996,AFC Asian Cup qualification,7,6,2,1,1,4,1,0
Lebanon,1996,Friendly,15,11,5,2,2,9,4,0
Lebanon,1997,FIFA World Cup qualification,4,7,1,2,1,4,-3,0
Lebanon,1997,Friendly,8,6,3,2,3,8,2,0
Lebanon,1998,Arab Cup,1,4,0,1,0,1,-3,0
Lebanon,1998,Arab Cup qualification,3,4,1,2,0,3,-1,0
Lebanon,1998,Asian Games,9,7,2,3,0,5,2,0
Lebanon,1998,Friendly,0,1,0,1,1,2,-1,0
Lebanon,1998,United Arab Emirates Friendship Tournament,4,5,0,1,2,3,-1,0
Lebanon,1999,Friendly,0,0,0,0,1,1,0,0
Lebanon,2000,AFC Asian Cup,3,7,0,1,2,3,-4,0
Lebanon,2000,Friendly,13,10,3,2,5,10,3,0
Lebanon,2000,WAFF Championship,3,2,1,1,1,3,1,0
Lebanon,2001,FIFA World Cup qualification,26,5,4,1,1,6,21,0
Lebanon,2001,Friendly,6,3,1,0,3,4,3,0
Lebanon,2002,Arab Cup,5,7,1,2,1,4,-2,0
Lebanon,2002,Friendly,1,1,0,0,1,1,0,0
Lebanon,2002,WAFF Championship,0,3,0,2,0,2,-3,0
Lebanon,2003,AFC Asian Cup qualification,2,8,1,4,1,6,-6,0
Lebanon,2003,Friendly,4,6,1,2,1,4,-2,0
Lebanon,2004,FIFA World Cup qualification,11,5,3,1,2,6,6,0
Lebanon,2004,Friendly,9,20,1,4,3,8,-11,0
Lebanon,2004,WAFF Championship,1,7,0,2,0,2,-6,0
Lebanon,2005,Friendly,1,2,0,1,0,1,-1,0
Lebanon,2006,AFC Asian Cup qualification,1,1,0,0,1,1,0,0
Lebanon,2006,Arab Cup qualification,4,0,1,0,2,3,4,0
Lebanon,2006,Friendly,2,1,1,0,0,1,1,0
Lebanon,2007,FIFA World Cup qualification,6,3,1,0,1,2,3,0
Lebanon,2007,Friendly,1,1,0,0,1,1,0,0
Lebanon,2007,WAFF Championship,0,4,0,2,0,2,-4,0
Lebanon,2008,AFC Asian Cup qualification,6,1,2,0,0,2,5,1
Lebanon,2008,FIFA World Cup qualification,3,14,0,6,0,6,-11,0
Lebanon,2008,Friendly,4,9,0,3,1,4,-5,0
Lebanon,2009,AFC Asian Cup qualification,1,8,0,4,0,4,-7,0
Lebanon,2009,Friendly,1,1,0,0,1,1,0,0
Lebanon,2009,King's Cup,2,2,1,1,0,2,0,1
Lebanon,2009,Nehru Cup,5,6,1,2,1,4,-1,0
Lebanon,2010,AFC Asian Cup qualification,1,5,0,1,1,2,-4,0
Lebanon,2011,FIFA World Cup qualification,12,12,4,2,1,7,0,0
Lebanon,2011,Friendly,4,17,0,5,0,5,-13,0
Lebanon,2012,Arab Cup,0,3,0,2,0,2,-3,0
Lebanon,2012,FIFA World Cup qualification,4,10,1,4,1,6,-6,0
Lebanon,2012,Friendly,6,11,2,3,1,6,-5,0
Lebanon,2012,WAFF Championship,2,3,1,2,0,3,-1,0
Lebanon,2013,AFC Asian Cup qualification,7,12,1,2,2,5,-5,0
Lebanon,2013,FIFA World Cup qualification,1,6,0,2,1,3,-5,0
Lebanon,2013,Friendly,5,5,1,2,5,8,0,0
Lebanon,2013,WAFF Championship,0,2,0,1,1,2,-2,0
Lebanon,2014,AFC Asian Cup qualification,5,2,1,0,0,1,3,0
Lebanon,2014,Friendly,6,10,1,2,1,4,-4,0
Lebanon,2015,FIFA World Cup qualification,11,4,3,2,1,6,7,0
Lebanon,2015,Friendly,5,5,1,1,3,5,0,0
Lebanon,2016,FIFA World Cup qualification,1,2,0,1,1,2,-1,0
Lebanon,2016,Friendly,5,7,1,2,5,8,-2,0
Lebanon,2017,AFC Asian Cup qualification,12,3,4,0,1,5,9,0
Lebanon,2017,Friendly,1,0,1,0,0,1,1,0
Lebanon,2018,AFC Asian Cup qualification,2,1,1,0,0,1,1,1
Lebanon,2018,Friendly,1,5,1,3,2,6,-4,0
Lebanon,2019,AFC Asian Cup,4,5,1,2,0,3,-1,0
Lebanon,2019,FIFA World Cup qualification,5,3,2,1,2,5,2,0
Lebanon,2019,Friendly,0,1,0,1,0,1,-1,0
Lebanon,2019,WAFF Championship,3,4,1,2,1,4,-1,0
Lebanon,2020,Friendly,1,3,0,1,0,1,-2,0
Lebanon,2021,Arab Cup,1,3,1,2,0,3,-2,0
Lebanon,2021,Arab Cup qualification,1,0,1,0,0,1,1,0
Lebanon,2021,FIFA World Cup qualification,10,13,2,5,2,9,-3,0
Lebanon,2021,Friendly,1,2,0,1,1,2,-1,0
Lebanon,2022,FIFA World Cup qualification,1,7,0,3,1,4,-6,0
Lebanon,2022,Friendly,0,3,0,2,0,2,-3,0
Lebanon,2023,FIFA World Cup qualification,1,1,0,0,2,2,0,0
Lebanon,2023,Friendly,3,7,0,3,0,3,-4,0
Lebanon,2023,King's Cup,2,2,1,1,0,2,0,0
Lebanon,2023,SAFF Cup,7,1,3,0,1,4,6,0
Lebanon,2024,AFC Asian Cup,1,5,0,2,1,3,-4,0
Lebanon,2024,FIFA World Cup qualification,4,7,1,2,1,4,-3,0
Lebanon,2024,Friendly,3,3,1,1,1,3,0,0
Lebanon,2024,Merdeka Tournament,1,1,1,1,0,2,0,0
Lebanon,2025,AFC Asian Cup qualification,5,0,1,0,0,1,5,0
Lebanon,2025,Friendly,4,0,1,0,0,1,4,0
Lesotho,1970,Friendly,3,7,1,1,0,2,-4,0
Lesotho,1971,Friendly,1,4,0,2,1,3,-3,0
Lesotho,1972,FIFA World Cup qualification,1,6,0,1,1,2,-5,0
Lesotho,1972,Friendly,2,7,0,2,2,4,-5,0
Lesotho,1973,African Cup of Nations qualification,1,5,0,1,1,2,-4,0
Lesotho,1976,Friendly,1,4,0,1,0,1,-3,0
Lesotho,1977,Friendly,1,9,0,2,0,2,-8,0
Lesotho,1978,African Cup of Nations qualification,2,2,1,1,0,2,0,0
Lesotho,1978,Friendly,0,2,0,2,0,2,-2,0
Lesotho,1979,Friendly,2,5,1,2,0,3,-3,0
Lesotho,1980,African Cup of Nations qualification,3,7,1,1,0,2,-4,0
Lesotho,1980,FIFA World Cup qualification,2,4,0,1,1,2,-2,0
Lesotho,1981,Friendly,4,12,0,3,1,4,-8,0
Lesotho,1984,Friendly,1,3,0,1,0,1,-2,0
Lesotho,1990,Friendly,2,10,0,3,0,3,-8,0
Lesotho,1992,African Cup of Nations qualification,6,5,1,1,2,4,1,0
Lesotho,1992,Friendly,7,4,2,0,2,4,3,0
Lesotho,1993,African Cup of Nations qualification,2,12,0,2,2,4,-10,0
Lesotho,1997,COSAFA Cup qualification,0,2,0,1,0,1,-2,0
Lesotho,1997,Friendly,6,5,1,1,3,5,1,0
Lesotho,1998,African Cup of Nations qualification,2,4,0,1,1,2,-2,0
Lesotho,1998,COSAFA Cup qualification,0,2,0,1,0,1,-2,0
Lesotho,1998,Friendly,0,0,0,0,1,1,0,0
Lesotho,1999,COSAFA Cup,0,1,0,1,0,1,-1,0
Lesotho,1999,COSAFA Cup qualification,1,0,1,0,0,1,1,0
Lesotho,1999,Friendly,2,9,0,3,0,3,-7,0
Lesotho,2000,African Cup of Nations qualification,5,5,1,1,2,4,0,0
Lesotho,2000,COSAFA Cup,3,9,1,3,1,5,-6,0
Lesotho,2000,FIFA World Cup qualification,0,3,0,2,0,2,-3,0
Lesotho,2000,Friendly,4,5,2,2,3,7,-1,0
Lesotho,2001,African Cup of Nations qualification,3,5,1,2,1,4,-2,0
Lesotho,2001,COSAFA Cup,1,2,0,1,0,1,-1,0
Lesotho,2001,Friendly,6,9,2,4,2,8,-3,0
Lesotho,2002,African Cup of Nations qualification,0,7,0,2,0,2,-7,0
Lesotho,2002,COSAFA Cup,0,2,0,1,0,1,-2,0
Lesotho,2002,Friendly,2,5,1,3,1,5,-3,0
Lesotho,2003,African Cup of Nations qualification,1,3,1,1,0,2,-2,0
Lesotho,2003,COSAFA Cup,0,0,0,0,1,1,0,0
Lesotho,2003,FIFA World Cup qualification,1,4,0,1,1,2,-3,0
Lesotho,2003,Friendly,11,11,3,3,2,8,0,0
Lesotho,2004,COSAFA Cup,0,0,0,0,1,1,0,0
Lesotho,2004,Friendly,1,1,0,0,1,1,0,0
Lesotho,2005,COSAFA Cup,1,2,0,1,0,1,-1,0
Lesotho,2005,Friendly,4,7,0,3,0,3,-3,0
Lesotho,2006,African Cup of Nations qualification,0,4,0,2,0,2,-4,0
Lesotho,2006,COSAFA Cup,1,3,0,1,1,2,-2,0
Lesotho,2006,Friendly,8,6,1,2,2,5,2,0
Lesotho,2007,African Cup of Nations qualification,3,5,1,2,1,4,-2,0
Lesotho,2007,COSAFA Cup,2,5,0,2,0,2,-3,0
Lesotho,2007,Friendly,2,2,1,1,1,3,0,0
Lesotho,2007,Merdeka Tournament,3,2,1,1,0,2,1,0
Lesotho,2008,COSAFA Cup qualification,2,2,1,1,1,3,0,0
Lesotho,2008,FIFA World Cup qualification,2,16,0,6,0,6,-14,0
Lesotho,2008,Friendly,6,6,1,1,2,4,0,0
Lesotho,2009,COSAFA Cup,3,2,1,0,1,2,1,0
Lesotho,2009,Friendly,3,8,0,1,4,5,-5,0
Lesotho,2011,FIFA World Cup qualification,3,2,1,0,1,2,1,0
Lesotho,2011,Friendly,0,4,0,2,2,4,-4,0
Lesotho,2012,African Cup of Nations qualification,0,1,0,1,1,2,-1,0
Lesotho,2012,FIFA World Cup qualification,0,7,0,1,1,2,-7,0
Lesotho,2012,Friendly,5,10,1,3,2,6,-5,0
Lesotho,2013,COSAFA Cup,10,10,1,2,3,6,0,0
Lesotho,2013,FIFA World Cup qualification,4,8,1,2,1,4,-4,0
Lesotho,2013,Friendly,0,2,0,1,0,1,-2,0
Lesotho,2014,African Cup of Nations qualification,6,13,2,5,3,10,-7,0
Lesotho,2014,Friendly,0,3,0,2,1,3,-3,0
Lesotho,2015,African Cup of Nations qualification,2,5,0,2,0,2,-3,0
Lesotho,2015,COSAFA Cup,2,4,1,2,0,3,-2,0
Lesotho,2015,FIFA World Cup qualification,1,1,0,0,2,2,0,0
Lesotho,2015,Friendly,1,3,0,1,2,3,-2,0
Lesotho,2016,African Cup of Nations qualification,3,11,1,3,0,4,-8,0
Lesotho,2016,COSAFA Cup,9,4,3,1,1,5,5,0
Lesotho,2016,Friendly,1,2,0,1,0,1,-1,0
Lesotho,2017,African Cup of Nations qualification,1,1,0,0,1,1,0,0
Lesotho,2017,COSAFA Cup,3,4,0,1,2,3,-1,0
Lesotho,2017,Friendly,2,2,1,1,1,3,0,0
Lesotho,2018,African Cup of Nations qualification,2,6,1,2,1,4,-4,0
Lesotho,2018,COSAFA Cup,2,0,2,0,1,3,2,0
Lesotho,2018,Friendly,1,3,0,2,0,2,-2,0
Lesotho,2019,African Cup of Nations qualification,3,5,0,1,2,3,-2,0
Lesotho,2019,COSAFA Cup,3,4,0,1,2,3,-1,0
Lesotho,2019,FIFA World Cup qualification,1,1,0,0,2,2,0,0
Lesotho,2019,Friendly,1,1,0,0,1,1,0,0
Lesotho,2020,African Cup of Nations qualification,0,1,0,1,1,2,-1,0
Lesotho,2021,African Cup of Nations qualification,0,3,0,1,1,2,-3,0
Lesotho,2021,COSAFA Cup,3,12,1,3,0,4,-9,0
Lesotho,2021,Friendly,0,5,0,1,0,1,-5,0
Lesotho,2022,African Cup of Nations qualification,3,3,1,1,2,4,0,0
Lesotho,2022,COSAFA Cup,4,4,2,1,0,3,0,0
Lesotho,2022,Friendly,2,2,0,0,2,2,0,0
Lesotho,2023,African Cup of Nations qualification,1,7,0,4,0,4,-6,0
Lesotho,2023,COSAFA Cup,6,6,2,2,1,5,0,0
Lesotho,2023,FIFA World Cup qualification,1,1,0,0,2,2,0,0
Lesotho,2023,Friendly,0,2,0,1,0,1,-2,0
Lesotho,2024,African Cup of Nations qualification,1,6,0,3,1,4,-5,0
Lesotho,2024,FIFA World Cup qualification,2,1,1,1,0,2,1,0
Lesotho,2024,Friendly,3,5,1,2,1,4,-2,0
Lesotho,2025,FIFA World Cup qualification,1,3,0,1,1,2,-2,0
Liberia,1961,African Friendship Games,2,11,0,2,1,3,-9,0
Liberia,1963,African Friendship Games,3,5,1,2,0,3,-2,0
Liberia,1963,Friendly,2,5,0,1,1,2,-3,0
Liberia,1965,African Cup of Nations qualification,4,9,1,3,0,4,-5,0
Liberia,1966,Friendly,3,1,1,0,1,2,2,0
Liberia,1967,African Cup of Nations qualification,4,10,0,2,2,4,-6,0
Liberia,1967,Friendly,2,5,0,1,1,2,-3,0
Liberia,1971,Friendly,3,2,1,1,0,2,1,0
Liberia,1972,Friendly,3,7,0,2,1,3,-4,0
Liberia,1974,African Cup of Nations qualification,0,3,0,2,0,2,-3,0
Liberia,1975,Friendly,2,1,1,1,0,2,1,0
Liberia,1976,Friendly,0,1,0,1,0,1,-1,0
Liberia,1979,Friendly,9,5,3,0,3,6,4,0
Liberia,1980,African Cup of Nations qualification,1,1,0,0,2,2,0,0
Liberia,1980,FIFA World Cup qualification,0,1,0,1,1,2,-1,0
Liberia,1980,Friendly,1,2,0,1,1,2,-1,0
Liberia,1981,African Cup of Nations qualification,1,8,0,2,0,2,-7,0
Liberia,1981,Friendly,4,4,2,1,1,4,0,0
Liberia,1982,Friendly,1,0,1,0,0,1,1,0
Liberia,1982,West African Cup,1,3,0,2,0,2,-2,0
Liberia,1983,West African Cup,1,7,0,3,1,4,-6,0
Liberia,1984,African Cup of Nations qualification,3,4,1,1,0,2,-1,0
Liberia,1984,FIFA World Cup qualification,0,4,0,2,0,2,-4,0
Liberia,1984,Friendly,3,10,0,3,2,5,-7,0
Liberia,1984,Merdeka Tournament,4,6,1,2,0,3,-2,0
Liberia,1986,African Cup of Nations qualification,2,3,0,1,1,2,-1,0
Liberia,1986,Friendly,3,3,2,1,1,4,0,0
Liberia,1986,West African Cup,3,5,1,3,0,4,-2,0
Liberia,1987,Friendly,4,5,2,2,1,5,-1,0
Liberia,1987,West African Cup,3,2,1,1,1,3,1,0
Liberia,1988,African Cup of Nations qualification,0,4,0,2,0,2,-4,0
Liberia,1988,FIFA World Cup qualification,2,0,1,0,1,2,2,0
Liberia,1988,Friendly,1,2,0,1,2,3,-1,0
Liberia,1989,FIFA World Cup qualification,2,3,2,2,2,6,-1,0
Liberia,1989,Friendly,5,1,2,0,1,3,4,0
Liberia,1990,Friendly,0,2,0,2,0,2,-2,0
Liberia,1992,FIFA World Cup qualification,2,4,0,1,0,1,-2,0
Liberia,1993,African Cup of Nations qualification,0,2,0,1,1,2,-2,0
Liberia,1994,African Cup of Nations qualification,2,1,1,0,1,2,1,0
Liberia,1994,Friendly,2,5,0,1,2,3,-3,0
Liberia,1995,African Cup of Nations qualification,4,4,2,1,3,6,0,0
Liberia,1995,Friendly,4,5,1,2,1,4,-1,0
Liberia,1996,African Cup of Nations,2,3,1,1,0,2,-1,0
Liberia,1996,African Cup of Nations qualification,0,0,0,0,1,1,0,0
Liberia,1996,FIFA World Cup qualification,5,3,1,2,0,3,2,0
Liberia,1996,Friendly,1,2,0,1,0,1,-1,0
Liberia,1997,African Cup of Nations qualification,5,8,2,2,1,5,-3,0
Liberia,1997,FIFA World Cup qualification,2,9,1,3,1,5,-7,0
Liberia,1998,African Cup of Nations qualification,4,4,1,2,0,3,0,0
Liberia,1998,Friendly,1,2,0,1,0,1,-1,0
Liberia,1999,African Cup of Nations qualification,6,6,2,2,1,5,0,0
Liberia,2000,African Cup of Nations qualification,5,2,1,1,0,2,3,0
Liberia,2000,FIFA World Cup qualification,3,3,2,1,1,4,0,0
Liberia,2001,African Cup of Nations qualification,9,2,3,0,1,4,7,0
Liberia,2001,FIFA World Cup qualification,8,5,4,2,0,6,3,0
Liberia,2001,Friendly,7,17,0,4,0,4,-10,0
Liberia,2002,African Cup of Nations,3,4,0,1,2,3,-1,0
Liberia,2002,African Cup of Nations qualification,1,3,1,1,0,2,-2,0
Liberia,2003,African Cup of Nations qualification,2,4,1,3,0,4,-2,0
Liberia,2003,FIFA World Cup qualification,3,2,1,1,0,2,1,0
Liberia,2004,FIFA World Cup qualification,1,7,1,3,1,5,-6,0
Liberia,2005,FIFA World Cup qualification,2,20,0,5,0,5,-18,0
Liberia,2005,Friendly,0,2,0,1,0,1,-2,0
Liberia,2006,African Cup of Nations qualification,4,4,1,1,0,2,0,0
Liberia,2007,African Cup of Nations qualification,2,9,0,3,1,4,-7,0
Liberia,2008,FIFA World Cup qualification,4,12,0,3,3,6,-8,0
Liberia,2008,Friendly,7,6,2,2,0,4,1,0
Liberia,2010,African Cup of Nations qualification,2,3,0,1,1,2,-1,0
Liberia,2011,African Cup of Nations qualification,5,9,1,2,1,4,-4,0
Liberia,2011,Friendly,3,2,1,0,2,3,1,0
Liberia,2012,African Cup of Nations qualification,4,8,1,1,2,4,-4,0
Liberia,2012,FIFA World Cup qualification,1,3,0,1,1,2,-2,0
Liberia,2012,Friendly,3,3,2,2,0,4,0,0
Liberia,2013,FIFA World Cup qualification,3,7,1,3,0,4,-4,0
Liberia,2013,Friendly,1,0,1,0,0,1,1,0
Liberia,2014,African Cup of Nations qualification,1,2,1,1,0,2,-1,0
Liberia,2015,African Cup of Nations qualification,2,2,1,1,0,2,0,0
Liberia,2015,FIFA World Cup qualification,4,6,1,2,1,4,-2,0
Liberia,2016,African Cup of Nations qualification,9,6,2,1,1,4,3,0
Liberia,2016,Friendly,0,1,0,1,0,1,-1,0
Liberia,2017,African Cup of Nations qualification,0,3,0,1,0,1,-3,0
Liberia,2018,African Cup of Nations qualification,5,5,2,1,1,4,0,0
Liberia,2018,Friendly,1,2,0,1,1,2,-1,0
Liberia,2019,African Cup of Nations qualification,1,2,1,2,0,3,-1,0
Liberia,2019,FIFA World Cup qualification,3,2,1,1,0,2,1,0
Liberia,2019,Friendly,1,3,0,2,2,4,-2,0
Liberia,2021,FIFA World Cup qualification,5,8,2,4,0,6,-3,0
Liberia,2021,Friendly,2,8,1,3,0,4,-6,0
Liberia,2022,African Cup of Nations qualification,0,2,0,1,0,1,-2,0
Liberia,2022,Friendly,1,10,0,4,1,5,-9,0
Liberia,2023,African Cup of Nations qualification,3,7,0,2,1,3,-4,0
Liberia,2023,FIFA World Cup qualification,0,2,0,2,0,2,-2,0
Liberia,2023,Friendly,3,6,0,2,0,2,-3,0
Liberia,2024,African Cup of Nations qualification,4,7,1,3,2,6,-3,0
Liberia,2024,FIFA World Cup qualification,2,1,1,0,1,2,1,0
Liberia,2025,FIFA World Cup qualification,2,2,1,1,0,2,0,0
Libya,1957,Friendly,2,4,0,1,0,1,-2,0
Libya,1958,Friendly,2,7,0,2,0,2,-5,0
Libya,1962,Friendly,8,5,1,0,1,2,3,0
Libya,1964,Arab Cup,9,5,2,0,2,4,4,0
Libya,1964,Friendly,2,3,0,1,1,2,-1,0
Libya,1965,Friendly,5,1,2,0,0,2,4,0
Libya,1966,African Cup of Nations qualification,2,2,0,0,1,1,0,0
Libya,1966,Arab Cup,41,4,3,1,2,6,37,0
Libya,1966,Friendly,4,10,1,4,0,5,-6,0
Libya,1967,African Cup of Nations qualification,2,3,0,1,0,1,-1,0
Libya,1967,Friendly,1,6,0,2,1,3,-5,0
Libya,1969,FIFA World Cup qualification,3,5,1,1,0,2,-2,0
Libya,1970,African Cup of Nations qualification,0,1,0,1,0,1,-1,0
Libya,1970,Friendly,5,6,1,1,1,3,-1,0
Libya,1971,African Cup of Nations qualification,1,2,0,1,0,1,-1,0
Libya,1971,Friendly,9,9,3,2,1,6,0,0
Libya,1972,Palestine Cup,3,7,0,2,1,3,-4,0
Libya,1973,Palestine Cup,12,4,1,1,2,4,8,0
Libya,1974,African Cup of Nations qualification,1,1,1,1,0,2,0,0
Libya,1974,Friendly,8,6,4,1,1,6,2,0
Libya,1974,Kuneitra Cup,10,4,1,1,1,3,6,0
Libya,1975,Friendly,1,4,0,2,0,2,-3,0
Libya,1975,Palestine Cup,3,3,1,1,0,2,0,0
Libya,1976,FIFA World Cup qualification,0,1,0,1,1,2,-1,0
Libya,1976,Friendly,5,12,2,5,1,8,-7,0
Libya,1977,African Cup of Nations qualification,0,5,0,2,0,2,-5,0
Libya,1977,Friendly,3,0,3,0,0,3,3,0
Libya,1977,Merdeka Tournament,4,10,0,2,3,5,-6,0
Libya,1978,All-African Games,3,4,1,2,0,3,-1,0
Libya,1978,Friendly,4,1,3,1,0,4,3,0
Libya,1979,African Cup of Nations qualification,5,5,2,1,1,4,0,0
Libya,1979,Friendly,3,7,1,1,2,4,-4,0
Libya,1980,FIFA World Cup qualification,2,1,1,0,1,2,1,0
Libya,1980,Friendly,7,1,3,0,0,3,6,0
Libya,1982,African Cup of Nations,7,4,2,0,3,5,3,0
Libya,1982,Friendly,5,1,2,0,0,2,4,0
Libya,1983,African Cup of Nations qualification,2,2,1,1,0,2,0,0
Libya,1983,Friendly,10,6,3,3,1,7,4,0
Libya,1985,African Cup of Nations qualification,5,4,2,2,0,4,1,0
Libya,1985,FIFA World Cup qualification,7,3,3,1,2,6,4,0
Libya,1985,Friendly,3,1,1,0,1,2,2,0
Libya,1988,FIFA World Cup qualification,3,2,1,1,0,2,1,0
Libya,1988,Friendly,1,0,1,0,0,1,1,0
Libya,1989,FIFA World Cup qualification,0,1,0,1,0,1,-1,0
Libya,1991,Friendly,0,2,0,1,0,1,-2,0
Libya,1992,Friendly,1,4,0,3,1,4,-3,0
Libya,1997,Friendly,4,5,1,1,2,4,-1,0
Libya,1998,African Cup of Nations qualification,0,5,0,2,0,2,-5,0
Libya,1998,Arab Cup,2,4,0,2,0,2,-2,0
Libya,1998,Friendly,3,7,0,1,1,2,-4,0
Libya,1999,Friendly,11,5,5,1,0,6,6,0
Libya,2000,African Cup of Nations qualification,6,6,2,2,0,4,0,0
Libya,2000,FIFA World Cup qualification,4,6,1,2,0,3,-2,0
Libya,2000,Friendly,2,3,0,1,1,2,-1,0
Libya,2001,African Cup of Nations qualification,2,8,1,3,0,4,-6,0
Libya,2001,FIFA World Cup qualification,7,16,0,5,2,7,-9,0
Libya,2002,African Cup of Nations qualification,4,4,1,1,0,2,0,0
Libya,2002,Friendly,5,0,2,0,0,2,5,0
Libya,2003,African Cup of Nations qualification,8,4,2,1,1,4,4,0
Libya,2003,FIFA World Cup qualification,9,0,2,0,0,2,9,0
Libya,2003,Friendly,5,10,0,3,0,3,-5,0
Libya,2004,FIFA World Cup qualification,7,4,3,1,1,5,3,0
Libya,2004,Friendly,10,4,5,1,1,7,6,0
Libya,2005,FIFA World Cup qualification,1,6,0,3,2,5,-5,0
Libya,2005,Friendly,4,8,1,2,2,5,-4,0
Libya,2006,African Cup of Nations,1,5,0,2,1,3,-4,0
Libya,2006,African Cup of Nations qualification,1,2,0,1,1,2,-1,0
Libya,2006,Friendly,9,16,3,6,2,11,-7,0
Libya,2007,African Cup of Nations qualification,6,4,2,1,1,4,2,0
Libya,2007,Friendly,1,5,0,3,2,5,-4,0
Libya,2008,FIFA World Cup qualification,7,4,4,2,0,6,3,0
Libya,2008,Friendly,16,7,3,0,3,6,9,0
Libya,2009,Friendly,3,4,0,1,1,2,-1,0
Libya,2010,African Cup of Nations qualification,1,0,1,0,1,2,1,0
Libya,2010,Friendly,3,3,1,1,1,3,0,0
Libya,2011,African Cup of Nations qualification,5,1,2,0,2,4,4,0
Libya,2011,Friendly,4,3,1,0,1,2,1,0
Libya,2012,African Cup of Nations,4,4,1,1,1,3,0,0
Libya,2012,African Cup of Nations qualification,0,3,0,2,0,2,-3,0
Libya,2012,Arab Cup,7,2,3,0,0,3,5,0
Libya,2012,FIFA World Cup qualification,3,2,1,0,1,2,1,0
Libya,2012,Friendly,6,1,3,1,0,4,5,0
Libya,2013,FIFA World Cup qualification,2,1,1,1,2,4,1,0
Libya,2013,Friendly,18,9,8,3,3,14,9,0
Libya,2014,African Cup of Nations qualification,0,3,0,1,1,2,-3,0
Libya,2014,Friendly,0,3,0,1,0,1,-3,0
Libya,2015,African Cup of Nations qualification,1,3,0,2,0,2,-2,0
Libya,2015,FIFA World Cup qualification,4,1,2,0,0,2,3,0
Libya,2015,Friendly,2,1,1,0,0,1,1,0
Libya,2016,African Cup of Nations qualification,7,3,2,1,1,4,4,0
Libya,2016,FIFA World Cup qualification,0,5,0,2,0,2,-5,0
Libya,2016,Friendly,0,2,0,1,0,1,-2,0
Libya,2017,African Cup of Nations qualification,5,1,1,0,0,1,4,0
Libya,2017,CECAFA Cup,1,0,1,0,3,4,1,0
Libya,2017,FIFA World Cup qualification,4,5,1,2,1,4,-1,0
Libya,2017,Friendly,2,5,0,3,2,5,-3,0
Libya,2018,African Cup of Nations qualification,10,8,1,2,1,4,2,0
Libya,2019,African Cup of Nations qualification,4,7,1,2,0,3,-3,0
Libya,2019,Friendly,3,2,1,1,2,4,1,0
Libya,2020,African Cup of Nations qualification,2,4,0,2,0,2,-2,0
Libya,2021,African Cup of Nations qualification,2,6,0,2,0,2,-4,0
Libya,2021,Arab Cup qualification,0,1,0,1,0,1,-1,0
Libya,2021,FIFA World Cup qualification,4,7,2,3,1,6,-3,0
Libya,2021,Friendly,0,1,0,1,0,1,-1,0
Libya,2022,African Cup of Nations qualification,1,2,1,1,0,2,-1,0
Libya,2022,Friendly,9,8,4,2,1,7,1,0
Libya,2023,African Cup of Nations qualification,1,6,0,3,1,4,-5,0
Libya,2023,FIFA World Cup qualification,2,1,1,0,1,2,1,0
Libya,2023,Friendly,4,3,1,0,1,2,1,0
Libya,2024,African Cup of Nations qualification,2,4,0,2,1,3,-2,0
Libya,2024,FIFA World Cup qualification,2,2,1,1,0,2,0,0
Libya,2024,Friendly,11,3,4,0,0,4,8,0
Libya,2025,FIFA World Cup qualification,2,4,0,1,1,2,-2,0
Liechtenstein,1981,Korea Cup,4,5,1,1,1,3,-1,0
Liechtenstein,1982,Friendly,2,1,1,1,0,2,1,0
Liechtenstein,1984,Friendly,0,6,0,1,0,1,-6,0
Liechtenstein,1990,Friendly,1,4,0,1,0,1,-3,0
Liechtenstein,1991,Friendly,0,6,0,1,0,1,-6,0
Liechtenstein,1993,Friendly,0,2,0,1,0,1,-2,0
Liechtenstein,1994,Friendly,0,2,0,1,0,1,-2,0
Liechtenstein,1994,UEFA Euro qualification,1,21,0,5,0,5,-20,0
Liechtenstein,1995,UEFA Euro qualification,0,19,0,4,1,5,-19,0
Liechtenstein,1996,FIFA World Cup qualification,2,21,0,4,0,4,-19,0
Liechtenstein,1996,Friendly,1,9,0,1,0,1,-8,0
Liechtenstein,1997,FIFA World Cup qualification,1,31,0,6,0,6,-30,0
Liechtenstein,1998,Friendly,0,6,0,1,0,1,-6,0
Liechtenstein,1998,UEFA Euro qualification,2,12,1,2,0,3,-10,0
Liechtenstein,1999,Friendly,0,0,0,0,1,1,0,0
Liechtenstein,1999,UEFA Euro qualification,0,27,0,6,1,7,-27,0
Liechtenstein,2000,FIFA World Cup qualification,0,3,0,2,0,2,-3,0
Liechtenstein,2000,Friendly,2,9,0,2,0,2,-7,0
Liechtenstein,2001,FIFA World Cup qualification,0,20,0,6,0,6,-20,0
Liechtenstein,2001,Friendly,0,2,0,1,0,1,-2,0
Liechtenstein,2002,Friendly,4,7,0,2,2,4,-3,0
Liechtenstein,2002,UEFA Euro qualification,1,6,0,1,1,2,-5,0
Liechtenstein,2003,Friendly,3,2,1,0,1,2,1,0
Liechtenstein,2003,UEFA Euro qualification,1,16,0,6,0,6,-15,0
Liechtenstein,2004,FIFA World Cup qualification,8,14,1,3,1,5,-6,0
Liechtenstein,2004,Friendly,0,7,0,4,0,4,-7,0
Liechtenstein,2005,FIFA World Cup qualification,5,9,1,5,1,7,-4,0
Liechtenstein,2005,Friendly,1,2,0,1,0,1,-1,0
Liechtenstein,2006,Friendly,2,13,0,5,0,5,-11,0
Liechtenstein,2006,UEFA Euro qualification,1,11,0,3,0,3,-10,0
Liechtenstein,2007,UEFA Euro qualification,8,21,2,6,1,9,-13,0
Liechtenstein,2008,FIFA World Cup qualification,0,8,0,2,1,3,-8,0
Liechtenstein,2008,Friendly,1,16,0,4,0,4,-15,0
Liechtenstein,2009,FIFA World Cup qualification,2,15,0,6,1,7,-13,0
Liechtenstein,2009,Friendly,0,10,0,3,0,3,-10,0
Liechtenstein,2010,Friendly,2,2,0,0,2,2,0,0
Liechtenstein,2010,UEFA Euro qualification,1,8,0,3,0,3,-7,0
Liechtenstein,2011,Friendly,2,7,1,2,0,3,-5,0
Liechtenstein,2011,UEFA Euro qualification,2,9,1,3,1,5,-7,0
Liechtenstein,2012,FIFA World Cup qualification,1,14,0,4,0,4,-13,0
Liechtenstein,2012,Friendly,2,3,1,2,0,3,-1,0
Liechtenstein,2013,FIFA World Cup qualification,3,11,0,4,2,6,-8,0
Liechtenstein,2013,Friendly,2,9,0,4,0,4,-7,0
Liechtenstein,2014,Friendly,1,10,0,3,0,3,-9,0
Liechtenstein,2014,UEFA Euro qualification,1,6,1,2,1,4,-5,0
Liechtenstein,2015,Friendly,1,3,1,1,0,2,-2,0
Liechtenstein,2015,UEFA Euro qualification,1,20,0,5,1,6,-19,0
Liechtenstein,2016,FIFA World Cup qualification,1,16,0,4,0,4,-15,0
Liechtenstein,2016,Friendly,2,12,0,3,1,4,-10,0
Liechtenstein,2017,FIFA World Cup qualification,0,23,0,6,0,6,-23,0
Liechtenstein,2017,Friendly,3,2,1,0,1,2,1,0
Liechtenstein,2018,Friendly,0,4,0,2,0,2,-4,0
Liechtenstein,2018,UEFA Nations League,7,12,1,4,1,6,-5,0
Liechtenstein,2019,UEFA Euro qualification,2,31,0,8,2,10,-29,0
Liechtenstein,2020,Friendly,2,4,1,1,0,2,-2,0
Liechtenstein,2020,UEFA Nations League,3,2,1,1,2,4,1,0
Liechtenstein,2021,FIFA World Cup qualification,2,34,0,9,1,10,-32,0
Liechtenstein,2021,Friendly,1,12,0,2,0,2,-11,0
Liechtenstein,2022,Friendly,0,9,0,3,0,3,-9,0
Liechtenstein,2022,UEFA Nations League,1,11,0,6,0,6,-10,0
Liechtenstein,2023,UEFA Euro qualification,1,28,0,10,0,10,-27,0
Liechtenstein,2024,Friendly,2,10,1,3,2,6,-8,0
Liechtenstein,2024,UEFA Nations League,3,6,0,2,2,4,-3,0
Liechtenstein,2025,FIFA World Cup qualification,0,5,0,2,0,2,-5,0
Lithuania,1923,Friendly,0,5,0,1,0,1,-5,0
Lithuania,1924,Friendly,2,11,1,1,0,2,-9,0
Lithuania,1924,Olympic Games,0,9,0,1,0,1,-9,0
Lithuania,1925,Friendly,2,3,0,1,1,2,-1,0
Lithuania,1926,Friendly,3,6,0,2,0,2,-3,0
Lithuania,1927,Friendly,3,11,0,2,0,2,-8,0
Lithuania,1928,Baltic Cup,0,9,0,2,0,2,-9,0
Lithuania,1928,Friendly,1,1,0,0,1,1,0,0
Lithuania,1929,Baltic Cup,3,8,0,2,0,2,-5,0
Lithuania,1930,Baltic Cup,5,4,1,0,1,2,1,0
Lithuania,1930,Friendly,4,0,1,0,0,1,4,0
Lithuania,1931,Baltic Cup,0,3,0,2,0,2,-3,0
Lithuania,1931,Friendly,5,13,0,3,0,3,-8,0
Lithuania,1932,Baltic Cup,3,5,1,1,0,2,-2,0
Lithuania,1932,Friendly,6,13,2,3,0,5,-7,0
Lithuania,1933,Baltic Cup,3,3,0,0,2,2,0,0
Lithuania,1933,FIFA World Cup qualification,0,2,0,1,0,1,-2,0
Lithuania,1933,Friendly,5,22,0,4,0,4,-17,0
Lithuania,1934,Friendly,7,2,3,0,1,4,5,0
Lithuania,1935,Baltic Cup,4,3,1,0,1,2,1,0
Lithuania,1935,Friendly,7,12,0,1,3,4,-5,0
Lithuania,1936,Baltic Cup,2,4,0,2,0,2,-2,0
Lithuania,1936,Friendly,3,5,1,1,0,2,-2,0
Lithuania,1937,Baltic Cup,0,4,0,1,0,1,-4,0
Lithuania,1937,FIFA World Cup qualification,3,9,0,2,0,2,-6,0
Lithuania,1937,Friendly,1,2,0,1,0,1,-1,0
Lithuania,1938,Baltic Cup,2,4,0,1,1,2,-2,0
Lithuania,1938,Friendly,1,7,0,3,0,3,-6,0
Lithuania,1939,Friendly,1,7,1,1,0,2,-6,0
Lithuania,1940,Baltic Cup,1,2,0,1,1,2,-1,0
Lithuania,1940,Friendly,6,3,2,0,0,2,3,0
Lithuania,1945,Friendly,11,7,2,1,0,3,4,0
Lithuania,1947,Friendly,2,6,0,2,1,3,-4,0
Lithuania,1948,Baltic Cup,3,1,2,0,0,2,2,0
Lithuania,1949,Baltic Cup,3,1,2,0,0,2,2,1
Lithuania,1956,Friendly,4,6,2,2,0,4,-2,0
Lithuania,1966,Friendly,6,0,1,0,0,1,6,0
Lithuania,1979,Friendly,4,11,2,4,1,7,-7,0
Lithuania,1990,Friendly,2,2,0,0,1,1,0,0
Lithuania,1991,Baltic Cup,5,2,1,0,1,2,3,0
Lithuania,1992,Baltic Cup,4,3,1,0,1,2,1,1
Lithuania,1992,FIFA World Cup qualification,5,5,1,1,3,5,0,0
Lithuania,1992,Friendly,2,6,1,2,1,4,-4,0
Lithuania,1993,Baltic Cup,1,2,0,1,1,2,-1,0
Lithuania,1993,FIFA World Cup qualification,3,16,1,6,0,7,-13,0
Lithuania,1993,Four Nations Tournament,2,4,1,1,0,2,-2,0
Lithuania,1993,Friendly,4,5,0,1,2,3,-1,0
Lithuania,1994,Baltic Cup,4,0,2,0,0,2,4,1
Lithuania,1994,Friendly,6,10,0,2,1,3,-4,0
Lithuania,1994,UEFA Euro qualification,4,3,2,1,0,3,1,0
Lithuania,1995,Baltic Cup,7,2,1,1,0,2,5,0
Lithuania,1995,Friendly,4,6,1,1,1,3,-2,0
Lithuania,1995,UEFA Euro qualification,9,9,3,3,1,7,0,0
Lithuania,1996,Baltic Cup,3,2,1,0,1,2,1,0
Lithuania,1996,FIFA World Cup qualification,4,4,2,1,0,3,0,0
Lithuania,1996,Friendly,11,14,1,3,1,5,-3,0
Lithuania,1997,Baltic Cup,3,1,2,0,0,2,2,1
Lithuania,1997,Cyprus International Tournament,0,2,0,2,1,3,-2,0
Lithuania,1997,FIFA World Cup qualification,7,4,3,2,2,7,3,0
Lithuania,1997,Friendly,0,3,0,2,0,2,-3,0
Lithuania,1998,Baltic Cup,2,1,1,0,1,2,1,0
Lithuania,1998,Friendly,6,13,1,5,1,7,-7,0
Lithuania,1998,UEFA Euro qualification,4,2,1,0,2,3,2,0
Lithuania,1999,Friendly,2,3,0,1,2,3,-1,0
Lithuania,1999,UEFA Euro qualification,4,14,2,5,0,7,-10,0
Lithuania,2000,Baltic Cup,2,1,1,0,0,1,1,1
Lithuania,2000,Cyprus International Tournament,4,5,1,2,0,3,-1,1
Lithuania,2000,FIFA World Cup qualification,1,11,0,3,0,3,-10,0
Lithuania,2000,Friendly,1,10,0,2,0,2,-9,0
Lithuania,2001,Baltic Cup,6,6,1,1,0,2,0,0
Lithuania,2001,Cyprus International Tournament,2,4,1,1,0,2,-2,0
Lithuania,2001,FIFA World Cup qualification,2,9,0,3,2,5,-7,0
Lithuania,2001,Friendly,2,3,0,1,0,1,-1,0
Lithuania,2002,Friendly,3,8,0,2,0,2,-5,0
Lithuania,2002,Malta International Tournament,2,4,1,1,1,3,-2,0
Lithuania,2002,UEFA Euro qualification,2,5,1,2,0,3,-3,0
Lithuania,2003,Baltic Cup,6,3,1,1,0,2,3,0
Lithuania,2003,Friendly,2,9,0,4,0,4,-7,0
Lithuania,2003,UEFA Euro qualification,5,6,2,2,1,5,-1,0
Lithuania,2004,FIFA World Cup qualification,6,1,2,0,2,4,5,0
Lithuania,2004,Friendly,5,11,0,4,0,4,-6,0
Lithuania,2005,Baltic Cup,2,0,1,0,0,1,2,1
Lithuania,2005,FIFA World Cup qualification,2,8,0,4,2,6,-6,0
Lithuania,2005,Friendly,1,1,1,1,0,2,0,0
Lithuania,2006,Friendly,9,6,3,2,0,5,3,0
Lithuania,2006,UEFA Euro qualification,3,3,1,1,1,3,0,0
Lithuania,2007,Friendly,3,4,1,1,0,2,-1,0
Lithuania,2007,UEFA Euro qualification,8,10,4,5,0,9,-2,0
Lithuania,2008,Baltic Cup,2,2,1,1,0,2,0,0
Lithuania,2008,FIFA World Cup qualification,6,3,3,1,0,4,3,0
Lithuania,2008,Friendly,7,8,2,2,2,6,-1,0
Lithuania,2009,FIFA World Cup qualification,4,8,1,5,0,6,-4,0
Lithuania,2009,Friendly,5,2,2,0,1,3,3,0
Lithuania,2010,Baltic Cup,2,0,1,0,1,2,2,1
Lithuania,2010,Friendly,0,8,0,3,0,3,-8,0
Lithuania,2010,UEFA Euro qualification,2,3,1,1,1,3,-1,0
Lithuania,2011,Friendly,5,1,2,1,0,3,4,0
Lithuania,2011,UEFA Euro qualification,2,10,0,4,1,5,-8,0
Lithuania,2012,Baltic Cup,0,6,0,2,0,2,-6,0
Lithuania,2012,FIFA World Cup qualification,3,6,1,2,1,4,-3,0
Lithuania,2012,Friendly,3,6,0,2,2,4,-3,0
Lithuania,2013,FIFA World Cup qualification,6,5,2,3,1,6,1,0
Lithuania,2013,Friendly,3,7,0,2,1,3,-4,0
Lithuania,2014,Baltic Cup,1,1,1,1,0,2,0,0
Lithuania,2014,Friendly,3,4,0,1,3,4,-1,0
Lithuania,2014,UEFA Euro qualification,3,6,2,2,0,4,-3,0
Lithuania,2015,Friendly,0,6,0,2,0,2,-6,0
Lithuania,2015,UEFA Euro qualification,4,12,1,4,1,6,-8,0
Lithuania,2016,Baltic Cup,3,2,1,1,0,2,1,0
Lithuania,2016,FIFA World Cup qualification,5,7,1,1,2,4,-2,0
Lithuania,2016,Friendly,0,4,0,2,1,3,-4,0
Lithuania,2017,FIFA World Cup qualification,2,13,0,5,1,6,-11,0
Lithuania,2017,Friendly,0,3,0,1,0,1,-3,0
Lithuania,2018,Baltic Cup,1,3,0,1,1,2,-2,0
Lithuania,2018,Friendly,1,9,1,3,0,4,-8,0
Lithuania,2018,UEFA Nations League,3,16,0,6,0,6,-13,0
Lithuania,2019,Friendly,1,0,1,0,1,2,1,0
Lithuania,2019,UEFA Euro qualification,5,25,0,7,1,8,-20,0
Lithuania,2020,Friendly,5,2,2,0,0,2,3,0
Lithuania,2020,UEFA Nations League,5,7,2,2,2,6,-2,0
Lithuania,2021,Baltic Cup,1,4,0,2,0,2,-3,0
Lithuania,2021,FIFA World Cup qualification,4,19,1,7,0,8,-15,0
Lithuania,2021,Friendly,1,9,0,2,1,3,-8,0
Lithuania,2022,Baltic Cup,0,2,0,1,1,2,-2,0
Lithuania,2022,Friendly,2,2,1,1,0,2,0,0
Lithuania,2022,UEFA Nations League,2,14,0,5,1,6,-12,0
Lithuania,2023,Friendly,0,1,0,1,1,2,-1,0
Lithuania,2023,UEFA Euro qualification,8,14,1,4,3,8,-6,0
Lithuania,2024,Baltic Cup,3,1,1,0,1,2,2,0
Lithuania,2024,UEFA Nations League,6,11,2,6,0,8,-5,0
Lithuania,2025,FIFA World Cup qualification,2,3,0,1,1,2,-1,0
Luhansk PR,2015,Friendly,4,6,1,2,0,3,-2,0
Luhansk PR,2016,Friendly,1,1,0,0,1,1,0,0
Luhansk PR,2019,Friendly,4,5,1,1,0,2,-1,0
Luxembourg,1911,Friendly,1,4,0,1,0,1,-3,0
Luxembourg,1913,Friendly,0,8,0,1,0,1,-8,0
Luxembourg,1914,Friendly,5,4,1,0,0,1,1,0
Luxembourg,1920,Olympic Games,0,3,0,1,0,1,-3,0
Luxembourg,1922,Friendly,0,1,0,1,0,1,-1,0
Luxembourg,1923,Friendly,1,4,0,1,0,1,-3,0
Luxembourg,1924,Friendly,1,1,0,0,1,1,0,0
Luxembourg,1924,Olympic Games,0,2,0,1,0,1,-2,0
Luxembourg,1925,Friendly,1,1,0,0,1,1,0,0
Luxembourg,1927,Friendly,2,5,0,1,0,1,-3,0
Luxembourg,1928,Friendly,1,1,0,0,1,1,0,0
Luxembourg,1928,Olympic Games,3,5,0,1,0,1,-2,0
Luxembourg,1934,FIFA World Cup qualification,2,15,0,2,0,2,-13,0
Luxembourg,1935,Friendly,0,1,0,1,0,1,-1,0
Luxembourg,1936,Friendly,3,12,0,2,0,2,-9,0
Luxembourg,1937,FIFA World Cup qualification,0,4,0,1,0,1,-4,0
Luxembourg,1937,Friendly,2,3,0,1,0,1,-1,0
Luxembourg,1938,FIFA World Cup qualification,2,3,0,1,0,1,-1,0
Luxembourg,1938,Friendly,1,8,0,2,0,2,-7,0
Luxembourg,1939,Friendly,3,4,1,1,0,2,-1,0
Luxembourg,1940,Friendly,5,4,1,0,0,1,1,0
Luxembourg,1945,Friendly,4,1,1,0,0,1,3,0
Luxembourg,1946,Friendly,7,22,1,3,0,4,-15,0
Luxembourg,1947,Friendly,0,6,0,1,0,1,-6,0
Luxembourg,1949,FIFA World Cup qualification,4,8,0,2,0,2,-4,0
Luxembourg,1949,Friendly,2,2,0,0,1,1,0,0
Luxembourg,1950,Friendly,2,2,0,0,1,1,0,0
Luxembourg,1951,Friendly,4,4,1,1,0,2,0,0
Luxembourg,1952,Friendly,0,3,0,1,0,1,-3,0
Luxembourg,1953,FIFA World Cup qualification,1,18,0,3,0,3,-17,0
Luxembourg,1954,FIFA World Cup qualification,0,1,0,1,0,1,-1,0
Luxembourg,1956,FIFA World Cup qualification,0,7,0,1,0,1,-7,0
Luxembourg,1957,FIFA World Cup qualification,3,12,0,3,0,3,-9,0
Luxembourg,1957,Friendly,0,3,0,1,0,1,-3,0
Luxembourg,1959,Friendly,0,1,0,1,0,1,-1,0
Luxembourg,1960,FIFA World Cup qualification,0,9,0,1,0,1,-9,0
Luxembourg,1961,FIFA World Cup qualification,5,12,1,2,0,3,-7,0
Luxembourg,1962,Friendly,1,3,0,1,0,1,-2,0
Luxembourg,1963,UEFA Euro qualification,8,8,1,1,3,5,0,0
Luxembourg,1964,FIFA World Cup qualification,1,7,0,3,0,3,-6,0
Luxembourg,1965,FIFA World Cup qualification,5,13,0,3,0,3,-8,0
Luxembourg,1966,UEFA Euro qualification,0,7,0,2,0,2,-7,0
Luxembourg,1967,UEFA Euro qualification,1,11,0,3,1,4,-10,0
Luxembourg,1968,FIFA World Cup qualification,0,2,0,1,0,1,-2,0
Luxembourg,1968,Friendly,1,5,0,1,0,1,-4,0
Luxembourg,1969,FIFA World Cup qualification,4,22,0,5,0,5,-18,0
Luxembourg,1969,Friendly,2,1,1,0,0,1,1,0
Luxembourg,1970,Friendly,1,2,0,1,1,2,-1,0
Luxembourg,1970,UEFA Euro qualification,0,7,0,2,0,2,-7,0
Luxembourg,1971,Friendly,0,5,0,2,0,2,-5,0
Luxembourg,1971,UEFA Euro qualification,1,16,0,3,1,4,-15,0
Luxembourg,1972,FIFA World Cup qualification,2,7,1,2,0,3,-5,0
Luxembourg,1972,Friendly,0,6,0,1,0,1,-6,0
Luxembourg,1973,FIFA World Cup qualification,0,7,0,3,0,3,-7,0
Luxembourg,1973,Friendly,0,2,0,1,0,1,-2,0
Luxembourg,1974,UEFA Euro qualification,2,9,0,2,0,2,-7,0
Luxembourg,1975,UEFA Euro qualification,5,19,0,4,0,4,-14,0
Luxembourg,1976,FIFA World Cup qualification,2,11,0,2,0,2,-9,0
Luxembourg,1976,Friendly,1,3,0,1,0,1,-2,0
Luxembourg,1977,FIFA World Cup qualification,0,11,0,4,0,4,-11,0
Luxembourg,1978,Friendly,1,3,0,1,0,1,-2,0
Luxembourg,1978,UEFA Euro qualification,1,3,0,1,0,1,-2,0
Luxembourg,1979,UEFA Euro qualification,1,14,0,4,1,5,-13,0
Luxembourg,1980,FIFA World Cup qualification,0,11,0,3,0,3,-11,0
Luxembourg,1980,Friendly,4,16,2,6,0,8,-12,0
Luxembourg,1981,FIFA World Cup qualification,1,12,0,5,0,5,-11,0
Luxembourg,1981,Friendly,0,3,0,1,0,1,-3,0
Luxembourg,1982,UEFA Euro qualification,1,13,0,3,0,3,-12,0
Luxembourg,1983,UEFA Euro qualification,4,23,0,5,0,5,-19,0
Luxembourg,1984,FIFA World Cup qualification,0,13,0,3,0,3,-13,0
Luxembourg,1984,Friendly,2,12,0,7,0,7,-10,0
Luxembourg,1985,FIFA World Cup qualification,2,14,0,5,0,5,-12,0
Luxembourg,1985,Friendly,0,0,0,0,1,1,0,0
Luxembourg,1986,Friendly,0,2,0,1,0,1,-2,0
Luxembourg,1986,UEFA Euro qualification,0,9,0,2,0,2,-9,0
Luxembourg,1987,Friendly,0,2,0,1,0,1,-2,0
Luxembourg,1987,UEFA Euro qualification,2,14,0,5,1,6,-12,0
Luxembourg,1988,FIFA World Cup qualification,1,7,0,3,0,3,-6,0
Luxembourg,1988,Friendly,0,3,0,1,0,1,-3,0
Luxembourg,1989,FIFA World Cup qualification,2,15,0,4,1,5,-13,0
Luxembourg,1990,Friendly,1,2,0,1,0,1,-1,0
Luxembourg,1990,UEFA Euro qualification,2,4,0,2,0,2,-2,0
Luxembourg,1991,Friendly,1,1,0,0,1,1,0,0
Luxembourg,1991,UEFA Euro qualification,0,10,0,4,0,4,-10,0
Luxembourg,1992,FIFA World Cup qualification,0,5,0,2,0,2,-5,0
Luxembourg,1992,Friendly,2,3,0,1,0,1,-1,0
Luxembourg,1993,FIFA World Cup qualification,2,12,0,5,1,6,-10,0
Luxembourg,1994,Friendly,1,2,0,1,0,1,-1,0
Luxembourg,1994,UEFA Euro qualification,0,11,0,3,0,3,-11,0
Luxembourg,1995,Friendly,2,4,0,1,0,1,-2,0
Luxembourg,1995,UEFA Euro qualification,3,10,3,3,1,7,-7,0
Luxembourg,1996,FIFA World Cup qualification,1,7,0,3,0,3,-6,0
Luxembourg,1996,Friendly,1,3,0,1,1,2,-2,0
Luxembourg,1997,FIFA World Cup qualification,1,15,0,5,0,5,-14,0
Luxembourg,1998,Friendly,0,9,0,2,1,3,-9,0
Luxembourg,1998,UEFA Euro qualification,0,6,0,2,0,2,-6,0
Luxembourg,1999,Friendly,1,2,0,1,0,1,-1,0
Luxembourg,1999,UEFA Euro qualification,2,17,0,6,0,6,-15,0
Luxembourg,2000,FIFA World Cup qualification,1,7,0,3,0,3,-6,0
Luxembourg,2000,Friendly,2,5,0,2,1,3,-3,0
Luxembourg,2001,FIFA World Cup qualification,3,21,0,7,0,7,-18,0
Luxembourg,2001,Friendly,0,4,0,2,0,2,-4,0
Luxembourg,2002,Friendly,3,13,0,3,3,6,-10,0
Luxembourg,2002,UEFA Euro qualification,0,9,0,2,0,2,-9,0
Luxembourg,2003,Friendly,3,8,0,2,1,3,-5,0
Luxembourg,2003,UEFA Euro qualification,0,12,0,6,0,6,-12,0
Luxembourg,2004,FIFA World Cup qualification,4,24,0,6,0,6,-20,0
Luxembourg,2004,Friendly,4,13,0,4,0,4,-9,0
Luxembourg,2005,FIFA World Cup qualification,1,24,0,6,0,6,-23,0
Luxembourg,2005,Friendly,0,1,0,1,0,1,-1,0
Luxembourg,2006,Friendly,0,16,0,5,2,7,-16,0
Luxembourg,2006,UEFA Euro qualification,0,4,0,3,0,3,-4,0
Luxembourg,2007,Friendly,2,1,1,0,1,2,1,0
Luxembourg,2007,UEFA Euro qualification,2,19,1,8,0,9,-17,0
Luxembourg,2008,FIFA World Cup qualification,3,7,1,2,1,4,-4,0
Luxembourg,2008,Friendly,4,10,0,3,2,5,-6,0
Luxembourg,2009,FIFA World Cup qualification,1,18,0,5,1,6,-17,0
Luxembourg,2009,Friendly,1,2,0,1,1,2,-1,0
Luxembourg,2010,Friendly,2,7,0,2,2,4,-5,0
Luxembourg,2010,UEFA Euro qualification,0,6,0,3,1,4,-6,0
Luxembourg,2011,Friendly,2,8,1,3,0,4,-6,0
Luxembourg,2011,UEFA Euro qualification,3,15,1,5,0,6,-12,0
Luxembourg,2012,FIFA World Cup qualification,2,12,0,3,1,4,-10,0
Luxembourg,2012,Friendly,4,7,1,3,0,4,-3,0
Luxembourg,2013,FIFA World Cup qualification,5,14,1,3,2,6,-9,0
Luxembourg,2013,Friendly,4,9,1,2,1,4,-5,0
Luxembourg,2014,Friendly,2,6,0,1,2,3,-4,0
Luxembourg,2014,UEFA Euro qualification,3,11,0,3,1,4,-8,0
Luxembourg,2015,Friendly,2,4,1,2,1,4,-2,0
Luxembourg,2015,UEFA Euro qualification,3,16,1,5,0,6,-13,0
Luxembourg,2016,FIFA World Cup qualification,5,9,0,3,1,4,-4,0
Luxembourg,2016,Friendly,2,11,0,4,0,4,-9,0
Luxembourg,2017,FIFA World Cup qualification,3,17,1,3,2,6,-14,0
Luxembourg,2017,Friendly,4,4,2,1,0,3,0,0
Luxembourg,2018,Friendly,2,4,2,1,1,4,-2,0
Luxembourg,2018,UEFA Nations League,11,4,3,2,1,6,7,0
Luxembourg,2019,Friendly,3,8,0,2,1,3,-5,0
Luxembourg,2019,UEFA Euro qualification,7,16,1,6,1,8,-9,0
Luxembourg,2020,Friendly,1,5,0,2,0,2,-4,0
Luxembourg,2020,UEFA Nations League,7,5,3,2,1,6,2,0
Luxembourg,2021,FIFA World Cup qualification,8,18,3,5,0,8,-10,0
Luxembourg,2021,Friendly,1,4,0,3,1,4,-3,0
Luxembourg,2022,Friendly,3,6,0,2,2,4,-3,0
Luxembourg,2022,UEFA Nations League,9,7,3,1,2,6,2,0
Luxembourg,2023,Friendly,0,1,0,1,0,1,-1,0
Luxembourg,2023,UEFA Euro qualification,13,19,5,3,2,10,-6,0
Luxembourg,2024,Friendly,0,6,0,2,0,2,-6,0
Luxembourg,2024,UEFA Euro qualification,0,2,0,1,0,1,-2,0
Luxembourg,2024,UEFA Nations League,3,7,0,3,3,6,-4,0
Luxembourg,2025,Friendly,2,3,1,1,0,2,-1,0
Macau,1949,Friendly,1,5,0,1,0,1,-4,0
Macau,1970,Friendly,0,9,0,1,0,1,-9,0
Macau,1975,Friendly,3,2,1,0,1,2,1,0
Macau,1977,Friendly,0,2,0,1,0,1,-2,0
Macau,1978,AFC Asian Cup qualification,2,6,0,2,0,2,-4,0
Macau,1978,Friendly,0,4,0,1,0,1,-4,0
Macau,1980,FIFA World Cup qualification,0,9,0,3,0,3,-9,0
Macau,1980,Friendly,0,2,0,1,0,1,-2,0
Macau,1981,Friendly,1,3,0,1,0,1,-2,0
Macau,1982,Friendly,1,0,1,0,0,1,1,0
Macau,1983,Friendly,0,1,0,1,0,1,-1,0
Macau,1984,Friendly,0,3,0,1,0,1,-3,0
Macau,1985,FIFA World Cup qualification,4,15,2,4,0,6,-11,0
Macau,1985,Friendly,0,2,0,1,0,1,-2,0
Macau,1986,Friendly,2,3,0,1,0,1,-1,0
Macau,1987,Friendly,0,5,0,1,0,1,-5,0
Macau,1988,Friendly,0,2,0,1,0,1,-2,0
Macau,1989,Friendly,1,2,0,1,0,1,-1,0
Macau,1992,AFC Asian Cup qualification,4,4,1,1,1,3,0,0
Macau,1993,East Asian Games,3,21,0,3,0,3,-18,0
Macau,1993,FIFA World Cup qualification,1,46,0,6,0,6,-45,0
Macau,1996,AFC Asian Cup qualification,7,12,1,2,0,3,-5,0
Macau,1997,FIFA World Cup qualification,3,28,1,4,1,6,-25,0
Macau,2000,AFC Asian Cup qualification,1,4,1,2,0,3,-3,0
Macau,2000,Friendly,0,1,0,1,0,1,-1,0
Macau,2001,FIFA World Cup qualification,2,31,0,6,0,6,-29,0
Macau,2003,AFC Asian Cup qualification,0,5,0,2,0,2,-5,0
Macau,2003,EAFF Championship,5,5,2,2,0,4,0,0
Macau,2003,FIFA World Cup qualification,1,6,0,2,0,2,-5,0
Macau,2005,Friendly,1,8,0,1,0,1,-7,0
Macau,2006,AFC Challenge Cup,2,8,0,2,1,3,-6,0
Macau,2006,Friendly,0,1,0,1,1,2,-1,0
Macau,2007,EAFF Championship,1,7,0,1,1,2,-6,0
Macau,2007,FIFA World Cup qualification,2,13,0,2,0,2,-11,0
Macau,2007,Friendly,1,2,0,1,0,1,-1,0
Macau,2008,AFC Challenge Cup qualification,3,6,0,2,0,2,-3,0
Macau,2008,Friendly,1,10,0,2,0,2,-9,0
Macau,2009,AFC Challenge Cup qualification,4,12,1,4,0,5,-8,0
Macau,2009,EAFF Championship,9,5,1,1,1,3,4,0
Macau,2009,East Asian Games,0,8,0,1,0,1,-8,0
Macau,2010,Dragon Cup,0,5,0,1,0,1,-5,0
Macau,2011,AFC Challenge Cup qualification,4,5,1,1,0,2,-1,0
Macau,2011,Dragon Cup,1,7,0,2,0,2,-6,0
Macau,2011,FIFA World Cup qualification,1,13,0,2,0,2,-12,0
Macau,2012,EAFF Championship,5,4,1,1,0,2,1,0
Macau,2012,Friendly,0,8,0,2,0,2,-8,0
Macau,2013,AFC Challenge Cup qualification,0,6,0,3,0,3,-6,0
Macau,2014,EAFF Championship,4,4,1,1,1,3,0,0
Macau,2014,Friendly,2,2,0,0,1,1,0,0
Macau,2015,FIFA World Cup qualification,1,4,0,1,1,2,-3,0
Macau,2015,Friendly,0,2,0,1,0,1,-2,0
Macau,2016,AFC Challenge Cup,8,5,2,1,2,5,3,0
Macau,2016,EAFF Championship,5,3,1,0,1,2,2,0
Macau,2016,Friendly,0,0,0,0,1,1,0,0
Macau,2017,AFC Asian Cup qualification,4,15,0,5,0,5,-11,0
Macau,2017,Friendly,3,1,1,0,0,1,2,0
Macau,2018,AFC Asian Cup qualification,0,1,0,1,0,1,-1,0
Macau,2018,EAFF Championship,4,5,1,1,1,3,-1,0
Macau,2018,Friendly,1,5,0,2,0,2,-4,0
Macau,2019,FIFA World Cup qualification,1,3,1,1,0,2,-2,0
Macau,2023,FIFA World Cup qualification,1,5,0,1,1,2,-4,0
Macau,2023,Friendly,0,8,0,4,0,4,-8,0
Macau,2024,AFC Asian Cup qualification,0,4,0,2,0,2,-4,0
Macau,2024,EAFF Championship qualification,1,2,0,1,0,1,-1,0
Macau,2025,Friendly,0,2,0,1,0,1,-2,0
Madagascar,1947,Friendly,5,4,1,1,0,2,1,0
Madagascar,1948,Friendly,3,5,1,1,0,2,-2,0
Madagascar,1949,Friendly,4,4,1,1,0,2,0,0
Madagascar,1950,Friendly,3,8,0,2,0,2,-5,0
Madagascar,1951,Friendly,4,8,1,1,0,2,-4,0
Madagascar,1952,Friendly,1,7,1,1,0,2,-6,0
Madagascar,1953,Friendly,8,7,1,1,0,2,1,0
Madagascar,1954,Friendly,3,10,0,2,0,2,-7,0
Madagascar,1955,Friendly,6,3,2,0,0,2,3,0
Madagascar,1956,Friendly,7,5,1,0,1,2,2,0
Madagascar,1957,Friendly,0,5,0,2,0,2,-5,0
Madagascar,1958,Friendly,6,3,2,0,0,2,3,0
Madagascar,1960,African Friendship Games,14,2,2,0,0,2,12,1
Madagascar,1960,Friendly,6,1,1,0,0,1,5,0
Madagascar,1961,African Friendship Games,6,4,1,1,0,2,2,0
Madagascar,1962,Friendly,2,10,0,2,0,2,-8,0
Madagascar,1963,African Friendship Games,8,8,3,2,0,5,0,0
Madagascar,1963,Friendly,6,1,1,0,0,1,5,0
Madagascar,1965,All-African Games,0,19,0,5,0,5,-19,0
Madagascar,1966,Friendly,6,4,1,1,0,2,2,0
Madagascar,1969,Friendly,3,0,1,0,0,1,3,0
Madagascar,1970,African Cup of Nations qualification,3,5,1,1,0,2,-2,0
Madagascar,1971,Friendly,8,3,3,0,1,4,5,0
Madagascar,1972,Friendly,3,2,1,1,0,2,1,0
Madagascar,1973,African Cup of Nations qualification,3,4,1,1,0,2,-1,0
Madagascar,1978,African Cup of Nations qualification,3,6,1,1,0,2,-3,0
Madagascar,1979,Friendly,7,4,2,1,0,3,3,0
Madagascar,1980,African Cup of Nations qualification,1,1,0,0,2,2,0,0
Madagascar,1980,FIFA World Cup qualification,3,4,0,1,1,2,-1,0
Madagascar,1980,Friendly,3,2,1,0,2,3,1,0
Madagascar,1981,African Cup of Nations qualification,3,6,1,1,0,2,-3,0
Madagascar,1981,Friendly,6,3,2,1,1,4,3,0
Madagascar,1983,African Cup of Nations qualification,4,3,2,1,1,4,1,0
Madagascar,1983,Friendly,6,2,2,0,1,3,4,0
Madagascar,1985,African Cup of Nations qualification,2,6,0,2,0,2,-4,0
Madagascar,1985,FIFA World Cup qualification,1,1,1,1,0,2,0,0
Madagascar,1985,Indian Ocean Island Games,2,3,1,1,0,2,-1,0
Madagascar,1987,African Cup of Nations qualification,2,3,1,1,0,2,-1,0
Madagascar,1987,All-African Games,5,6,1,2,1,4,-1,0
Madagascar,1987,Friendly,5,2,2,0,0,2,3,0
Madagascar,1990,African Cup of Nations qualification,1,0,1,0,1,2,1,0
Madagascar,1990,Indian Ocean Island Games,12,1,3,0,1,4,11,1
Madagascar,1991,African Cup of Nations qualification,2,2,1,1,1,3,0,0
Madagascar,1992,FIFA World Cup qualification,5,0,2,0,1,3,5,0
Madagascar,1993,FIFA World Cup qualification,2,3,1,1,0,2,-1,0
Madagascar,1993,Indian Ocean Island Games,10,2,4,0,0,4,8,1
Madagascar,1996,FIFA World Cup qualification,3,4,0,1,1,2,-1,0
Madagascar,1996,Friendly,0,0,0,0,1,1,0,0
Madagascar,1998,African Cup of Nations qualification,4,3,1,0,2,3,1,0
Madagascar,1998,Indian Ocean Island Games,13,5,3,0,1,4,8,0
Madagascar,1999,African Cup of Nations qualification,6,7,1,2,2,5,-1,0
Madagascar,2000,African Cup of Nations qualification,4,2,2,1,1,4,2,0
Madagascar,2000,FIFA World Cup qualification,5,2,2,2,0,4,3,0
Madagascar,2000,Friendly,2,1,1,0,1,2,1,0
Madagascar,2001,African Cup of Nations qualification,3,6,0,3,1,4,-3,0
Madagascar,2001,FIFA World Cup qualification,2,14,1,5,0,6,-12,0
Madagascar,2001,Friendly,1,0,1,0,0,1,1,0
Madagascar,2002,African Cup of Nations qualification,2,0,2,0,0,2,2,0
Madagascar,2002,COSAFA Cup,3,2,1,0,1,2,1,0
Madagascar,2002,Friendly,0,1,0,1,0,1,-1,0
Madagascar,2003,African Cup of Nations qualification,0,8,0,2,0,2,-8,0
Madagascar,2003,COSAFA Cup,2,3,1,1,0,2,-1,0
Madagascar,2003,FIFA World Cup qualification,3,4,0,1,1,2,-1,0
Madagascar,2003,Friendly,4,12,0,4,1,5,-8,0
Madagascar,2003,Indian Ocean Island Games,2,4,0,1,1,2,-2,0
Madagascar,2004,COSAFA Cup,0,2,0,1,0,1,-2,0
Madagascar,2005,COSAFA Cup,0,2,0,1,0,1,-2,0
Madagascar,2005,Friendly,2,0,1,0,0,1,2,0
Madagascar,2006,African Cup of Nations qualification,0,4,0,1,0,1,-4,0
Madagascar,2006,COSAFA Cup,0,4,0,2,0,2,-4,0
Madagascar,2007,African Cup of Nations qualification,0,10,0,3,0,3,-10,0
Madagascar,2007,COSAFA Cup,5,1,1,1,0,2,4,0
Madagascar,2007,FIFA World Cup qualification,10,2,2,0,0,2,8,0
Madagascar,2007,Friendly,2,2,0,0,2,2,0,0
Madagascar,2007,Indian Ocean Island Games,7,0,2,0,2,4,7,0
Madagascar,2008,COSAFA Cup,1,4,0,2,0,2,-3,0
Madagascar,2008,COSAFA Cup qualification,4,3,1,0,2,3,1,0
Madagascar,2008,FIFA World Cup qualification,2,7,1,2,3,6,-5,0
Madagascar,2008,Friendly,2,1,1,0,0,1,1,0
Madagascar,2009,Friendly,4,3,1,1,1,3,1,0
Madagascar,2010,African Cup of Nations qualification,0,3,0,2,0,2,-3,0
Madagascar,2010,Friendly,1,0,1,0,1,2,1,0
Madagascar,2011,African Cup of Nations qualification,4,11,0,3,1,4,-7,0
Madagascar,2011,FIFA World Cup qualification,2,3,1,1,0,2,-1,0
Madagascar,2011,Friendly,0,1,0,1,0,1,-1,0
Madagascar,2011,Indian Ocean Island Games,2,3,0,1,1,2,-1,0
Madagascar,2012,African Cup of Nations qualification,1,7,0,2,0,2,-6,0
Madagascar,2014,African Cup of Nations qualification,2,2,1,1,0,2,0,0
Madagascar,2015,African Cup of Nations qualification,1,2,0,1,1,2,-1,0
Madagascar,2015,COSAFA Cup,11,7,4,1,1,6,4,0
Madagascar,2015,FIFA World Cup qualification,7,7,1,1,2,4,0,0
Madagascar,2015,Indian Ocean Island Games,6,8,1,3,1,5,-2,0
Madagascar,2016,African Cup of Nations qualification,4,10,0,2,2,4,-6,0
Madagascar,2016,COSAFA Cup,1,1,1,1,1,3,0,0
Madagascar,2017,African Cup of Nations qualification,7,3,3,0,0,3,4,0
Madagascar,2017,COSAFA Cup,6,1,2,0,1,3,5,0
Madagascar,2017,Friendly,1,1,0,0,1,1,0,0
Madagascar,2018,African Cup of Nations qualification,5,5,2,1,1,4,0,0
Madagascar,2018,COSAFA Cup,4,4,2,2,2,6,0,0
Madagascar,2018,Friendly,0,1,0,1,1,2,-1,0
Madagascar,2019,African Cup of Nations,7,7,2,1,2,5,0,0
Madagascar,2019,African Cup of Nations qualification,7,4,2,1,0,3,3,0
Madagascar,2019,Friendly,4,7,0,2,1,3,-3,0
Madagascar,2019,Indian Ocean Island Games,1,1,0,0,2,2,0,0
Madagascar,2020,African Cup of Nations qualification,2,3,0,1,1,2,-1,0
Madagascar,2020,Friendly,1,2,0,1,0,1,-1,0
Madagascar,2021,African Cup of Nations qualification,0,4,0,1,1,2,-4,0
Madagascar,2021,FIFA World Cup qualification,4,9,1,4,1,6,-5,0
Madagascar,2022,African Cup of Nations qualification,1,4,0,1,1,2,-3,0
Madagascar,2022,COSAFA Cup,1,4,0,2,0,2,-3,0
Madagascar,2022,Friendly,6,4,1,0,1,2,2,0
Madagascar,2023,African Cup of Nations qualification,0,5,0,2,2,4,-5,0
Madagascar,2023,FIFA World Cup qualification,3,1,1,1,0,2,2,0
Madagascar,2023,Friendly,3,3,1,1,0,2,0,0
Madagascar,2023,Indian Ocean Island Games,7,3,3,0,1,4,4,1
Madagascar,2024,African Cup of Nations qualification,2,4,0,2,2,4,-2,0
Madagascar,2024,FIFA World Cup qualification,2,1,1,0,1,2,1,0
Madagascar,2025,FIFA World Cup qualification,4,4,1,1,0,2,0,0
Madrid,2013,Friendly,1,2,0,1,0,1,-1,0
Malawi,1957,Friendly,0,5,0,1,0,1,-5,0
Malawi,1962,Friendly,2,18,0,2,0,2,-16,0
Malawi,1963,Friendly,1,5,0,1,0,1,-4,0
Malawi,1964,Friendly,0,5,0,1,0,1,-5,0
Malawi,1966,Friendly,3,24,0,5,0,5,-21,0
Malawi,1967,Friendly,0,1,0,1,0,1,-1,0
Malawi,1968,Friendly,10,7,1,2,1,4,3,0
Malawi,1969,Friendly,8,28,1,5,3,9,-20,0
Malawi,1970,Friendly,9,7,2,2,1,5,2,0
Malawi,1971,Friendly,14,15,3,3,2,8,-1,0
Malawi,1972,Friendly,7,2,3,1,0,4,5,0
Malawi,1973,Friendly,6,1,3,0,0,3,5,0
Malawi,1974,Friendly,14,14,2,3,3,8,0,0
Malawi,1975,African Cup of Nations qualification,4,9,0,1,1,2,-5,0
Malawi,1975,CECAFA Cup,11,6,3,0,1,4,5,0
Malawi,1975,Friendly,22,14,5,3,3,11,8,0
Malawi,1976,African Cup of Nations qualification,1,1,0,0,1,1,0,0
Malawi,1976,CECAFA Cup,4,5,0,1,2,3,-1,0
Malawi,1976,FIFA World Cup qualification,0,5,0,2,0,2,-5,0
Malawi,1976,Friendly,21,7,5,1,1,7,14,0
Malawi,1977,African Cup of Nations qualification,2,3,0,1,0,1,-1,0
Malawi,1977,CECAFA Cup,3,2,2,1,1,4,1,0
Malawi,1977,Friendly,19,11,5,1,2,8,8,0
Malawi,1978,African Cup of Nations qualification,6,3,1,1,0,2,3,0
Malawi,1978,All-African Games,4,13,0,5,0,5,-9,0
Malawi,1978,CECAFA Cup,11,6,5,1,0,6,5,1
Malawi,1978,Friendly,13,6,3,1,2,6,7,0
Malawi,1979,African Cup of Nations qualification,0,4,0,2,0,2,-4,0
Malawi,1979,CECAFA Cup,16,3,4,0,1,5,13,1
Malawi,1979,Friendly,10,3,5,2,1,8,7,0
Malawi,1980,African Cup of Nations qualification,1,2,0,1,1,2,-1,0
Malawi,1980,CECAFA Cup,2,1,2,1,0,3,1,0
Malawi,1980,FIFA World Cup qualification,1,4,0,1,1,2,-3,0
Malawi,1980,Friendly,4,3,1,1,2,4,1,0
Malawi,1981,CECAFA Cup,6,4,1,1,1,3,2,0
Malawi,1981,Friendly,24,13,7,2,2,11,11,0
Malawi,1982,African Cup of Nations qualification,4,0,2,0,0,2,4,0
Malawi,1982,CECAFA Cup,4,3,1,1,1,3,1,0
Malawi,1982,Friendly,2,1,1,1,0,2,1,0
Malawi,1983,African Cup of Nations qualification,2,1,1,0,1,2,1,0
Malawi,1983,CECAFA Cup,6,7,2,3,0,5,-1,0
Malawi,1983,Friendly,5,2,3,1,4,8,3,0
Malawi,1984,African Cup of Nations,2,6,0,2,1,3,-4,0
Malawi,1984,CECAFA Cup,6,1,4,0,1,5,5,0
Malawi,1984,FIFA World Cup qualification,5,0,2,0,0,2,5,0
Malawi,1984,Friendly,10,3,5,0,2,7,7,0
Malawi,1985,African Cup of Nations qualification,2,2,0,0,2,2,0,0
Malawi,1985,CECAFA Cup,6,4,2,1,1,4,2,0
Malawi,1985,FIFA World Cup qualification,0,2,0,1,1,2,-2,0
Malawi,1985,Friendly,16,7,3,1,4,8,9,0
Malawi,1986,Friendly,2,6,1,3,2,6,-4,0
Malawi,1987,African Cup of Nations qualification,1,4,0,2,0,2,-3,0
Malawi,1987,All-African Games,8,4,3,1,1,5,4,0
Malawi,1987,CECAFA Cup,3,4,1,1,1,3,-1,0
Malawi,1987,Friendly,10,13,2,2,2,6,-3,0
Malawi,1988,CECAFA Cup,7,1,3,0,1,4,6,1
Malawi,1988,FIFA World Cup qualification,3,2,1,1,0,2,1,0
Malawi,1988,Friendly,9,16,3,3,3,9,-7,0
Malawi,1989,African Cup of Nations qualification,5,4,1,1,2,4,1,0
Malawi,1989,CECAFA Cup,4,3,1,0,3,4,1,0
Malawi,1989,FIFA World Cup qualification,3,4,1,2,3,6,-1,0
Malawi,1989,Friendly,4,8,2,4,1,7,-4,0
Malawi,1990,African Cup of Nations qualification,0,1,0,1,0,1,-1,0
Malawi,1990,CECAFA Cup,2,2,1,1,1,3,0,0
Malawi,1990,Friendly,9,5,3,0,5,8,4,0
Malawi,1991,African Cup of Nations qualification,3,8,0,2,1,3,-5,0
Malawi,1991,CECAFA Cup,1,1,1,1,1,3,0,0
Malawi,1991,Friendly,5,6,2,2,2,6,-1,0
Malawi,1992,African Cup of Nations qualification,2,1,1,0,1,2,1,0
Malawi,1992,CECAFA Cup,7,7,3,1,1,5,0,0
Malawi,1992,Friendly,2,4,1,1,2,4,-2,0
Malawi,1993,African Cup of Nations qualification,2,6,1,3,0,4,-4,0
Malawi,1993,Friendly,12,8,4,2,2,8,4,0
Malawi,1994,African Cup of Nations qualification,4,2,1,0,1,2,2,0
Malawi,1994,Friendly,1,7,0,3,0,3,-6,0
Malawi,1995,African Cup of Nations qualification,2,5,0,2,2,4,-3,0
Malawi,1996,African Cup of Nations qualification,2,1,1,0,0,1,1,0
Malawi,1996,FIFA World Cup qualification,0,4,0,2,0,2,-4,0
Malawi,1996,Friendly,7,5,3,1,2,6,2,0
Malawi,1997,African Cup of Nations qualification,7,9,2,3,0,5,-2,0
Malawi,1997,COSAFA Cup,5,12,0,2,2,4,-7,0
Malawi,1997,COSAFA Cup qualification,4,1,1,0,0,1,3,0
Malawi,1997,Friendly,0,0,0,0,1,1,0,0
Malawi,1998,African Cup of Nations qualification,1,3,0,2,0,2,-2,0
Malawi,1998,COSAFA Cup qualification,0,1,0,1,0,1,-1,0
Malawi,1998,Friendly,6,5,3,1,3,7,1,0
Malawi,1999,COSAFA Cup qualification,2,3,0,1,1,2,-1,0
Malawi,1999,Friendly,4,12,0,5,2,7,-8,0
Malawi,2000,African Cup of Nations qualification,2,5,0,2,0,2,-3,0
Malawi,2000,COSAFA Cup,2,1,1,0,1,2,1,0
Malawi,2000,FIFA World Cup qualification,3,1,1,0,2,3,2,0
Malawi,2000,Friendly,10,15,1,4,2,7,-5,0
Malawi,2001,COSAFA Cup,2,2,2,1,0,3,0,0
Malawi,2001,FIFA World Cup qualification,3,11,0,5,0,5,-8,0
Malawi,2001,Friendly,2,2,0,0,1,1,0,0
Malawi,2002,African Cup of Nations qualification,1,0,1,0,0,1,1,0
Malawi,2002,COSAFA Cup,4,5,2,2,0,4,-1,0
Malawi,2002,Friendly,9,4,4,0,1,5,5,0
Malawi,2003,African Cup of Nations qualification,2,10,0,3,0,3,-8,0
Malawi,2003,COSAFA Cup,3,6,0,2,2,4,-3,0
Malawi,2003,FIFA World Cup qualification,3,1,1,0,1,2,2,0
Malawi,2003,Friendly,3,5,0,2,3,5,-2,0
Malawi,2004,COSAFA Cup,0,2,0,1,0,1,-2,0
Malawi,2004,FIFA World Cup qualification,6,9,0,2,3,5,-3,0
Malawi,2004,Friendly,4,3,1,1,1,3,1,0
Malawi,2005,COSAFA Cup,3,3,1,1,0,2,0,0
Malawi,2005,FIFA World Cup qualification,6,17,1,4,0,5,-11,0
Malawi,2005,Friendly,5,2,2,0,1,3,3,0
Malawi,2006,African Cup of Nations qualification,1,0,1,0,0,1,1,0
Malawi,2006,CECAFA Cup,4,3,1,2,1,4,1,0
Malawi,2006,COSAFA Cup,3,6,0,2,0,2,-3,0
Malawi,2006,Friendly,5,3,2,0,2,4,2,0
Malawi,2007,African Cup of Nations qualification,1,4,0,2,0,2,-3,0
Malawi,2007,COSAFA Cup,0,1,0,1,1,2,-1,0
Malawi,2007,Friendly,6,5,1,2,0,3,1,0
Malawi,2008,COSAFA Cup qualification,2,1,2,1,0,3,1,0
Malawi,2008,FIFA World Cup qualification,14,5,4,2,0,6,9,0
Malawi,2008,Friendly,4,5,1,1,1,3,-1,0
Malawi,2009,COSAFA Cup,0,1,0,1,0,1,-1,0
Malawi,2009,FIFA World Cup qualification,4,11,1,4,1,6,-7,0
Malawi,2009,Friendly,8,6,3,2,1,6,2,0
Malawi,2010,African Cup of Nations,4,5,1,2,0,3,-1,0
Malawi,2010,African Cup of Nations qualification,10,6,1,0,3,4,4,0
Malawi,2010,CECAFA Cup,4,3,1,0,1,2,1,0
Malawi,2010,Friendly,3,4,1,2,1,4,-1,0
Malawi,2011,African Cup of Nations qualification,3,2,1,0,3,4,1,0
Malawi,2011,CECAFA Cup,3,2,1,1,2,4,1,0
Malawi,2011,Friendly,3,3,1,1,2,4,0,0
Malawi,2012,African Cup of Nations qualification,4,6,1,3,0,4,-2,0
Malawi,2012,CECAFA Cup,5,5,2,2,0,4,0,0
Malawi,2012,FIFA World Cup qualification,1,1,0,0,2,2,0,0
Malawi,2012,Friendly,2,4,1,2,1,4,-2,0
Malawi,2013,COSAFA Cup,3,4,0,1,1,2,-1,0
Malawi,2013,FIFA World Cup qualification,3,4,1,1,2,4,-1,0
Malawi,2013,Friendly,2,3,1,2,1,4,-1,0
Malawi,2014,African Cup of Nations qualification,9,13,4,5,1,10,-4,0
Malawi,2014,Friendly,2,6,0,2,2,4,-4,0
Malawi,2015,African Cup of Nations qualification,3,4,0,1,1,2,-1,0
Malawi,2015,CECAFA Cup,5,5,2,2,0,4,0,0
Malawi,2015,COSAFA Cup,3,2,1,0,2,3,1,0
Malawi,2015,FIFA World Cup qualification,1,2,1,1,0,2,-1,0
Malawi,2015,Friendly,3,5,1,2,1,4,-2,0
Malawi,2016,African Cup of Nations qualification,2,5,1,2,1,4,-3,1
Malawi,2016,COSAFA Cup,4,1,2,1,0,3,3,0
Malawi,2017,African Cup of Nations qualification,1,0,1,0,0,1,1,0
Malawi,2017,COSAFA Cup,0,2,0,1,2,3,-2,0
Malawi,2017,Friendly,3,2,1,0,2,3,1,0
Malawi,2018,African Cup of Nations qualification,1,6,0,3,1,4,-5,0
Malawi,2018,COSAFA Cup,1,2,0,1,2,3,-1,0
Malawi,2018,Friendly,0,1,0,1,1,2,-1,0
Malawi,2019,African Cup of Nations qualification,1,2,1,1,1,3,-1,0
Malawi,2019,COSAFA Cup,10,5,3,0,3,6,5,0
Malawi,2019,FIFA World Cup qualification,1,0,1,0,1,2,1,0
Malawi,2019,Friendly,1,1,0,0,1,1,0,0
Malawi,2020,African Cup of Nations qualification,1,3,0,1,1,2,-2,0
Malawi,2020,Friendly,0,1,0,1,1,2,-1,0
Malawi,2021,African Cup of Nations qualification,2,0,2,0,0,2,2,0
Malawi,2021,COSAFA Cup,4,7,0,2,2,4,-3,0
Malawi,2021,FIFA World Cup qualification,2,12,1,5,0,6,-10,0
Malawi,2021,Friendly,2,7,1,2,0,3,-5,1
Malawi,2022,African Cup of Nations,3,4,1,2,1,4,-1,0
Malawi,2022,African Cup of Nations qualification,2,2,1,1,0,2,0,0
Malawi,2022,COSAFA Cup,4,3,1,1,1,3,1,0
Malawi,2023,African Cup of Nations qualification,2,8,0,2,2,4,-6,0
Malawi,2023,COSAFA Cup,6,1,3,0,2,5,5,0
Malawi,2023,FIFA World Cup qualification,1,1,1,1,0,2,0,0
Malawi,2023,Friendly,2,2,0,0,2,2,0,0
Malawi,2024,African Cup of Nations qualification,3,11,0,4,0,4,-8,0
Malawi,2024,FIFA World Cup qualification,3,2,1,1,0,2,1,0
Malawi,2025,FIFA World Cup qualification,0,3,0,2,0,2,-3,0
Malaysia,1953,Friendly,2,3,0,1,0,1,-1,0
Malaysia,1956,AFC Asian Cup qualification,14,12,1,2,1,4,2,0
Malaysia,1957,Friendly,5,4,1,1,0,2,1,0
Malaysia,1957,Merdeka Tournament,10,8,2,1,0,3,2,1
Malaysia,1958,Asian Games,2,8,0,2,0,2,-6,0
Malaysia,1958,Friendly,28,16,5,1,2,8,12,1
Malaysia,1958,Merdeka Tournament,5,2,2,0,1,3,3,1
Malaysia,1959,AFC Asian Cup qualification,5,3,1,1,0,2,2,0
Malaysia,1959,Friendly,3,7,0,2,0,2,-4,0
Malaysia,1959,Merdeka Tournament,5,4,1,0,1,2,1,0
Malaysia,1959,Southeast Asian Peninsular Games,5,5,2,1,0,3,0,0
Malaysia,1960,Friendly,0,5,0,1,1,2,-5,0
Malaysia,1960,Merdeka Tournament,12,2,3,0,1,4,10,0
Malaysia,1961,Friendly,2,3,0,1,0,1,-1,0
Malaysia,1961,Merdeka Tournament,8,7,2,2,0,4,1,0
Malaysia,1961,Southeast Asian Peninsular Games,10,3,3,0,1,4,7,0
Malaysia,1961,Vietnam Independence Cup,3,2,1,1,0,2,1,0
Malaysia,1962,Asian Games,23,9,3,2,0,5,14,0
Malaysia,1962,Friendly,0,1,0,1,0,1,-1,0
Malaysia,1962,Merdeka Tournament,5,4,1,0,2,3,1,0
Malaysia,1962,Vietnam Independence Cup,5,6,1,2,0,3,-1,0
Malaysia,1963,AFC Asian Cup qualification,9,10,1,2,0,3,-1,0
Malaysia,1963,Merdeka Tournament,10,14,1,3,1,5,-4,0
Malaysia,1964,Merdeka Tournament,11,9,2,2,2,6,2,0
Malaysia,1965,Friendly,1,5,0,2,1,3,-4,0
Malaysia,1965,Merdeka Tournament,6,13,0,3,2,5,-7,0
Malaysia,1965,Southeast Asian Peninsular Games,0,4,0,2,0,2,-4,0
Malaysia,1965,Vietnam Independence Cup,2,2,0,0,1,1,0,0
Malaysia,1966,Asian Games,1,5,0,3,0,3,-4,0
Malaysia,1966,Merdeka Tournament,7,4,2,1,2,5,3,0
Malaysia,1966,Vietnam Independence Cup,3,4,0,1,1,2,-1,0
Malaysia,1967,AFC Asian Cup qualification,2,0,1,0,0,1,2,0
Malaysia,1967,Friendly,2,8,0,1,0,1,-6,0
Malaysia,1967,Merdeka Tournament,10,8,3,2,2,7,2,0
Malaysia,1967,Southeast Asian Peninsular Games,1,6,0,2,0,2,-5,0
Malaysia,1967,Vietnam Independence Cup,7,9,2,3,0,5,-2,0
Malaysia,1968,King's Cup,6,16,1,4,0,5,-10,0
Malaysia,1968,Merdeka Tournament,19,7,5,0,2,7,12,1
Malaysia,1969,King's Cup,3,5,0,1,2,3,-2,0
Malaysia,1969,Merdeka Tournament,10,5,3,1,0,4,5,0
Malaysia,1969,Southeast Asian Peninsular Games,4,5,2,1,0,3,-1,0
Malaysia,1970,Asian Games,0,4,0,3,0,3,-4,0
Malaysia,1970,Indonesia Tournament,9,1,3,0,1,4,8,1
Malaysia,1970,King's Cup,6,8,2,2,1,5,-2,1
Malaysia,1970,Merdeka Tournament,13,7,3,2,1,6,6,0
Malaysia,1970,Vietnam Independence Cup,5,6,1,1,1,3,-1,1
Malaysia,1971,AFC Asian Cup qualification,15,3,4,1,0,5,12,0
Malaysia,1971,Friendly,4,11,1,2,0,3,-7,0
Malaysia,1971,Indonesia Tournament,10,12,3,2,1,6,-2,0
Malaysia,1971,King's Cup,2,4,0,1,1,2,-2,0
Malaysia,1971,Korea Cup,11,17,2,3,0,5,-6,0
Malaysia,1971,Merdeka Tournament,2,2,1,1,1,3,0,0
Malaysia,1971,Southeast Asian Peninsular Games,16,6,4,1,0,5,10,0
Malaysia,1971,Vietnam Independence Cup,3,2,1,0,2,3,1,0
Malaysia,1972,Indonesia Tournament,4,3,1,0,1,2,1,0
Malaysia,1972,King's Cup,8,4,4,1,0,5,4,1
Malaysia,1972,Korea Cup,3,7,1,3,1,5,-4,0
Malaysia,1972,Merdeka Tournament,15,5,4,1,0,5,10,0
Malaysia,1972,Vietnam Independence Cup,1,4,0,2,1,3,-3,0
Malaysia,1973,FIFA World Cup qualification,2,4,1,2,1,4,-2,0
Malaysia,1973,Indonesia Tournament,2,4,0,1,1,2,-2,0
Malaysia,1973,King's Cup,5,4,2,1,1,4,1,0
Malaysia,1973,Korea Cup,8,6,2,2,0,4,2,0
Malaysia,1973,Merdeka Tournament,13,6,4,1,2,7,7,1
Malaysia,1973,Southeast Asian Peninsular Games,4,2,1,1,2,4,2,0
Malaysia,1973,Vietnam Independence Cup,7,2,2,0,0,2,5,0
Malaysia,1974,Asian Games,20,13,3,2,2,7,7,0
Malaysia,1974,Indonesia Tournament,3,7,0,2,1,3,-4,0
Malaysia,1974,King's Cup,8,6,2,1,3,6,2,0
Malaysia,1974,Merdeka Tournament,7,3,2,0,0,2,4,0
Malaysia,1974,Vietnam Independence Cup,0,1,0,1,2,3,-1,0
Malaysia,1975,AFC Asian Cup qualification,6,1,3,0,1,4,5,0
Malaysia,1975,Indonesia Tournament,3,6,1,2,1,4,-3,0
Malaysia,1975,King's Cup,1,3,0,2,1,3,-2,0
Malaysia,1975,Merdeka Tournament,14,7,6,2,0,8,7,0
Malaysia,1975,Southeast Asian Peninsular Games,3,3,1,1,1,3,0,0
Malaysia,1976,AFC Asian Cup,1,3,0,1,1,2,-2,0
Malaysia,1976,Friendly,0,2,0,1,0,1,-2,0
Malaysia,1976,Indonesia Tournament,3,4,1,1,0,2,-1,0
Malaysia,1976,King's Cup,8,6,1,1,2,4,2,0
Malaysia,1976,Korea Cup,12,5,2,0,1,3,7,0
Malaysia,1976,Merdeka Tournament,21,6,5,0,2,7,15,1
Malaysia,1977,FIFA World Cup qualification,7,6,1,1,2,4,1,0
Malaysia,1977,King's Cup,9,4,3,0,0,3,5,1
Malaysia,1977,Korea Cup,4,5,1,1,1,3,-1,0
Malaysia,1977,Merdeka Tournament,6,2,2,0,3,5,4,0
Malaysia,1977,Southeast Asian Games,24,3,4,1,0,5,21,1
Malaysia,1978,Asian Games,4,10,2,3,0,5,-6,0
Malaysia,1978,Indonesia Tournament,5,8,0,1,3,4,-3,0
Malaysia,1978,King's Cup,0,1,0,1,0,1,-1,0
Malaysia,1978,Korea Cup,4,3,1,0,1,2,1,0
Malaysia,1978,Merdeka Tournament,20,8,5,2,0,7,12,0
Malaysia,1979,AFC Asian Cup qualification,1,2,0,1,2,3,-1,0
Malaysia,1979,Friendly,1,6,0,2,0,2,-5,0
Malaysia,1979,Merdeka Tournament,13,5,3,0,2,5,8,0
Malaysia,1979,Southeast Asian Games,4,0,3,0,2,5,4,1
Malaysia,1980,AFC Asian Cup,5,5,1,1,2,4,0,0
Malaysia,1980,Friendly,6,1,2,0,0,2,5,0
Malaysia,1980,Korea Cup,3,8,0,2,2,4,-5,0
Malaysia,1980,Merdeka Tournament,12,9,3,1,3,7,3,0
Malaysia,1981,FIFA World Cup qualification,3,8,0,2,1,3,-5,0
Malaysia,1981,Friendly,4,4,1,1,2,4,0,0
Malaysia,1981,King's Cup,2,6,0,3,0,3,-4,0
Malaysia,1981,Korea Cup,0,4,0,2,0,2,-4,0
Malaysia,1981,Merdeka Tournament,4,6,1,3,1,5,-2,0
Malaysia,1981,Southeast Asian Games,5,5,1,1,2,4,0,0
Malaysia,1982,Asian Games,1,4,0,3,0,3,-3,0
Malaysia,1982,Friendly,5,4,1,1,0,2,1,0
Malaysia,1982,King's Cup,0,5,0,1,0,1,-5,0
Malaysia,1982,Korea Cup,1,1,0,0,1,1,0,0
Malaysia,1982,Merdeka Tournament,3,4,2,2,0,4,-1,0
Malaysia,1982,Merlion Cup,5,5,2,1,1,4,0,0
Malaysia,1983,Friendly,1,0,1,0,1,2,1,0
Malaysia,1983,Merdeka Tournament,8,0,2,0,0,2,8,1
Malaysia,1983,Southeast Asian Games,7,3,1,1,2,4,4,0
Malaysia,1984,AFC Asian Cup qualification,10,3,2,1,1,4,7,0
Malaysia,1984,Friendly,3,9,1,2,2,5,-6,0
Malaysia,1984,Merdeka Tournament,10,4,2,0,1,3,6,1
Malaysia,1985,FIFA World Cup qualification,6,2,2,1,1,4,4,0
Malaysia,1985,Korea Cup,1,3,0,1,0,1,-2,0
Malaysia,1985,Merlion Cup,4,6,1,2,0,3,-2,0
Malaysia,1985,Southeast Asian Games,10,3,2,0,2,4,7,0
Malaysia,1986,Asian Games,2,5,0,2,1,3,-3,0
Malaysia,1986,Friendly,3,4,0,1,1,2,-1,0
Malaysia,1986,Merdeka Tournament,7,1,3,0,0,3,6,1
Malaysia,1987,Merdeka Tournament,0,1,0,1,0,1,-1,0
Malaysia,1987,Southeast Asian Games,2,1,1,1,1,3,1,0
Malaysia,1988,AFC Asian Cup qualification,4,6,1,2,1,4,-2,0
Malaysia,1988,King's Cup,0,0,0,0,1,1,0,0
Malaysia,1988,Merdeka Tournament,0,0,0,0,2,2,0,0
Malaysia,1989,FIFA World Cup qualification,8,8,3,2,1,6,0,0
Malaysia,1989,Friendly,0,1,0,1,0,1,-1,0
Malaysia,1989,King's Cup,3,2,1,1,0,2,1,0
Malaysia,1989,Southeast Asian Games,11,2,5,0,0,5,9,1
Malaysia,1990,Asian Games,0,3,0,1,1,2,-3,0
Malaysia,1990,Friendly,0,4,0,2,0,2,-4,0
Malaysia,1991,Friendly,2,6,0,2,0,2,-4,0
Malaysia,1991,Merdeka Tournament,1,2,0,1,0,1,-1,0
Malaysia,1991,Southeast Asian Games,2,4,1,2,0,3,-2,0
Malaysia,1992,AFC Asian Cup qualification,2,6,0,1,2,3,-4,0
Malaysia,1992,Friendly,2,1,1,0,1,2,1,0
Malaysia,1992,Merlion Cup,0,3,0,1,0,1,-3,0
Malaysia,1993,FIFA World Cup qualification,16,7,2,2,2,6,9,0
Malaysia,1993,Friendly,0,2,0,2,0,2,-2,0
Malaysia,1993,Merdeka Tournament,3,2,1,0,1,2,1,0
Malaysia,1993,Southeast Asian Games,13,5,2,2,0,4,8,0
Malaysia,1994,Asian Games,6,11,1,2,1,4,-5,0
Malaysia,1994,Friendly,0,2,0,1,0,1,-2,0
Malaysia,1995,Merdeka Tournament,1,2,0,1,0,1,-1,0
Malaysia,1995,Southeast Asian Games,9,5,1,2,1,4,4,0
Malaysia,1996,AFC Asian Cup qualification,6,3,1,0,1,2,3,0
Malaysia,1996,AFF Championship,18,4,3,1,2,6,14,0
Malaysia,1997,Dunhill Cup,2,4,1,2,1,4,-2,0
Malaysia,1997,FIFA World Cup qualification,5,3,3,1,1,5,2,0
Malaysia,1997,Southeast Asian Games,5,5,2,2,0,4,0,0
Malaysia,1998,AFF Championship,0,3,0,2,1,3,-3,0
Malaysia,1999,Friendly,4,9,2,2,0,4,-5,0
Malaysia,1999,Southeast Asian Games,10,10,2,2,0,4,0,0
Malaysia,2000,AFC Asian Cup qualification,12,13,2,3,1,6,-1,0
Malaysia,2000,AFF Championship,12,4,4,1,1,6,8,1
Malaysia,2000,Friendly,21,7,6,2,1,9,14,0
Malaysia,2000,Merdeka Tournament,2,2,1,1,1,3,0,0
Malaysia,2001,FIFA World Cup qualification,8,11,2,3,1,6,-3,0
Malaysia,2001,Friendly,3,11,1,3,0,4,-8,0
Malaysia,2001,Merdeka Tournament,4,8,0,2,1,3,-4,0
Malaysia,2002,AFF Championship,9,5,2,2,1,5,4,0
Malaysia,2002,Friendly,7,8,1,3,2,6,-1,0
Malaysia,2003,AFC Asian Cup qualification,9,12,1,3,2,6,-3,0
Malaysia,2003,Friendly,1,1,0,0,1,1,0,0
Malaysia,2004,AFF Championship,13,4,4,1,0,5,9,0
Malaysia,2004,FIFA World Cup qualification,2,18,0,6,0,6,-16,0
Malaysia,2004,Friendly,4,5,2,1,1,4,-1,0
Malaysia,2005,AFF Championship,3,5,1,1,0,2,-2,0
Malaysia,2005,Friendly,1,4,0,2,0,2,-3,0
Malaysia,2006,Friendly,1,3,0,2,2,4,-2,0
Malaysia,2006,Merdeka Tournament,2,3,0,1,1,2,-1,0
Malaysia,2007,AFC Asian Cup,1,12,0,3,0,3,-11,0
Malaysia,2007,AFF Championship,6,3,1,1,3,5,3,0
Malaysia,2007,FIFA World Cup qualification,1,4,0,1,1,2,-3,0
Malaysia,2007,Friendly,7,5,1,2,0,3,2,0
Malaysia,2008,AFF Championship,5,6,1,2,0,3,-1,0
Malaysia,2008,Friendly,9,9,1,1,3,5,0,0
Malaysia,2008,Merdeka Tournament,14,0,3,0,0,3,14,1
Malaysia,2009,AFC Asian Cup qualification,2,11,0,3,0,3,-9,0
Malaysia,2009,Friendly,10,3,2,1,3,6,7,0
Malaysia,2010,AFC Asian Cup qualification,0,1,0,1,0,1,-1,0
Malaysia,2010,AFF Championship,12,8,3,2,2,7,4,0
Malaysia,2010,Friendly,1,3,1,1,0,2,-2,0
Malaysia,2011,FIFA World Cup qualification,8,10,1,2,1,4,-2,0
Malaysia,2011,Friendly,8,10,2,2,2,6,-2,0
Malaysia,2012,AFF Championship,7,7,2,2,1,5,0,0
Malaysia,2012,Friendly,16,10,3,3,5,11,6,0
Malaysia,2013,AFC Asian Cup qualification,3,6,1,3,1,5,-3,0
Malaysia,2013,Friendly,1,11,0,4,0,4,-10,0
Malaysia,2014,AFC Asian Cup qualification,2,1,1,0,0,1,1,0
Malaysia,2014,AFF Championship,13,12,3,3,1,7,1,1
Malaysia,2014,Friendly,6,10,1,3,2,6,-4,0
Malaysia,2015,FIFA World Cup qualification,7,27,2,5,0,7,-20,0
Malaysia,2015,Friendly,3,7,1,1,2,4,-4,0
Malaysia,2016,AFC Asian Cup qualification,6,0,2,0,0,2,6,0
Malaysia,2016,AFF Championship,3,4,1,2,0,3,-1,0
Malaysia,2016,FIFA World Cup qualification,0,2,0,1,0,1,-2,0
Malaysia,2016,Friendly,6,7,2,1,5,8,-1,0
Malaysia,2017,AFC Asian Cup qualification,4,13,0,4,1,5,-9,0
Malaysia,2017,Friendly,1,3,0,2,1,3,-2,0
Malaysia,2018,AFC Asian Cup qualification,1,2,0,1,0,1,-1,0
Malaysia,2018,AFF Championship,11,8,3,2,3,8,3,0
Malaysia,2018,Friendly,20,7,5,2,1,8,13,0
Malaysia,2019,FIFA World Cup qualification,20,8,5,2,0,7,12,0
Malaysia,2019,Friendly,11,2,4,1,0,5,9,0
Malaysia,2021,AFF Championship,8,8,2,2,0,4,0,0
Malaysia,2021,FIFA World Cup qualification,2,6,1,2,0,3,-4,0
Malaysia,2021,Friendly,1,11,0,3,0,3,-10,0
Malaysia,2022,AFC Asian Cup qualification,8,4,2,1,0,3,4,0
Malaysia,2022,AFF Championship,6,3,2,1,0,3,3,0
Malaysia,2022,Friendly,16,2,5,1,0,6,14,0
Malaysia,2022,King's Cup,1,1,0,0,2,2,0,0
Malaysia,2023,AFF Championship,5,4,2,1,0,3,1,0
Malaysia,2023,FIFA World Cup qualification,5,3,2,0,0,2,2,0
Malaysia,2023,Friendly,20,4,4,0,2,6,16,0
Malaysia,2024,AFC Asian Cup,3,8,0,2,1,3,-5,0
Malaysia,2024,ASEAN Championship,5,5,1,1,2,4,0,0
Malaysia,2024,FIFA World Cup qualification,4,6,1,2,1,4,-2,0
Malaysia,2024,Friendly,6,8,1,1,2,4,-2,0
Malaysia,2024,Merdeka Tournament,3,1,2,0,0,2,2,0
Malaysia,2025,AFC Asian Cup qualification,2,0,1,0,0,1,2,1
Maldives,1979,Indian Ocean Island Games,1,20,0,3,0,3,-19,0
Maldives,1984,South Asian Games,1,9,1,2,0,3,-8,0
Maldives,1985,Indian Ocean Island Games,2,11,0,1,1,2,-9,0
Maldives,1985,South Asian Games,1,11,0,2,0,2,-10,0
Maldives,1987,South Asian Games,0,6,0,2,0,2,-6,0
Maldives,1989,South Asian Games,0,2,0,1,1,2,-2,0
Maldives,1991,South Asian Games,2,2,2,1,0,3,0,0
Maldives,1993,South Asian Games,1,3,0,1,2,3,-2,0
Maldives,1995,South Asian Games,0,1,0,1,1,2,-1,0
Maldives,1996,AFC Asian Cup qualification,4,30,0,6,0,6,-26,0
Maldives,1997,FIFA World Cup qualification,0,59,0,6,0,6,-59,0
Maldives,1997,SAFF Cup,6,9,1,1,2,4,-3,0
Maldives,1998,Asian Games,0,7,0,2,0,2,-7,0
Maldives,1998,Friendly,2,2,0,0,1,1,0,0
Maldives,1999,SAFF Cup,6,4,2,1,1,4,2,1
Maldives,1999,South Asian Games,8,6,2,2,0,4,2,0
Maldives,2000,AFC Asian Cup qualification,2,24,0,6,0,6,-22,0
Maldives,2000,Friendly,4,8,1,2,3,6,-4,0
Maldives,2001,FIFA World Cup qualification,8,19,1,4,1,6,-11,0
Maldives,2001,Friendly,0,7,0,2,0,2,-7,0
Maldives,2002,Friendly,1,4,0,2,1,3,-3,0
Maldives,2003,AFC Asian Cup qualification,1,3,0,1,1,2,-2,0
Maldives,2003,FIFA World Cup qualification,13,0,2,0,0,2,13,1
Maldives,2003,Friendly,1,4,0,1,0,1,-3,0
Maldives,2003,SAFF Cup,11,4,3,1,1,5,7,0
Maldives,2004,FIFA World Cup qualification,5,14,1,4,1,6,-9,0
Maldives,2004,Friendly,2,10,0,4,1,5,-8,0
Maldives,2005,SAFF Cup,11,2,2,1,1,4,9,0
Maldives,2007,FIFA World Cup qualification,2,3,1,1,0,2,-1,0
Maldives,2007,Friendly,0,1,0,1,0,1,-1,0
Maldives,2008,AFC Asian Cup qualification,1,6,0,2,0,2,-5,0
Maldives,2008,SAFF Cup,9,2,4,1,0,5,7,1
Maldives,2009,AFC Challenge Cup qualification,9,5,2,1,0,3,4,0
Maldives,2009,Friendly,1,1,0,0,1,1,0,0
Maldives,2009,SAFF Cup,9,3,2,0,1,3,6,1
Maldives,2010,Friendly,0,3,0,1,0,1,-3,0
Maldives,2011,AFC Challenge Cup qualification,6,1,2,0,1,3,5,0
Maldives,2011,FIFA World Cup qualification,0,5,0,2,0,2,-5,0
Maldives,2011,Friendly,6,2,2,0,1,3,4,0
Maldives,2011,Indian Ocean Island Games,4,8,0,1,2,3,-4,0
Maldives,2011,SAFF Cup,5,5,1,1,2,4,0,0
Maldives,2012,AFC Challenge Cup,2,5,1,2,0,3,-3,0
Maldives,2012,Friendly,0,3,0,1,0,1,-3,0
Maldives,2012,Nehru Cup,5,8,2,2,0,4,-3,0
Maldives,2013,Friendly,6,6,1,2,1,4,0,0
Maldives,2013,SAFF Cup,18,3,2,1,1,4,15,0
Maldives,2014,AFC Challenge Cup,7,7,1,2,2,5,0,0
Maldives,2015,FIFA World Cup qualification,4,14,1,5,0,6,-10,0
Maldives,2015,Friendly,0,4,0,2,0,2,-4,0
Maldives,2015,Indian Ocean Island Games,3,8,1,2,0,3,-5,0
Maldives,2015,SAFF Cup,9,9,2,2,0,4,0,0
Maldives,2016,AFC Asian Cup qualification,5,5,1,2,1,4,0,0
Maldives,2016,FIFA World Cup qualification,4,6,1,1,0,2,-2,0
Maldives,2016,Friendly,9,6,2,1,0,3,3,0
Maldives,2017,AFC Asian Cup qualification,4,19,1,4,0,5,-15,0
Maldives,2017,Friendly,1,2,0,1,0,1,-1,0
Maldives,2018,AFC Asian Cup qualification,7,0,1,0,0,1,7,0
Maldives,2018,Friendly,2,6,0,2,0,2,-4,0
Maldives,2018,SAFF Cup,5,3,2,1,1,4,2,1
Maldives,2019,FIFA World Cup qualification,6,10,2,3,0,5,-4,0
Maldives,2019,Indian Ocean Island Games,1,10,0,3,0,3,-9,0
Maldives,2021,FIFA World Cup qualification,1,10,0,2,1,3,-9,0
Maldives,2021,Mahinda Rajapaksa Cup,5,6,0,1,2,3,-1,0
Maldives,2021,SAFF Cup,4,4,2,2,0,4,0,0
Maldives,2022,AFC Asian Cup qualification,1,7,1,2,0,3,-6,0
Maldives,2022,Friendly,9,7,3,2,0,5,2,0
Maldives,2023,FIFA World Cup qualification,2,3,0,1,1,2,-1,0
Maldives,2023,Friendly,1,0,1,0,0,1,1,0
Maldives,2023,SAFF Cup,3,4,1,2,0,3,-1,0
Maldives,2024,Friendly,2,2,1,1,0,2,0,0
Maldives,2025,AFC Asian Cup qualification,1,4,0,1,0,1,-3,0
Maldives,2025,Friendly,0,3,0,1,0,1,-3,0
Mali,1960,African Friendship Games,6,6,1,1,0,2,0,0
Mali,1960,Friendly,14,15,4,2,0,6,-1,0
Mali,1961,Friendly,0,3,0,1,0,1,-3,0
Mali,1962,Friendly,5,5,1,3,1,5,0,0
Mali,1963,Friendly,7,11,2,3,0,5,-4,0
Mali,1964,Friendly,1,2,0,1,1,2,-1,0
Mali,1965,African Cup of Nations qualification,4,8,1,3,0,4,-4,0
Mali,1965,All-African Games,10,5,3,1,1,5,5,0
Mali,1965,Friendly,4,2,1,0,1,2,2,0
Mali,1966,Friendly,1,9,1,2,0,3,-8,0
Mali,1967,African Cup of Nations qualification,5,4,2,2,0,4,1,0
Mali,1967,Friendly,4,3,1,0,2,3,1,0
Mali,1969,African Cup of Nations qualification,0,4,0,1,1,2,-4,0
Mali,1970,African Cup of Nations qualification,4,1,2,0,0,2,3,0
Mali,1970,Friendly,1,2,0,1,0,1,-1,0
Mali,1971,African Cup of Nations qualification,3,1,1,0,1,2,2,1
Mali,1971,Friendly,1,4,0,1,0,1,-3,0
Mali,1972,African Cup of Nations,11,11,1,1,3,5,0,0
Mali,1972,Friendly,2,4,1,1,0,2,-2,0
Mali,1973,African Cup of Nations qualification,8,6,1,0,3,4,2,0
Mali,1974,Friendly,4,3,1,0,2,3,1,0
Mali,1975,African Cup of Nations qualification,3,5,1,1,0,2,-2,0
Mali,1975,Friendly,7,6,2,2,0,4,1,0
Mali,1976,Friendly,7,2,3,0,1,4,5,0
Mali,1977,Friendly,3,1,1,0,0,1,2,0
Mali,1978,All-African Games,3,5,0,1,2,3,-2,0
Mali,1978,Friendly,1,3,0,1,0,1,-2,0
Mali,1979,Amílcar Cabral Cup,7,4,3,1,1,5,3,0
Mali,1979,Friendly,3,3,1,1,0,2,0,0
Mali,1980,African Cup of Nations qualification,3,2,1,1,0,2,1,0
Mali,1980,Amílcar Cabral Cup,5,3,2,1,0,3,2,0
Mali,1980,Friendly,6,3,1,1,1,3,3,0
Mali,1981,African Cup of Nations qualification,4,5,1,1,0,2,-1,0
Mali,1981,Amílcar Cabral Cup,9,2,3,0,2,5,7,0
Mali,1982,African Cup of Nations qualification,3,2,1,1,0,2,1,0
Mali,1982,Amílcar Cabral Cup,7,4,2,2,1,5,3,0
Mali,1982,Friendly,5,4,1,0,1,2,1,0
Mali,1983,African Cup of Nations qualification,2,4,1,1,0,2,-2,0
Mali,1983,Amílcar Cabral Cup,5,3,2,2,0,4,2,0
Mali,1983,Friendly,8,9,1,2,7,10,-1,0
Mali,1984,African Cup of Nations qualification,3,2,1,0,1,2,1,0
Mali,1984,Amílcar Cabral Cup,4,1,3,1,1,5,3,0
Mali,1984,Friendly,5,8,1,2,2,5,-3,0
Mali,1985,African Cup of Nations qualification,1,7,0,1,1,2,-6,0
Mali,1985,Amílcar Cabral Cup,9,4,3,1,1,5,5,0
Mali,1985,Friendly,6,5,1,1,2,4,1,0
Mali,1986,Amílcar Cabral Cup,1,2,0,1,1,2,-1,0
Mali,1987,Amílcar Cabral Cup,1,1,1,1,3,5,0,0
Mali,1987,Friendly,9,8,3,4,0,7,1,0
Mali,1988,African Cup of Nations qualification,4,0,2,0,0,2,4,0
Mali,1988,Amílcar Cabral Cup,6,5,1,1,3,5,1,0
Mali,1988,Friendly,3,10,1,2,0,3,-7,0
Mali,1988,Tournament Burkina Faso,3,3,2,2,0,4,0,0
Mali,1989,African Cup of Nations qualification,4,6,0,1,3,4,-2,0
Mali,1989,Amílcar Cabral Cup,9,4,3,0,2,5,5,1
Mali,1990,African Cup of Nations qualification,1,1,0,0,2,2,0,0
Mali,1990,Friendly,2,6,1,1,2,4,-4,0
Mali,1991,African Cup of Nations qualification,1,6,0,3,1,4,-5,0
Mali,1991,Amílcar Cabral Cup,3,2,1,1,1,3,1,0
Mali,1991,Friendly,10,7,2,3,3,8,3,0
Mali,1992,African Cup of Nations qualification,3,2,1,0,1,2,1,0
Mali,1992,Friendly,7,4,4,1,0,5,3,0
Mali,1993,African Cup of Nations qualification,5,5,2,2,0,4,0,0
Mali,1993,Amílcar Cabral Cup,4,4,2,2,1,5,0,0
Mali,1993,Friendly,3,8,1,4,1,6,-5,0
Mali,1994,African Cup of Nations,4,8,2,3,0,5,-4,0
Mali,1994,African Cup of Nations qualification,5,3,2,1,1,4,2,0
Mali,1994,Friendly,8,6,3,2,5,10,2,0
Mali,1995,African Cup of Nations qualification,10,7,3,3,0,6,3,0
Mali,1995,Amílcar Cabral Cup,1,1,1,1,0,2,0,0
Mali,1995,Friendly,8,19,1,8,1,10,-11,0
Mali,1996,African Cup of Nations qualification,2,1,1,0,0,1,1,0
Mali,1996,Friendly,9,9,2,3,3,8,0,0
Mali,1997,African Cup of Nations qualification,7,8,2,3,0,5,-1,0
Mali,1997,Amílcar Cabral Cup,10,3,3,0,2,5,7,1
Mali,1997,Friendly,7,11,2,3,1,6,-4,0
Mali,1998,African Cup of Nations qualification,3,1,1,1,1,3,2,0
Mali,1998,Friendly,8,8,3,4,1,8,0,0
Mali,1999,African Cup of Nations qualification,5,2,2,0,3,5,3,0
Mali,1999,Friendly,7,8,1,2,1,4,-1,0
Mali,2000,Amílcar Cabral Cup,8,11,1,2,2,5,-3,0
Mali,2000,FIFA World Cup qualification,3,4,1,1,0,2,-1,0
Mali,2000,Friendly,2,1,1,0,0,1,1,0
Mali,2001,Amílcar Cabral Cup,7,4,3,1,1,5,3,1
Mali,2001,Friendly,10,10,4,4,1,9,0,0
Mali,2002,African Cup of Nations,5,5,2,2,2,6,0,0
Mali,2002,African Cup of Nations qualification,3,1,1,1,0,2,2,0
Mali,2002,Friendly,12,6,4,0,2,6,6,0
Mali,2003,African Cup of Nations qualification,5,0,3,0,1,4,5,0
Mali,2003,FIFA World Cup qualification,4,1,2,0,0,2,3,0
Mali,2003,Friendly,4,0,3,0,0,3,4,0
Mali,2004,African Cup of Nations,10,10,3,2,1,6,0,0
Mali,2004,FIFA World Cup qualification,3,6,0,3,2,5,-3,0
Mali,2004,Friendly,5,1,2,1,1,4,4,0
Mali,2005,FIFA World Cup qualification,8,8,2,3,0,5,0,0
Mali,2005,Friendly,5,2,1,0,1,2,3,0
Mali,2006,African Cup of Nations qualification,1,0,1,0,1,2,1,0
Mali,2006,Friendly,3,0,3,0,0,3,3,0
Mali,2007,African Cup of Nations qualification,9,1,2,0,2,4,8,0
Mali,2007,Friendly,11,9,3,2,0,5,2,0
Mali,2008,African Cup of Nations,1,3,1,1,1,3,-2,0
Mali,2008,FIFA World Cup qualification,13,8,4,2,0,6,5,0
Mali,2008,Friendly,1,3,0,2,1,3,-2,0
Mali,2009,FIFA World Cup qualification,8,7,2,1,3,6,1,0
Mali,2009,Friendly,9,2,3,1,0,4,7,0
Mali,2010,African Cup of Nations,7,6,1,1,1,3,1,0
Mali,2010,African Cup of Nations qualification,2,2,1,1,0,2,0,0
Mali,2010,Friendly,4,6,1,3,1,5,-2,0
Mali,2011,African Cup of Nations qualification,7,4,2,1,1,4,3,0
Mali,2011,Friendly,3,6,0,2,1,3,-3,0
Mali,2012,African Cup of Nations,6,5,3,2,1,6,1,0
Mali,2012,African Cup of Nations qualification,7,1,2,0,0,2,6,0
Mali,2012,FIFA World Cup qualification,2,2,1,1,0,2,0,0
Mali,2013,African Cup of Nations,7,8,2,2,2,6,-1,0
Mali,2013,FIFA World Cup qualification,5,5,1,1,2,4,0,0
Mali,2013,Friendly,1,6,0,4,0,4,-5,0
Mali,2014,African Cup of Nations qualification,8,6,3,3,0,6,2,0
Mali,2014,Friendly,6,6,1,2,1,4,0,0
Mali,2015,African Cup of Nations,3,3,0,0,3,3,0,0
Mali,2015,African Cup of Nations qualification,3,1,1,0,1,2,2,0
Mali,2015,FIFA World Cup qualification,3,2,1,1,0,2,1,0
Mali,2015,Friendly,8,9,1,2,1,4,-1,0
Mali,2016,African Cup of Nations qualification,10,2,4,0,0,4,8,0
Mali,2016,FIFA World Cup qualification,1,3,0,1,1,2,-2,0
Mali,2016,Friendly,0,1,0,1,0,1,-1,0
Mali,2017,African Cup of Nations,1,2,0,1,2,3,-1,0
Mali,2017,African Cup of Nations qualification,2,1,1,0,0,1,1,0
Mali,2017,FIFA World Cup qualification,0,6,0,1,3,4,-6,0
Mali,2017,Friendly,1,2,0,1,0,1,-1,0
Mali,2018,African Cup of Nations qualification,5,1,2,0,2,4,4,0
Mali,2018,Friendly,1,1,0,0,1,1,0,0
Mali,2019,African Cup of Nations,6,3,2,1,1,4,3,0
Mali,2019,African Cup of Nations qualification,7,2,2,0,1,3,5,0
Mali,2019,Friendly,6,9,0,3,2,5,-3,0
Mali,2020,African Cup of Nations qualification,3,1,2,0,0,2,2,0
Mali,2020,Friendly,3,0,1,0,0,1,3,0
Mali,2021,African Cup of Nations qualification,3,1,1,1,0,2,2,0
Mali,2021,FIFA World Cup qualification,11,0,5,0,1,6,11,0
Mali,2021,Friendly,1,3,0,2,1,3,-2,0
Mali,2022,African Cup of Nations,4,1,2,0,2,4,3,0
Mali,2022,African Cup of Nations qualification,7,1,2,0,0,2,6,0
Mali,2022,FIFA World Cup qualification,0,1,0,1,1,2,-1,0
Mali,2022,Friendly,2,1,1,0,1,2,1,0
Mali,2023,African Cup of Nations qualification,8,1,3,1,0,4,7,0
Mali,2023,FIFA World Cup qualification,4,2,1,0,1,2,2,0
Mali,2023,Friendly,4,1,2,0,0,2,3,0
Mali,2024,African Cup of Nations,6,4,2,1,2,5,2,0
Mali,2024,African Cup of Nations qualification,3,1,2,0,2,4,2,0
Mali,2024,FIFA World Cup qualification,1,2,0,1,1,2,-1,0
Mali,2024,Friendly,8,2,2,0,0,2,6,0
Mali,2025,FIFA World Cup qualification,3,0,1,0,1,2,3,0
Malta,1957,Friendly,2,3,0,1,0,1,-1,0
Malta,1958,Friendly,3,0,1,0,0,1,3,0
Malta,1959,Friendly,0,0,0,0,1,1,0,0
Malta,1960,Friendly,1,0,1,0,0,1,1,0
Malta,1961,Friendly,1,1,0,0,1,1,0,0
Malta,1962,Friendly,0,5,0,1,0,1,-5,0
Malta,1962,UEFA Euro qualification,2,9,0,2,0,2,-7,0
Malta,1964,Friendly,2,2,0,0,1,1,0,0
Malta,1966,Friendly,2,0,2,0,0,2,2,0
Malta,1969,Friendly,1,3,0,1,0,1,-2,0
Malta,1970,Friendly,1,1,0,0,1,1,0,0
Malta,1970,UEFA Euro qualification,2,3,0,1,1,2,-1,0
Malta,1971,FIFA World Cup qualification,0,2,0,1,0,1,-2,0
Malta,1971,Friendly,1,1,0,0,1,1,0,0
Malta,1971,UEFA Euro qualification,0,13,0,4,0,4,-13,0
Malta,1972,FIFA World Cup qualification,0,16,0,4,0,4,-16,0
Malta,1972,Friendly,0,1,0,1,0,1,-1,0
Malta,1973,FIFA World Cup qualification,1,2,0,1,0,1,-1,0
Malta,1973,Friendly,2,0,1,0,1,2,2,0
Malta,1974,Friendly,0,1,0,1,1,2,-1,0
Malta,1974,UEFA Euro qualification,0,1,0,1,0,1,-1,0
Malta,1975,UEFA Euro qualification,2,11,1,3,0,4,-9,0
Malta,1976,FIFA World Cup qualification,0,5,0,2,0,2,-5,0
Malta,1976,Friendly,3,3,0,0,2,2,0,0
Malta,1976,UEFA Euro qualification,0,8,0,1,0,1,-8,0
Malta,1977,FIFA World Cup qualification,0,22,0,4,0,4,-22,0
Malta,1977,Friendly,2,3,1,2,0,3,-1,0
Malta,1978,Friendly,0,1,0,1,0,1,-1,0
Malta,1978,UEFA Euro qualification,0,7,0,1,0,1,-7,0
Malta,1979,Friendly,0,4,0,1,0,1,-4,0
Malta,1979,UEFA Euro qualification,2,6,0,3,1,4,-4,0
Malta,1980,FIFA World Cup qualification,0,2,0,1,0,1,-2,0
Malta,1980,Friendly,0,3,0,1,0,1,-3,0
Malta,1980,UEFA Euro qualification,0,8,0,1,0,1,-8,0
Malta,1981,FIFA World Cup qualification,2,13,0,3,0,3,-11,0
Malta,1981,Friendly,1,0,1,0,0,1,1,0
Malta,1981,Korea Cup,4,1,2,0,1,3,3,1
Malta,1982,Friendly,1,14,0,2,1,3,-13,0
Malta,1982,UEFA Euro qualification,2,7,1,1,0,2,-5,0
Malta,1983,Friendly,1,6,0,2,0,2,-5,0
Malta,1983,UEFA Euro qualification,3,30,0,6,0,6,-27,0
Malta,1984,FIFA World Cup qualification,2,11,0,3,0,3,-9,0
Malta,1984,Friendly,1,2,0,1,0,1,-1,0
Malta,1985,FIFA World Cup qualification,4,14,0,4,1,5,-10,0
Malta,1985,Friendly,3,1,1,0,0,1,2,0
Malta,1986,UEFA Euro qualification,0,7,0,2,0,2,-7,0
Malta,1987,Friendly,1,1,0,0,1,1,0,0
Malta,1987,UEFA Euro qualification,4,14,0,4,2,6,-10,0
Malta,1988,FIFA World Cup qualification,2,5,0,1,1,2,-3,0
Malta,1988,Friendly,5,8,1,3,2,6,-3,0
Malta,1988,Malta International Tournament,4,1,2,0,0,2,3,0
Malta,1989,FIFA World Cup qualification,1,13,0,5,1,6,-12,0
Malta,1989,Friendly,2,8,0,3,1,4,-6,0
Malta,1989,Malta International Tournament,0,3,0,2,1,3,-3,0
Malta,1990,Friendly,1,6,0,3,0,3,-5,0
Malta,1990,Malta International Tournament,2,3,0,1,1,2,-1,0
Malta,1990,UEFA Euro qualification,1,13,0,2,1,3,-12,0
Malta,1991,Friendly,3,4,1,1,0,2,-1,0
Malta,1991,Korea Cup,6,6,1,1,1,3,0,0
Malta,1991,UEFA Euro qualification,1,10,0,4,1,5,-9,0
Malta,1992,FIFA World Cup qualification,1,5,0,2,1,3,-4,0
Malta,1992,Friendly,1,3,1,1,0,2,-2,0
Malta,1992,Malta International Tournament,1,0,1,0,0,1,1,1
Malta,1993,FIFA World Cup qualification,2,18,1,6,0,7,-16,0
Malta,1993,Friendly,2,4,1,1,0,2,-2,0
Malta,1994,Friendly,9,7,2,3,2,7,2,0
Malta,1994,Malta International Tournament,1,3,0,2,1,3,-2,0
Malta,1994,UEFA Euro qualification,1,7,0,2,1,3,-6,0
Malta,1995,Friendly,2,1,1,0,0,1,1,0
Malta,1995,UEFA Euro qualification,1,15,0,6,1,7,-14,0
Malta,1996,FIFA World Cup qualification,0,21,0,4,0,4,-21,0
Malta,1996,Friendly,1,5,0,3,1,4,-4,0
Malta,1996,Malta International Tournament,1,6,0,2,1,3,-5,0
Malta,1997,FIFA World Cup qualification,2,16,0,6,0,6,-14,0
Malta,1997,Friendly,3,10,0,3,0,3,-7,0
Malta,1998,Friendly,1,7,0,3,0,3,-6,0
Malta,1998,Malta International Tournament,4,5,1,1,1,3,-1,0
Malta,1998,UEFA Euro qualification,2,15,0,4,0,4,-13,0
Malta,1999,Friendly,3,6,1,3,1,5,-3,0
Malta,1999,UEFA Euro qualification,4,12,0,4,0,4,-8,0
Malta,2000,FIFA World Cup qualification,0,4,0,2,1,3,-4,0
Malta,2000,Friendly,3,15,1,6,0,7,-12,0
Malta,2000,Malta International Tournament,4,2,1,1,1,3,2,0
Malta,2001,FIFA World Cup qualification,4,20,0,7,0,7,-16,0
Malta,2001,Friendly,2,6,1,2,0,3,-4,0
Malta,2002,Friendly,2,6,1,1,1,3,-4,0
Malta,2002,Malta International Tournament,6,2,2,0,1,3,4,0
Malta,2002,UEFA Euro qualification,1,11,0,4,0,4,-10,0
Malta,2003,Friendly,3,7,0,1,2,3,-4,0
Malta,2003,UEFA Euro qualification,4,13,0,3,1,4,-9,0
Malta,2004,FIFA World Cup qualification,1,13,0,3,1,4,-12,0
Malta,2004,Friendly,3,12,0,3,1,4,-9,0
Malta,2004,Malta International Tournament,5,2,1,0,1,2,3,0
Malta,2005,FIFA World Cup qualification,3,19,0,4,2,6,-16,0
Malta,2005,Friendly,1,4,0,1,1,2,-3,0
Malta,2006,Friendly,1,8,0,3,0,3,-7,0
Malta,2006,Malta International Tournament,0,2,0,1,0,1,-2,0
Malta,2006,UEFA Euro qualification,4,8,1,2,0,3,-4,0
Malta,2007,Friendly,1,5,0,2,1,3,-4,0
Malta,2007,UEFA Euro qualification,6,23,0,7,2,9,-17,0
Malta,2008,FIFA World Cup qualification,0,11,0,4,0,4,-11,0
Malta,2008,Friendly,9,9,1,3,0,4,0,0
Malta,2008,Malta International Tournament,1,2,1,2,0,3,-1,0
Malta,2009,FIFA World Cup qualification,0,15,0,5,1,6,-15,0
Malta,2009,Friendly,4,9,1,4,0,5,-5,0
Malta,2010,Friendly,2,6,0,2,1,3,-4,0
Malta,2010,UEFA Euro qualification,1,9,0,4,0,4,-8,0
Malta,2011,Friendly,2,1,1,0,1,2,1,0
Malta,2011,UEFA Euro qualification,3,12,0,5,1,6,-9,0
Malta,2012,FIFA World Cup qualification,1,6,0,3,0,3,-5,0
Malta,2012,Friendly,8,3,4,0,0,4,5,0
Malta,2013,FIFA World Cup qualification,4,22,1,6,0,7,-18,0
Malta,2013,Friendly,3,5,1,1,1,3,-2,0
Malta,2014,Friendly,0,4,0,3,0,3,-4,0
Malta,2014,UEFA Euro qualification,1,7,0,3,1,4,-6,0
Malta,2015,Friendly,2,4,1,2,0,3,-2,0
Malta,2015,UEFA Euro qualification,2,9,0,5,1,6,-7,0
Malta,2016,FIFA World Cup qualification,1,10,0,4,0,4,-9,0
Malta,2016,Friendly,2,11,0,3,2,5,-9,0
Malta,2017,FIFA World Cup qualification,2,15,0,5,1,6,-13,0
Malta,2017,Friendly,1,3,1,1,0,2,-2,0
Malta,2018,Friendly,1,8,0,3,1,4,-7,0
Malta,2018,UEFA Nations League,5,14,0,3,3,6,-9,0
Malta,2019,UEFA Euro qualification,3,27,1,9,0,10,-24,0
Malta,2020,Friendly,5,0,2,0,0,2,5,0
Malta,2020,UEFA Nations League,8,6,2,1,3,6,2,0
Malta,2021,FIFA World Cup qualification,9,30,1,7,2,10,-21,0
Malta,2021,Friendly,1,5,0,2,0,2,-4,0
Malta,2022,Friendly,7,5,3,2,1,6,2,0
Malta,2022,UEFA Nations League,5,4,2,2,0,4,1,0
Malta,2023,Friendly,2,0,2,0,0,2,2,0
Malta,2023,UEFA Euro qualification,2,20,0,8,0,8,-18,0
Malta,2024,Friendly,5,11,1,2,2,5,-6,0
Malta,2024,UEFA Nations League,2,2,2,1,1,4,0,0
Malta,2025,FIFA World Cup qualification,0,3,0,2,0,2,-3,0
Manchukuo,1939,Friendly,0,6,0,1,0,1,-6,0
Manchukuo,1940,Friendly,0,7,0,1,0,1,-7,0
Manchukuo,1942,Friendly,0,3,0,1,0,1,-3,0
Mapuche,2022,CONIFA South America Football Cup,3,2,1,1,0,2,1,0
Martinique,1931,Friendly,4,4,1,1,1,3,0,0
Martinique,1932,Friendly,0,1,0,1,0,1,-1,0
Martinique,1934,Friendly,6,0,1,0,0,1,6,0
Martinique,1939,Friendly,1,3,0,1,0,1,-2,0
Martinique,1941,Friendly,7,1,2,0,0,2,6,0
Martinique,1948,Friendly,15,6,3,1,0,4,9,0
Martinique,1949,Friendly,2,0,1,0,1,2,2,0
Martinique,1951,Friendly,4,1,1,0,1,2,3,0
Martinique,1952,Friendly,1,6,0,2,0,2,-5,0
Martinique,1953,Friendly,6,3,2,0,0,2,3,0
Martinique,1954,Friendly,6,4,1,0,1,2,2,0
Martinique,1955,Friendly,5,2,1,0,1,2,3,0
Martinique,1956,Friendly,7,9,1,3,1,5,-2,0
Martinique,1957,Friendly,8,6,1,1,0,2,2,0
Martinique,1958,Friendly,1,1,0,0,1,1,0,0
Martinique,1959,Friendly,11,8,3,3,0,6,3,0
Martinique,1960,Friendly,6,7,1,1,4,6,-1,0
Martinique,1961,Friendly,2,2,0,0,1,1,0,0
Martinique,1962,Friendly,7,5,1,2,0,3,2,0
Martinique,1963,Friendly,6,3,1,1,0,2,3,0
Martinique,1964,Friendly,5,0,2,0,0,2,5,0
Martinique,1967,Friendly,15,10,4,1,1,6,5,0
Martinique,1968,Friendly,12,15,2,3,1,6,-3,0
Martinique,1969,Friendly,0,0,0,0,1,1,0,0
Martinique,1971,Friendly,5,4,1,0,2,3,1,0
Martinique,1972,Friendly,4,6,0,2,1,3,-2,0
Martinique,1973,Friendly,2,2,1,1,0,2,0,0
Martinique,1975,Friendly,10,3,2,0,0,2,7,0
Martinique,1976,Friendly,4,2,2,0,0,2,2,0
Martinique,1977,Friendly,6,1,3,0,0,3,5,0
Martinique,1978,CFU Caribbean Cup qualification,0,0,0,0,2,2,0,0
Martinique,1978,Friendly,14,11,3,3,0,6,3,0
Martinique,1979,CFU Caribbean Cup qualification,2,3,0,1,1,2,-1,0
Martinique,1979,Friendly,6,2,3,0,1,4,4,0
Martinique,1980,Friendly,1,0,1,0,0,1,1,0
Martinique,1981,CFU Caribbean Cup qualification,2,4,0,2,0,2,-2,0
Martinique,1983,CFU Caribbean Cup,5,1,2,0,1,3,4,0
Martinique,1983,CFU Caribbean Cup qualification,15,1,3,0,0,3,14,0
Martinique,1983,Friendly,4,4,0,0,1,1,0,0
Martinique,1985,CFU Caribbean Cup,5,2,2,0,1,3,3,0
Martinique,1986,Friendly,0,1,0,1,0,1,-1,0
Martinique,1987,Friendly,1,1,0,0,1,1,0,0
Martinique,1988,CFU Caribbean Cup,4,6,1,1,1,3,-2,0
Martinique,1989,CFU Caribbean Cup qualification,11,3,1,1,1,3,8,0
Martinique,1989,Friendly,0,2,0,1,0,1,-2,0
Martinique,1990,CFU Caribbean Cup,2,2,0,0,1,1,0,0
Martinique,1990,CFU Caribbean Cup qualification,4,0,1,0,1,2,4,0
Martinique,1990,Friendly,2,1,1,1,0,2,1,0
Martinique,1991,CFU Caribbean Cup,4,2,1,1,1,3,2,0
Martinique,1991,CFU Caribbean Cup qualification,4,3,1,1,0,2,1,1
Martinique,1991,Friendly,0,0,0,0,1,1,0,0
Martinique,1992,CFU Caribbean Cup,5,3,1,1,1,3,2,0
Martinique,1992,CFU Caribbean Cup qualification,8,1,1,0,1,2,7,0
Martinique,1993,CFU Caribbean Cup,6,3,2,0,2,4,3,0
Martinique,1993,CFU Caribbean Cup qualification,6,2,2,0,0,2,4,0
Martinique,1993,Friendly,1,1,0,0,1,1,0,0
Martinique,1993,Gold Cup,3,14,0,2,1,3,-11,0
Martinique,1994,CFU Caribbean Cup,12,10,3,1,1,5,2,0
Martinique,1995,CFU Caribbean Cup qualification,5,4,1,1,1,3,1,0
Martinique,1996,CFU Caribbean Cup,3,4,1,2,1,4,-1,0
Martinique,1996,CFU Caribbean Cup qualification,2,0,2,0,0,2,2,0
Martinique,1997,CFU Caribbean Cup,2,3,1,1,0,2,-1,0
Martinique,1997,CFU Caribbean Cup qualification,10,1,3,0,0,3,9,1
Martinique,1997,Friendly,8,6,3,1,0,4,2,0
Martinique,1998,CFU Caribbean Cup,7,8,1,2,0,3,-1,0
Martinique,1998,CFU Caribbean Cup qualification,6,2,2,0,0,2,4,0
Martinique,1999,CFU Caribbean Cup qualification,6,5,2,1,0,3,1,0
Martinique,2001,CFU Caribbean Cup,6,8,3,2,0,5,-2,0
Martinique,2001,CFU Caribbean Cup qualification,7,1,1,0,1,2,6,0
Martinique,2001,Friendly,9,4,2,0,1,3,5,0
Martinique,2001,SKN Football Festival,2,4,0,1,1,2,-2,0
Martinique,2002,Friendly,12,7,3,1,1,5,5,0
Martinique,2002,Gold Cup,2,3,1,1,1,3,-1,0
Martinique,2002,Gold Cup qualification,8,2,2,1,0,3,6,0
Martinique,2003,Friendly,5,4,1,0,1,2,1,0
Martinique,2003,Gold Cup,0,3,0,2,0,2,-3,0
Martinique,2003,Gold Cup qualification,13,14,2,2,1,5,-1,0
Martinique,2004,CFU Caribbean Cup qualification,5,5,1,2,2,5,0,0
Martinique,2004,Friendly,0,2,0,1,1,2,-2,0
Martinique,2006,CFU Caribbean Cup qualification,7,4,4,1,1,6,3,0
Martinique,2006,Friendly,4,4,0,0,3,3,0,0
Martinique,2007,CFU Caribbean Cup,4,8,1,2,0,3,-4,0
Martinique,2007,Friendly,3,0,1,0,0,1,3,0
Martinique,2008,CFU Caribbean Cup qualification,7,6,2,1,1,4,1,0
Martinique,2008,Coupe de l'Outre-Mer,3,2,2,1,1,4,1,0
Martinique,2008,Friendly,2,2,1,1,0,2,0,0
Martinique,2009,Friendly,0,0,0,0,1,1,0,0
Martinique,2010,CFU Caribbean Cup,1,3,0,2,1,3,-2,0
Martinique,2010,Coupe de l'Outre-Mer,8,3,2,1,1,4,5,0
Martinique,2010,Friendly,6,4,1,0,3,4,2,0
Martinique,2011,Friendly,2,2,1,1,0,2,0,0
Martinique,2012,CFU Caribbean Cup,5,3,2,1,2,5,2,0
Martinique,2012,CFU Caribbean Cup qualification,29,7,3,0,3,6,22,0
Martinique,2012,Coupe de l'Outre-Mer,9,5,2,1,1,4,4,0
Martinique,2012,Friendly,4,4,1,1,1,3,0,0
Martinique,2013,Gold Cup,2,4,1,2,0,3,-2,0
Martinique,2014,CFU Caribbean Cup,2,3,1,1,0,2,-1,0
Martinique,2014,CFU Caribbean Cup qualification,1,1,0,0,1,1,0,0
Martinique,2014,Friendly,3,0,2,0,1,3,3,0
Martinique,2015,Friendly,2,0,1,0,0,1,2,0
Martinique,2016,CFU Caribbean Cup qualification,11,2,4,0,0,4,9,0
Martinique,2016,Friendly,1,3,0,1,1,2,-2,0
Martinique,2017,CFU Caribbean Cup,1,3,0,2,0,2,-2,0
Martinique,2017,Friendly,5,3,1,1,1,3,2,0
Martinique,2017,Gold Cup,4,6,1,2,0,3,-2,0
Martinique,2018,CONCACAF Nations League qualification,9,2,3,0,0,3,7,0
Martinique,2018,Friendly,3,0,1,0,1,2,3,0
Martinique,2019,CONCACAF Nations League,4,5,0,1,3,4,-1,0
Martinique,2019,CONCACAF Nations League qualification,1,0,1,0,0,1,1,0
Martinique,2019,Gold Cup,5,7,1,2,0,3,-2,0
Martinique,2021,Gold Cup,3,12,0,3,0,3,-9,0
Martinique,2022,CONCACAF Nations League,0,7,0,2,1,3,-7,0
Martinique,2023,CONCACAF Nations League,3,5,2,2,1,5,-2,0
Martinique,2023,Gold Cup,7,9,1,2,0,3,-2,0
Martinique,2023,Gold Cup qualification,5,1,2,0,0,2,4,0
Martinique,2024,CONCACAF Nations League,4,5,1,1,2,4,-1,0
Martinique,2024,Friendly,1,1,0,0,1,1,0,0
Martinique,2025,Gold Cup qualification,0,2,0,2,0,2,-2,0
Matabeleland,2018,CONIFA World Football Cup,5,12,2,2,1,5,-7,1
Matabeleland,2022,CONIFA Africa Football Cup,2,2,1,1,1,3,0,0
Maule Sur,2022,CONIFA South America Football Cup,2,0,2,0,0,2,2,1
Mauritania,1961,African Friendship Games,1,12,0,2,0,2,-11,0
Mauritania,1963,African Friendship Games,0,19,0,4,0,4,-19,0
Mauritania,1967,Friendly,1,1,0,0,1,1,0,0
Mauritania,1976,FIFA World Cup qualification,1,3,0,1,1,2,-2,0
Mauritania,1976,Friendly,1,8,0,2,0,2,-7,0
Mauritania,1977,Friendly,1,2,0,1,0,1,-1,0
Mauritania,1979,African Cup of Nations qualification,3,6,0,1,1,2,-3,0
Mauritania,1979,Amílcar Cabral Cup,4,11,0,3,0,3,-7,0
Mauritania,1980,African Cup of Nations qualification,2,3,1,1,0,2,-1,0
Mauritania,1980,Amílcar Cabral Cup,4,4,1,1,1,3,0,0
Mauritania,1980,Friendly,1,6,0,2,0,2,-5,0
Mauritania,1981,Amílcar Cabral Cup,4,8,0,3,0,3,-4,0
Mauritania,1982,Amílcar Cabral Cup,3,8,1,2,0,3,-5,0
Mauritania,1983,Amílcar Cabral Cup,3,6,1,3,0,4,-3,0
Mauritania,1983,Friendly,3,6,1,2,2,5,-3,0
Mauritania,1984,African Cup of Nations qualification,4,3,1,1,0,2,1,0
Mauritania,1984,Amílcar Cabral Cup,1,9,0,3,0,3,-8,0
Mauritania,1984,Friendly,2,7,0,3,4,7,-5,0
Mauritania,1985,African Cup of Nations qualification,1,5,0,1,1,2,-4,0
Mauritania,1985,Amílcar Cabral Cup,0,6,0,3,0,3,-6,0
Mauritania,1985,Arab Cup,0,4,0,2,0,2,-4,0
Mauritania,1985,Friendly,0,0,0,0,1,1,0,0
Mauritania,1986,Amílcar Cabral Cup,1,5,0,3,0,3,-4,0
Mauritania,1987,Amílcar Cabral Cup,1,3,0,2,1,3,-2,0
Mauritania,1987,Arab Cup qualification,1,5,0,2,0,2,-4,0
Mauritania,1987,Friendly,1,2,0,1,0,1,-1,0
Mauritania,1988,Amílcar Cabral Cup,5,6,0,1,2,3,-1,0
Mauritania,1989,Amílcar Cabral Cup,2,5,0,2,0,2,-3,0
Mauritania,1990,African Cup of Nations qualification,4,15,1,4,0,5,-11,0
Mauritania,1991,African Cup of Nations qualification,0,3,0,2,0,2,-3,0
Mauritania,1991,Friendly,0,2,0,1,1,2,-2,0
Mauritania,1993,Amílcar Cabral Cup,0,5,0,2,1,3,-5,0
Mauritania,1993,Friendly,4,2,1,0,0,1,2,0
Mauritania,1994,African Cup of Nations qualification,1,1,0,0,2,2,0,0
Mauritania,1994,Friendly,1,3,0,1,2,3,-2,0
Mauritania,1995,African Cup of Nations qualification,2,5,1,3,2,6,-3,0
Mauritania,1995,Amílcar Cabral Cup,4,2,2,0,2,4,2,0
Mauritania,1995,Friendly,2,6,1,2,0,3,-4,0
Mauritania,1996,African Cup of Nations qualification,1,4,0,1,1,2,-3,0
Mauritania,1996,FIFA World Cup qualification,0,2,0,1,1,2,-2,0
Mauritania,1996,Friendly,0,0,0,0,1,1,0,0
Mauritania,1997,Amílcar Cabral Cup,4,5,0,1,2,3,-1,0
Mauritania,1997,Friendly,1,3,0,1,0,1,-2,0
Mauritania,2000,Amílcar Cabral Cup,3,4,0,1,2,3,-1,0
Mauritania,2000,FIFA World Cup qualification,1,5,0,2,0,2,-4,0
Mauritania,2000,Friendly,0,0,0,0,2,2,0,0
Mauritania,2001,Amílcar Cabral Cup,2,6,0,3,0,3,-4,0
Mauritania,2001,Friendly,0,1,0,1,0,1,-1,0
Mauritania,2002,African Cup of Nations qualification,0,3,0,2,0,2,-3,0
Mauritania,2002,Friendly,1,4,0,2,0,2,-3,0
Mauritania,2003,African Cup of Nations qualification,0,7,0,2,2,4,-7,0
Mauritania,2003,FIFA World Cup qualification,2,4,1,1,0,2,-2,0
Mauritania,2003,Friendly,1,4,0,1,0,1,-3,0
Mauritania,2006,African Cup of Nations qualification,1,3,0,1,0,1,-2,0
Mauritania,2006,Arab Cup qualification,8,4,1,1,1,3,4,1
Mauritania,2007,African Cup of Nations qualification,4,7,1,2,1,4,-3,0
Mauritania,2007,Friendly,0,0,0,0,1,1,0,0
Mauritania,2008,FIFA World Cup qualification,2,12,0,4,0,4,-10,0
Mauritania,2010,Friendly,0,0,0,0,1,1,0,0
Mauritania,2012,Friendly,0,5,0,2,0,2,-5,0
Mauritania,2013,Friendly,3,3,2,2,3,7,0,0
Mauritania,2014,African Cup of Nations qualification,4,6,3,3,0,6,-2,0
Mauritania,2014,Friendly,1,1,0,0,1,1,0,0
Mauritania,2015,African Cup of Nations qualification,3,2,1,1,0,2,1,0
Mauritania,2015,FIFA World Cup qualification,7,5,1,2,1,4,2,0
Mauritania,2015,Friendly,2,1,1,1,0,2,1,0
Mauritania,2016,African Cup of Nations qualification,3,3,1,1,2,4,0,0
Mauritania,2016,Friendly,2,4,1,1,1,3,-2,0
Mauritania,2017,African Cup of Nations qualification,1,0,1,0,0,1,1,0
Mauritania,2017,Friendly,5,17,2,6,1,9,-12,0
Mauritania,2018,African Cup of Nations qualification,6,5,3,1,0,4,1,0
Mauritania,2018,Friendly,2,0,1,0,0,1,2,0
Mauritania,2019,African Cup of Nations,1,4,0,1,2,3,-3,0
Mauritania,2019,African Cup of Nations qualification,2,1,1,1,1,3,1,0
Mauritania,2019,Friendly,5,8,1,3,1,5,-3,0
Mauritania,2020,African Cup of Nations qualification,2,4,0,1,1,2,-2,0
Mauritania,2020,Friendly,2,1,1,0,0,1,1,0
Mauritania,2021,African Cup of Nations qualification,1,0,1,0,1,2,1,0
Mauritania,2021,Arab Cup,3,7,1,2,0,3,-4,0
Mauritania,2021,Arab Cup qualification,2,0,1,0,0,1,2,0
Mauritania,2021,FIFA World Cup qualification,2,11,0,4,2,6,-9,0
Mauritania,2021,Friendly,2,4,1,1,1,3,-2,0
Mauritania,2022,African Cup of Nations,0,7,0,3,0,3,-7,0
Mauritania,2022,African Cup of Nations qualification,3,0,1,0,1,2,3,0
Mauritania,2022,Friendly,8,2,4,0,1,5,6,0
Mauritania,2023,African Cup of Nations qualification,7,5,2,1,1,4,2,0
Mauritania,2023,FIFA World Cup qualification,0,2,0,1,1,2,-2,0
Mauritania,2023,Friendly,3,3,1,1,0,2,0,0
Mauritania,2024,African Cup of Nations,3,5,1,3,0,4,-2,0
Mauritania,2024,African Cup of Nations qualification,1,5,1,3,0,4,-4,0
Mauritania,2024,FIFA World Cup qualification,0,3,0,2,0,2,-3,0
Mauritania,2024,Friendly,0,2,0,1,2,3,-2,0
Mauritania,2025,FIFA World Cup qualification,2,4,0,1,1,2,-2,0
Mauritius,1947,Friendly,4,2,2,0,0,2,2,0
Mauritius,1948,Friendly,9,2,2,0,0,2,7,0
Mauritius,1949,Friendly,9,1,2,0,0,2,8,0
Mauritius,1950,Friendly,20,3,2,0,0,2,17,0
Mauritius,1951,Friendly,17,3,2,0,0,2,14,0
Mauritius,1952,Friendly,13,0,2,0,0,2,13,0
Mauritius,1953,Friendly,12,6,2,0,0,2,6,0
Mauritius,1954,Friendly,15,1,2,0,0,2,14,0
Mauritius,1955,Friendly,4,3,1,1,0,2,1,0
Mauritius,1956,Friendly,11,6,1,0,1,2,5,0
Mauritius,1957,Friendly,6,0,3,0,0,3,6,0
Mauritius,1958,Friendly,4,3,1,1,0,2,1,0
Mauritius,1963,Friendly,0,2,0,1,0,1,-2,0
Mauritius,1967,African Cup of Nations qualification,1,2,0,1,1,2,-1,0
Mauritius,1967,Friendly,5,5,2,1,0,3,0,0
Mauritius,1968,African Cup of Nations qualification,4,5,0,1,1,2,-1,0
Mauritius,1970,African Cup of Nations qualification,5,3,1,1,0,2,2,0
Mauritius,1970,Friendly,0,1,0,1,1,2,-1,0
Mauritius,1971,African Cup of Nations qualification,1,2,0,1,1,2,-1,0
Mauritius,1971,Friendly,1,4,0,1,1,2,-3,0
Mauritius,1972,FIFA World Cup qualification,3,5,0,1,1,2,-2,0
Mauritius,1972,Friendly,2,5,0,2,0,2,-3,0
Mauritius,1973,African Cup of Nations qualification,7,3,1,0,3,4,4,0
Mauritius,1973,Friendly,2,6,0,2,1,3,-4,0
Mauritius,1974,African Cup of Nations,2,8,0,3,0,3,-6,0
Mauritius,1974,Friendly,8,4,2,0,1,3,4,0
Mauritius,1975,African Cup of Nations qualification,1,5,0,1,1,2,-4,0
Mauritius,1975,Friendly,1,5,0,2,1,3,-4,0
Mauritius,1976,African Cup of Nations qualification,1,1,0,0,1,1,0,0
Mauritius,1976,Friendly,2,3,1,1,0,2,-1,0
Mauritius,1977,African Cup of Nations qualification,5,6,1,2,0,3,-1,0
Mauritius,1977,Friendly,4,1,2,0,0,2,3,0
Mauritius,1978,African Cup of Nations qualification,2,2,1,1,0,2,0,1
Mauritius,1978,Friendly,7,5,2,1,0,3,2,0
Mauritius,1979,African Cup of Nations qualification,3,6,1,1,0,2,-3,0
Mauritius,1979,Indian Ocean Island Games,7,2,2,0,1,3,5,0
Mauritius,1980,African Cup of Nations qualification,1,1,0,0,2,2,0,0
Mauritius,1981,Friendly,3,3,1,1,1,3,0,0
Mauritius,1982,Friendly,3,1,1,0,1,2,2,0
Mauritius,1983,African Cup of Nations qualification,1,1,1,1,0,2,0,0
Mauritius,1983,Friendly,4,3,1,0,2,3,1,0
Mauritius,1984,African Cup of Nations qualification,0,3,0,1,1,2,-3,0
Mauritius,1984,FIFA World Cup qualification,0,5,0,2,0,2,-5,0
Mauritius,1985,Indian Ocean Island Games,10,6,2,0,1,3,4,0
Mauritius,1986,Friendly,0,1,0,1,1,2,-1,0
Mauritius,1987,Friendly,0,0,0,0,1,1,0,0
Mauritius,1988,African Cup of Nations qualification,3,1,1,1,0,2,2,0
Mauritius,1989,African Cup of Nations qualification,1,5,0,2,0,2,-4,0
Mauritius,1990,Friendly,4,5,2,1,0,3,-1,0
Mauritius,1990,Indian Ocean Island Games,7,5,2,1,0,3,2,0
Mauritius,1991,Friendly,3,9,1,3,0,4,-6,0
Mauritius,1992,African Cup of Nations qualification,1,4,0,2,0,2,-3,0
Mauritius,1992,Friendly,2,3,0,1,1,2,-1,0
Mauritius,1993,African Cup of Nations qualification,1,8,0,3,1,4,-7,0
Mauritius,1993,Indian Ocean Island Games,10,5,2,2,0,4,5,0
Mauritius,1994,African Cup of Nations qualification,0,3,0,1,0,1,-3,0
Mauritius,1995,African Cup of Nations qualification,0,8,0,3,0,3,-8,0
Mauritius,1996,African Cup of Nations qualification,3,3,1,1,1,3,0,0
Mauritius,1996,FIFA World Cup qualification,1,7,0,2,0,2,-6,0
Mauritius,1996,Friendly,0,0,0,0,1,1,0,0
Mauritius,1997,African Cup of Nations qualification,3,10,0,4,1,5,-7,0
Mauritius,1997,Friendly,1,0,1,0,0,1,1,0
Mauritius,1998,African Cup of Nations qualification,4,4,1,1,1,3,0,0
Mauritius,1998,Indian Ocean Island Games,3,11,0,4,0,4,-8,0
Mauritius,1999,African Cup of Nations qualification,6,6,1,1,3,5,0,0
Mauritius,1999,Friendly,5,5,1,1,0,2,0,0
Mauritius,2000,African Cup of Nations qualification,5,8,2,2,0,4,-3,0
Mauritius,2000,COSAFA Cup,0,3,0,1,0,1,-3,0
Mauritius,2000,FIFA World Cup qualification,2,6,0,2,0,2,-4,0
Mauritius,2000,Friendly,1,2,0,1,1,2,-1,0
Mauritius,2001,African Cup of Nations qualification,1,6,0,2,2,4,-5,0
Mauritius,2001,COSAFA Cup,1,1,1,1,0,2,0,0
Mauritius,2002,African Cup of Nations qualification,0,1,0,1,0,1,-1,0
Mauritius,2002,COSAFA Cup,2,3,0,1,0,1,-1,0
Mauritius,2002,Friendly,3,1,2,0,2,4,2,0
Mauritius,2003,African Cup of Nations qualification,2,8,1,2,0,3,-6,0
Mauritius,2003,COSAFA Cup,1,2,0,1,0,1,-1,0
Mauritius,2003,FIFA World Cup qualification,3,4,1,1,0,2,-1,0
Mauritius,2003,Indian Ocean Island Games,10,2,3,0,1,4,8,1
Mauritius,2004,COSAFA Cup,3,3,1,1,0,2,0,0
Mauritius,2005,COSAFA Cup,2,1,1,1,0,2,1,0
Mauritius,2005,Friendly,3,4,1,1,1,3,-1,0
Mauritius,2006,African Cup of Nations qualification,1,2,0,1,1,2,-1,0
Mauritius,2006,COSAFA Cup,1,5,0,1,1,2,-4,0
Mauritius,2006,Friendly,2,4,0,2,0,2,-2,0
Mauritius,2007,African Cup of Nations qualification,2,8,0,3,1,4,-6,0
Mauritius,2007,COSAFA Cup,0,2,0,1,1,2,-2,0
Mauritius,2007,Friendly,1,4,0,1,1,2,-3,0
Mauritius,2007,Indian Ocean Island Games,4,3,1,2,1,4,1,0
Mauritius,2008,COSAFA Cup qualification,2,10,0,2,1,3,-8,0
Mauritius,2008,FIFA World Cup qualification,3,17,0,5,1,6,-14,0
Mauritius,2008,Friendly,1,2,0,1,0,1,-1,0
Mauritius,2009,COSAFA Cup,0,4,0,2,0,2,-4,0
Mauritius,2009,Friendly,0,4,0,1,0,1,-4,0
Mauritius,2010,African Cup of Nations qualification,1,10,0,2,0,2,-9,0
Mauritius,2011,African Cup of Nations qualification,1,12,0,4,0,4,-11,0
Mauritius,2011,Indian Ocean Island Games,5,4,1,1,3,5,1,0
Mauritius,2013,COSAFA Cup,5,2,1,1,0,2,3,0
Mauritius,2013,Friendly,0,3,0,1,0,1,-3,0
Mauritius,2014,African Cup of Nations qualification,0,3,0,2,0,2,-3,0
Mauritius,2015,African Cup of Nations qualification,2,7,1,1,0,2,-5,0
Mauritius,2015,COSAFA Cup,1,4,1,2,0,3,-3,0
Mauritius,2015,FIFA World Cup qualification,2,5,0,1,1,2,-3,0
Mauritius,2015,Friendly,3,3,0,0,2,2,0,0
Mauritius,2015,Indian Ocean Island Games,7,4,2,2,0,4,3,0
Mauritius,2016,African Cup of Nations qualification,1,8,1,3,0,4,-7,0
Mauritius,2016,COSAFA Cup,2,4,1,2,0,3,-2,0
Mauritius,2017,African Cup of Nations qualification,1,3,0,1,1,2,-2,0
Mauritius,2017,COSAFA Cup,1,2,0,1,2,3,-1,0
Mauritius,2017,Friendly,3,12,0,3,1,4,-9,0
Mauritius,2018,COSAFA Cup,1,7,1,2,0,3,-6,0
Mauritius,2018,Friendly,4,2,2,1,1,4,2,0
Mauritius,2019,African Cup of Nations qualification,2,5,0,2,0,2,-3,0
Mauritius,2019,COSAFA Cup,3,4,0,1,1,2,-1,0
Mauritius,2019,FIFA World Cup qualification,0,3,0,2,0,2,-3,0
Mauritius,2019,Friendly,3,2,1,1,0,2,1,0
Mauritius,2019,Indian Ocean Island Games,4,3,1,0,3,4,1,0
Mauritius,2022,African Cup of Nations qualification,6,3,1,0,1,2,3,0
Mauritius,2022,COSAFA Cup,1,7,0,3,0,3,-6,0
Mauritius,2022,Friendly,0,2,0,2,1,3,-2,0
Mauritius,2023,COSAFA Cup,1,3,1,2,0,3,-2,0
Mauritius,2023,FIFA World Cup qualification,0,3,0,1,1,2,-3,0
Mauritius,2023,Indian Ocean Island Games,5,3,2,1,1,4,2,0
Mauritius,2023,Mauritius Four Nations Cup,5,3,2,1,0,3,2,1
Mauritius,2024,African Cup of Nations qualification,1,3,0,2,0,2,-2,0
Mauritius,2024,FIFA World Cup qualification,3,3,1,1,0,2,0,0
Mauritius,2024,Friendly,0,1,0,1,0,1,-1,0
Mauritius,2024,Intercontinental Cup,0,2,0,1,1,2,-2,0
Mauritius,2025,FIFA World Cup qualification,3,4,0,1,1,2,-1,0
Mayotte,2001,Friendly,0,1,0,1,0,1,-1,0
Mayotte,2003,Friendly,1,1,0,0,1,1,0,0
Mayotte,2006,Friendly,1,3,0,1,0,1,-2,0
Mayotte,2007,Friendly,2,2,0,0,1,1,0,0
Mayotte,2007,Indian Ocean Island Games,3,7,1,2,1,4,-4,0
Mayotte,2008,Coupe de l'Outre-Mer,5,13,0,3,0,3,-8,0
Mayotte,2009,Friendly,2,4,0,1,1,2,-2,0
Mayotte,2010,Coupe de l'Outre-Mer,13,8,1,2,1,4,5,0
Mayotte,2010,Friendly,0,0,0,0,1,1,0,0
Mayotte,2011,Indian Ocean Island Games,3,2,1,1,2,4,1,0
Mayotte,2012,Coupe de l'Outre-Mer,5,5,2,2,0,4,0,0
Mayotte,2015,Indian Ocean Island Games,8,6,3,1,1,5,2,0
Mayotte,2019,Indian Ocean Island Games,8,4,3,2,0,5,4,0
Mayotte,2023,Indian Ocean Island Games,0,0,0,0,2,2,0,0
Menorca,2007,Island Games,11,5,2,2,0,4,6,0
Menorca,2009,Island Games,13,4,2,0,2,4,9,0
Menorca,2011,Island Games,5,6,1,1,1,3,-1,0
Menorca,2015,Island Games,10,5,3,1,1,5,5,0
Menorca,2017,Island Games,11,5,2,1,2,5,6,0
Menorca,2023,Island Games,6,7,1,3,0,4,-1,0
Mexico,1923,Friendly,15,10,4,1,1,6,5,0
Mexico,1928,Olympic Games,2,10,0,2,0,2,-8,0
Mexico,1930,FIFA World Cup,4,13,0,3,0,3,-9,0
Mexico,1934,FIFA World Cup qualification,14,7,3,1,0,4,7,0
Mexico,1935,Central American and Caribbean Games,29,5,5,0,0,5,24,0
Mexico,1937,Friendly,16,15,2,3,0,5,1,0
Mexico,1938,Central American and Caribbean Games,14,4,4,0,1,5,10,0
Mexico,1938,Friendly,14,14,2,2,0,4,0,0
Mexico,1947,NAFC Championship,8,1,2,0,0,2,7,0
Mexico,1949,FIFA World Cup qualification,9,2,2,0,0,2,7,0
Mexico,1949,NAFC Championship,8,0,2,0,0,2,8,0
Mexico,1950,FIFA World Cup,2,10,0,3,0,3,-8,0
Mexico,1952,Pan American Championship,5,14,1,4,0,5,-9,0
Mexico,1953,FIFA World Cup qualification,12,0,2,0,0,2,12,1
Mexico,1954,FIFA World Cup,2,8,0,2,0,2,-6,0
Mexico,1954,FIFA World Cup qualification,7,1,2,0,0,2,6,0
Mexico,1956,Pan American Championship,2,5,0,2,2,4,-3,0
Mexico,1957,FIFA World Cup qualification,21,3,5,0,1,6,18,0
Mexico,1958,FIFA World Cup,1,8,0,2,1,3,-7,0
Mexico,1959,Friendly,7,3,3,0,0,3,4,0
Mexico,1960,FIFA World Cup qualification,6,3,1,0,1,2,3,0
Mexico,1960,Friendly,3,1,1,0,0,1,2,0
Mexico,1960,Pan American Championship,5,9,0,3,1,4,-4,0
Mexico,1961,FIFA World Cup qualification,12,2,3,1,2,6,10,0
Mexico,1961,Friendly,4,12,1,2,1,4,-8,0
Mexico,1962,FIFA World Cup,3,4,1,2,0,3,-1,0
Mexico,1962,Friendly,6,4,3,1,1,5,2,0
Mexico,1963,CONCACAF Championship,9,2,1,1,1,3,7,0
Mexico,1965,CONCACAF Championship,13,2,4,0,1,5,11,0
Mexico,1965,FIFA World Cup qualification,20,4,6,0,2,8,16,0
Mexico,1966,FIFA World Cup,1,3,0,1,2,3,-2,0
Mexico,1966,Friendly,11,10,3,2,1,6,1,0
Mexico,1967,CONCACAF Championship,10,1,4,1,0,5,9,1
Mexico,1967,Friendly,9,10,4,4,0,8,-1,0
Mexico,1968,Friendly,25,18,6,3,7,16,7,0
Mexico,1969,CONCACAF Championship,4,5,1,2,2,5,-1,0
Mexico,1969,CONCACAF Championship qualification,4,2,1,1,0,2,2,0
Mexico,1969,Friendly,19,17,6,7,4,17,2,0
Mexico,1970,FIFA World Cup,6,4,2,1,1,4,2,0
Mexico,1970,Friendly,15,11,4,3,4,11,4,0
Mexico,1971,CONCACAF Championship,6,1,4,0,1,5,5,0
Mexico,1971,CONCACAF Championship qualification,6,0,2,0,0,2,6,1
Mexico,1971,Friendly,3,14,1,4,4,9,-11,0
Mexico,1972,CONCACAF Championship qualification,8,3,4,0,0,4,5,0
Mexico,1972,Friendly,11,6,4,2,0,6,5,0
Mexico,1973,CONCACAF Championship,10,5,2,1,2,5,5,1
Mexico,1973,Friendly,6,5,2,3,0,5,1,0
Mexico,1974,Friendly,5,2,2,0,1,3,3,0
Mexico,1975,Friendly,13,6,3,3,1,7,7,0
Mexico,1976,CONCACAF Championship qualification,3,1,1,1,2,4,2,0
Mexico,1976,Friendly,0,3,0,1,0,1,-3,0
Mexico,1977,CONCACAF Championship,20,5,5,0,0,5,15,0
Mexico,1977,Friendly,14,7,3,1,3,7,7,0
Mexico,1978,FIFA World Cup,2,12,0,3,0,3,-10,0
Mexico,1978,Friendly,6,4,2,2,0,4,2,0
Mexico,1978,Korea Cup,7,1,1,0,0,1,6,0
Mexico,1979,Friendly,4,1,2,0,1,3,3,0
Mexico,1980,CONCACAF Championship qualification,8,5,1,1,2,4,3,0
Mexico,1980,Friendly,18,14,5,3,3,11,4,0
Mexico,1981,CONCACAF Championship,6,3,1,1,3,5,3,0
Mexico,1981,Friendly,5,1,1,0,1,2,4,0
Mexico,1983,Friendly,20,4,6,0,1,7,16,0
Mexico,1984,Friendly,19,17,7,3,6,16,2,0
Mexico,1985,Friendly,28,14,10,3,7,20,14,0
Mexico,1986,FIFA World Cup,6,2,3,0,2,5,4,0
Mexico,1986,Friendly,7,6,3,2,1,6,1,0
Mexico,1987,Friendly,10,3,3,0,0,3,7,0
Mexico,1988,Friendly,13,1,3,0,0,3,12,0
Mexico,1989,Friendly,7,2,3,0,0,3,5,0
Mexico,1989,Marlboro Cup,4,2,1,0,0,1,2,0
Mexico,1990,Friendly,6,4,3,1,1,5,2,0
Mexico,1990,NAFU Championship,1,2,0,1,0,1,-1,0
Mexico,1991,Friendly,6,4,2,1,5,8,2,0
Mexico,1991,Gold Cup,10,5,3,1,1,5,5,0
Mexico,1991,NAFU Championship,5,2,1,0,1,2,3,0
Mexico,1992,FIFA World Cup qualification,22,3,4,1,1,6,19,0
Mexico,1992,Friendly,11,14,3,3,4,10,-3,0
Mexico,1993,Copa América,9,7,2,2,2,6,2,0
Mexico,1993,FIFA World Cup qualification,17,5,5,1,0,6,12,0
Mexico,1993,Friendly,18,10,6,3,5,14,8,0
Mexico,1993,Gold Cup,28,2,4,0,1,5,26,0
Mexico,1994,FIFA World Cup,4,4,1,1,2,4,0,0
Mexico,1994,Friendly,13,13,3,3,2,8,0,0
Mexico,1995,Confederations Cup,4,2,1,0,2,3,2,0
Mexico,1995,Copa América,5,4,1,1,2,4,1,0
Mexico,1995,Friendly,9,13,2,4,1,7,-4,0
Mexico,1995,USA Cup,2,5,1,1,1,3,-3,0
Mexico,1996,FIFA World Cup qualification,14,6,4,2,0,6,8,0
Mexico,1996,Friendly,9,8,2,3,0,5,1,0
Mexico,1996,Gold Cup,9,0,4,0,0,4,9,1
Mexico,1996,Kirin Cup,2,3,0,1,1,2,-1,0
Mexico,1996,USA Cup,5,4,1,0,2,3,1,0
Mexico,1997,Confederations Cup,8,6,1,2,0,3,2,0
Mexico,1997,Copa América,8,9,2,2,2,6,-1,0
Mexico,1997,FIFA World Cup qualification,23,7,4,0,6,10,16,0
Mexico,1997,Friendly,3,7,1,2,0,3,-4,0
Mexico,1997,USA Cup,2,0,1,0,1,2,2,0
Mexico,1998,FIFA World Cup,8,7,1,1,2,4,1,0
Mexico,1998,Friendly,18,12,4,2,4,10,6,0
Mexico,1998,Gold Cup,8,2,4,0,0,4,6,1
Mexico,1999,Confederations Cup,13,6,4,0,1,5,7,1
Mexico,1999,Copa América,10,9,3,2,1,6,1,0
Mexico,1999,Friendly,3,6,0,3,4,7,-3,0
Mexico,1999,Korea Cup,4,3,1,1,1,3,1,0
Mexico,1999,Lunar New Year Cup,3,0,1,0,0,1,3,1
Mexico,1999,USA Cup,4,2,2,0,0,2,2,1
Mexico,2000,FIFA World Cup qualification,17,2,4,1,1,6,15,0
Mexico,2000,Friendly,10,6,5,2,0,7,4,0
Mexico,2000,Gold Cup,6,3,1,1,1,3,3,0
Mexico,2000,Lunar New Year Cup,2,2,1,1,0,2,0,0
Mexico,2000,USA Cup,6,7,1,1,1,3,-1,0
Mexico,2001,Confederations Cup,1,8,0,3,0,3,-7,0
Mexico,2001,Copa América,5,3,3,2,1,6,2,0
Mexico,2001,FIFA World Cup qualification,16,9,5,3,2,10,7,0
Mexico,2001,Friendly,15,18,3,4,1,8,-3,0
Mexico,2002,FIFA World Cup,4,4,2,1,1,4,0,0
Mexico,2002,Friendly,9,3,4,1,0,5,6,0
Mexico,2002,Gold Cup,4,1,2,0,1,3,3,0
Mexico,2003,Friendly,5,9,1,4,5,10,-4,0
Mexico,2003,Gold Cup,9,0,4,0,1,5,9,1
Mexico,2004,Copa América,5,7,2,1,1,4,-2,0
Mexico,2004,FIFA World Cup qualification,45,1,8,0,0,8,44,0
Mexico,2004,Friendly,9,4,4,1,1,6,5,0
Mexico,2005,Confederations Cup,7,6,2,1,2,5,1,0
Mexico,2005,FIFA World Cup qualification,22,9,7,2,1,10,13,0
Mexico,2005,Friendly,8,7,2,1,4,7,1,0
Mexico,2005,Gold Cup,7,4,2,2,0,4,3,0
Mexico,2006,FIFA World Cup,5,5,1,2,1,4,0,0
Mexico,2006,Friendly,9,7,5,3,0,8,2,0
Mexico,2007,Copa América,13,5,4,1,1,6,8,0
Mexico,2007,Friendly,19,16,5,5,1,11,3,0
Mexico,2007,Gold Cup,7,5,4,2,0,6,2,0
Mexico,2008,FIFA World Cup qualification,18,6,5,2,1,8,12,0
Mexico,2008,Friendly,12,9,4,2,1,7,3,0
Mexico,2009,FIFA World Cup qualification,18,12,6,3,1,10,6,0
Mexico,2009,Friendly,10,4,2,2,1,5,6,0
Mexico,2009,Gold Cup,15,2,4,0,2,6,13,1
Mexico,2010,FIFA World Cup,4,5,1,2,1,4,-1,0
Mexico,2010,Friendly,26,13,9,3,4,16,13,0
Mexico,2011,Copa América,1,4,0,3,0,3,-3,0
Mexico,2011,Friendly,17,10,6,2,4,12,7,0
Mexico,2011,Gold Cup,22,4,6,0,0,6,18,1
Mexico,2012,FIFA World Cup qualification,15,2,6,0,0,6,13,0
Mexico,2012,Friendly,9,5,4,2,0,6,4,0
Mexico,2013,Confederations Cup,3,5,1,2,0,3,-2,0
Mexico,2013,FIFA World Cup qualification,16,12,4,3,5,12,4,0
Mexico,2013,Friendly,6,3,1,0,2,3,3,0
Mexico,2013,Gold Cup,8,5,3,2,0,5,3,0
Mexico,2014,FIFA World Cup,5,3,2,1,1,4,2,0
Mexico,2014,Friendly,14,8,5,3,1,9,6,0
Mexico,2015,Copa América,4,5,0,1,2,3,-1,0
Mexico,2015,FIFA World Cup qualification,5,0,2,0,0,2,5,0
Mexico,2015,Friendly,11,11,2,2,4,8,0,0
Mexico,2015,Gold Cup,16,6,4,0,2,6,10,1
Mexico,2016,Copa América,6,9,2,1,1,4,-3,0
Mexico,2016,FIFA World Cup qualification,10,2,4,0,2,6,8,0
Mexico,2016,Friendly,4,1,3,0,0,3,3,0
Mexico,2017,Confederations Cup,8,10,2,2,1,5,-2,0
Mexico,2017,FIFA World Cup qualification,14,6,5,1,2,8,8,0
Mexico,2017,Friendly,11,7,4,1,1,6,4,0
Mexico,2017,Gold Cup,6,2,3,1,1,5,4,0
Mexico,2018,FIFA World Cup,3,6,2,2,0,4,-3,0
Mexico,2018,Friendly,9,15,4,7,1,12,-6,0
Mexico,2019,CONCACAF Nations League,13,3,4,0,0,4,10,0
Mexico,2019,Friendly,18,10,6,1,0,7,8,0
Mexico,2019,Gold Cup,16,4,5,0,1,6,12,1
Mexico,2020,Friendly,8,4,3,0,1,4,4,0
Mexico,2021,CONCACAF Nations League,2,3,0,1,1,2,-1,0
Mexico,2021,FIFA World Cup qualification,11,7,4,2,2,8,4,0
Mexico,2021,Friendly,14,7,4,2,2,8,7,0
Mexico,2021,Gold Cup,9,2,4,1,1,6,7,0
Mexico,2022,CONCACAF Nations League,4,1,1,0,1,2,3,0
Mexico,2022,FIFA World Cup,2,3,1,1,1,3,-1,0
Mexico,2022,FIFA World Cup qualification,6,1,4,0,2,6,5,0
Mexico,2022,Friendly,10,10,3,4,2,9,0,0
Mexico,2023,CONCACAF Nations League,7,7,3,2,1,6,0,1
Mexico,2023,Friendly,16,13,2,1,5,8,3,0
Mexico,2023,Gold Cup,13,2,5,1,0,6,11,1
Mexico,2024,CONCACAF Nations League,7,4,2,2,0,4,3,1
Mexico,2024,Copa América,1,1,1,1,1,3,0,0
Mexico,2024,Friendly,8,7,3,2,1,6,1,0
Mexico,2025,CONCACAF Nations League,4,1,2,0,0,2,3,0
Micronesia,1999,Friendly,8,7,1,2,0,3,1,0
Micronesia,2003,South Pacific Games,0,52,0,4,0,4,-52,0
Moldova,1956,Friendly,4,1,1,0,0,1,3,0
Moldova,1991,Friendly,2,4,0,1,0,1,-2,0
Moldova,1992,Friendly,1,1,0,0,2,2,0,0
Moldova,1992,Jordan International Tournament,10,4,3,2,0,5,6,0
Moldova,1994,Friendly,1,4,0,1,1,2,-3,0
Moldova,1994,UEFA Euro qualification,5,9,2,2,0,4,-4,0
Moldova,1995,UEFA Euro qualification,6,18,1,5,0,6,-12,0
Moldova,1996,FIFA World Cup qualification,2,8,0,3,0,3,-6,0
Moldova,1996,Friendly,5,8,1,2,1,4,-3,0
Moldova,1997,FIFA World Cup qualification,0,13,0,5,0,5,-13,0
Moldova,1998,Friendly,3,7,1,2,1,4,-4,0
Moldova,1998,UEFA Euro qualification,5,8,0,2,1,3,-3,0
Moldova,1999,Friendly,3,3,1,1,1,3,0,0
Moldova,1999,UEFA Euro qualification,2,9,0,2,3,5,-7,0
Moldova,2000,Cyprus International Tournament,3,3,1,1,0,2,0,0
Moldova,2000,FIFA World Cup qualification,0,3,0,2,1,3,-3,0
Moldova,2000,Friendly,2,1,2,1,0,3,1,0
Moldova,2001,FIFA World Cup qualification,6,17,1,4,2,7,-11,0
Moldova,2001,Friendly,0,4,0,2,1,3,-4,0
Moldova,2002,Friendly,1,4,0,2,1,3,-3,0
Moldova,2002,Malta International Tournament,2,4,1,2,0,3,-2,0
Moldova,2002,UEFA Euro qualification,0,4,0,2,0,2,-4,0
Moldova,2003,Friendly,4,5,1,1,2,4,-1,0
Moldova,2003,UEFA Euro qualification,5,15,2,4,0,6,-10,0
Moldova,2004,FIFA World Cup qualification,1,9,0,3,1,4,-8,0
Moldova,2004,Friendly,4,2,2,0,1,3,2,0
Moldova,2004,Malta International Tournament,0,1,0,1,1,2,-1,0
Moldova,2005,FIFA World Cup qualification,4,7,1,4,1,6,-3,0
Moldova,2005,Friendly,0,0,0,0,1,1,0,0
Moldova,2006,Friendly,3,2,1,0,1,2,1,0
Moldova,2006,UEFA Euro qualification,2,10,0,3,1,4,-8,0
Moldova,2007,Friendly,2,3,1,1,0,2,-1,0
Moldova,2007,UEFA Euro qualification,10,9,3,3,2,8,1,0
Moldova,2008,FIFA World Cup qualification,2,7,0,3,1,4,-5,0
Moldova,2008,Friendly,4,8,1,3,2,6,-4,0
Moldova,2009,FIFA World Cup qualification,4,11,0,4,2,6,-7,0
Moldova,2009,Friendly,9,5,2,0,2,4,4,0
Moldova,2010,Friendly,4,4,1,1,2,4,0,0
Moldova,2010,UEFA Euro qualification,5,3,2,2,0,4,2,0
Moldova,2011,Friendly,4,7,1,3,0,4,-3,0
Moldova,2011,UEFA Euro qualification,7,13,1,5,0,6,-6,0
Moldova,2012,FIFA World Cup qualification,2,7,1,2,1,4,-5,0
Moldova,2012,Friendly,0,6,0,2,2,4,-6,0
Moldova,2013,FIFA World Cup qualification,10,10,2,3,1,6,0,0
Moldova,2013,Friendly,5,6,1,1,2,4,-1,0
Moldova,2014,Friendly,10,8,2,5,1,8,2,0
Moldova,2014,UEFA Euro qualification,2,6,0,3,1,4,-4,0
Moldova,2015,Friendly,2,3,0,1,2,3,-1,0
Moldova,2015,UEFA Euro qualification,2,10,0,5,1,6,-8,0
Moldova,2016,FIFA World Cup qualification,2,11,0,3,1,4,-9,0
Moldova,2016,Friendly,2,3,1,2,1,4,-1,0
Moldova,2017,FIFA World Cup qualification,2,12,0,5,1,6,-10,0
Moldova,2017,Friendly,5,5,1,1,2,4,0,0
Moldova,2018,Friendly,1,6,0,3,2,5,-5,0
Moldova,2018,UEFA Nations League,4,5,2,1,3,6,-1,0
Moldova,2019,Friendly,0,1,0,1,0,1,-1,0
Moldova,2019,UEFA Euro qualification,4,26,1,9,0,10,-22,0
Moldova,2020,Friendly,0,7,0,2,1,3,-7,0
Moldova,2020,UEFA Nations League,1,11,0,5,1,6,-10,0
Moldova,2021,FIFA World Cup qualification,5,30,0,9,1,10,-25,0
Moldova,2021,Friendly,1,2,1,1,0,2,-1,0
Moldova,2022,Friendly,3,14,0,4,0,4,-11,0
Moldova,2022,UEFA Nations League,12,8,5,2,1,8,4,0
Moldova,2023,Friendly,2,4,0,1,1,2,-2,0
Moldova,2023,UEFA Euro qualification,7,10,2,2,4,8,-3,0
Moldova,2024,Friendly,6,8,2,1,2,5,-2,0
Moldova,2024,UEFA Nations League,5,1,3,1,0,4,4,0
Moldova,2025,FIFA World Cup qualification,2,8,0,2,0,2,-6,0
Monaco,2000,Friendly,0,5,0,1,0,1,-5,0
Monaco,2001,Friendly,2,1,1,0,0,1,1,0
Monaco,2002,Friendly,2,2,0,0,2,2,0,0
Monaco,2005,Friendly,3,6,1,1,2,4,-3,0
Monaco,2006,Friendly,14,8,1,1,0,2,6,0
Monaco,2006,Viva World Cup,7,37,2,2,0,4,-30,0
Monaco,2008,Friendly,4,5,0,1,1,2,-1,0
Monaco,2010,Friendly,1,5,0,1,0,1,-4,0
Monaco,2011,Friendly,2,1,1,0,0,1,1,0
Monaco,2012,Friendly,1,2,0,1,0,1,-1,0
Monaco,2013,Friendly,3,6,1,1,0,2,-3,0
Monaco,2014,Friendly,2,10,1,1,0,2,-8,0
Monaco,2017,Friendly,0,0,0,0,1,1,0,0
Mongolia,1942,Friendly,0,12,0,1,0,1,-12,0
Mongolia,1960,Friendly,3,19,0,3,0,3,-16,0
Mongolia,1993,East Asian Games,5,16,1,2,0,3,-11,1
Mongolia,1997,East Asian Games,7,22,1,3,0,4,-15,0
Mongolia,1998,Asian Games,0,26,0,2,0,2,-26,0
Mongolia,2000,AFC Asian Cup qualification,1,10,0,3,0,3,-9,0
Mongolia,2000,Friendly,1,8,0,1,0,1,-7,0
Mongolia,2001,FIFA World Cup qualification,2,22,0,5,1,6,-20,0
Mongolia,2003,AFC Asian Cup qualification,5,0,1,0,1,2,5,0
Mongolia,2003,EAFF Championship,2,12,1,2,0,3,-10,0
Mongolia,2003,FIFA World Cup qualification,0,13,0,2,0,2,-13,0
Mongolia,2005,EAFF Championship,4,13,1,2,0,3,-9,0
Mongolia,2007,EAFF Championship,5,9,1,1,1,3,-4,0
Mongolia,2007,FIFA World Cup qualification,2,9,0,2,0,2,-7,0
Mongolia,2009,AFC Challenge Cup qualification,3,3,1,1,0,2,0,0
Mongolia,2009,EAFF Championship,6,3,2,1,0,3,3,0
Mongolia,2011,AFC Challenge Cup qualification,2,3,1,1,0,2,-1,0
Mongolia,2011,FIFA World Cup qualification,1,2,1,1,0,2,-1,0
Mongolia,2013,AFC Challenge Cup qualification,1,5,0,2,1,3,-4,0
Mongolia,2014,EAFF Championship,6,5,1,2,0,3,1,0
Mongolia,2015,FIFA World Cup qualification,6,0,2,0,0,2,6,0
Mongolia,2016,AFC Challenge Cup,3,5,1,2,0,3,-2,0
Mongolia,2016,EAFF Championship,10,4,1,1,1,3,6,0
Mongolia,2017,Friendly,4,10,0,3,0,3,-6,0
Mongolia,2018,EAFF Championship,17,13,2,3,1,6,4,0
Mongolia,2018,Friendly,6,7,1,2,1,4,-1,0
Mongolia,2019,FIFA World Cup qualification,5,12,2,5,0,7,-7,0
Mongolia,2019,Friendly,1,1,0,0,1,1,0,0
Mongolia,2021,FIFA World Cup qualification,1,17,1,2,0,3,-16,0
Mongolia,2022,AFC Asian Cup qualification,2,2,1,2,0,3,0,0
Mongolia,2022,Friendly,0,1,0,1,1,2,-1,0
Mongolia,2023,FIFA World Cup qualification,0,2,0,2,0,2,-2,0
Mongolia,2023,Friendly,1,6,0,1,0,1,-5,0
Mongolia,2024,AFC Asian Cup qualification,3,4,1,1,0,2,-1,1
Mongolia,2024,EAFF Championship qualification,0,7,0,2,0,2,-7,0
Mongolia,2024,FIFA Series,0,4,0,2,0,2,-4,0
Mongolia,2024,Friendly,2,3,1,1,0,2,-1,0
Montenegro,1946,Friendly,0,5,0,1,0,1,-5,0
Montenegro,1966,Friendly,0,1,0,1,0,1,-1,0
Montenegro,1976,Friendly,2,1,1,0,0,1,1,0
Montenegro,2007,Friendly,5,4,2,1,1,4,1,0
Montenegro,2007,Kirin Cup,0,3,0,2,0,2,-3,0
Montenegro,2008,FIFA World Cup qualification,3,4,0,1,2,3,-1,0
Montenegro,2008,Friendly,11,9,3,1,1,5,2,0
Montenegro,2009,FIFA World Cup qualification,6,10,1,2,4,7,-4,0
Montenegro,2009,Friendly,3,1,2,0,0,2,2,0
Montenegro,2010,Friendly,6,5,2,3,0,5,1,0
Montenegro,2010,UEFA Euro qualification,3,0,3,0,1,4,3,0
Montenegro,2011,Friendly,3,3,1,1,0,2,0,0
Montenegro,2011,UEFA Euro qualification,4,10,0,4,2,6,-6,0
Montenegro,2012,FIFA World Cup qualification,12,2,3,0,1,4,10,0
Montenegro,2012,Friendly,6,3,2,0,1,3,3,0
Montenegro,2013,FIFA World Cup qualification,6,15,1,3,2,6,-9,0
Montenegro,2013,Friendly,5,2,1,0,1,2,3,0
Montenegro,2014,Friendly,1,2,1,1,1,3,-1,0
Montenegro,2014,UEFA Euro qualification,3,2,1,1,2,4,1,0
Montenegro,2015,Friendly,2,6,0,2,0,2,-4,0
Montenegro,2015,UEFA Euro qualification,7,8,2,3,0,5,-1,0
Montenegro,2016,FIFA World Cup qualification,9,4,2,1,1,4,5,0
Montenegro,2016,Friendly,1,3,0,2,1,3,-2,0
Montenegro,2017,FIFA World Cup qualification,11,8,3,3,0,6,3,0
Montenegro,2017,Friendly,1,2,0,1,0,1,-1,0
Montenegro,2018,Friendly,2,4,0,1,3,4,-2,0
Montenegro,2018,UEFA Nations League,7,6,2,3,1,6,1,0
Montenegro,2019,Friendly,4,1,2,0,0,2,3,0
Montenegro,2019,UEFA Euro qualification,3,22,0,5,3,8,-19,0
Montenegro,2020,Friendly,1,1,0,0,2,2,0,0
Montenegro,2020,UEFA Nations League,10,2,4,1,1,6,8,0
Montenegro,2021,FIFA World Cup qualification,14,15,3,4,3,10,-1,0
Montenegro,2021,Friendly,1,3,0,1,1,2,-2,0
Montenegro,2022,Friendly,3,4,1,2,1,4,-1,0
Montenegro,2022,UEFA Nations League,6,6,2,3,1,6,0,0
Montenegro,2023,Friendly,4,6,1,1,0,2,-2,0
Montenegro,2023,UEFA Euro qualification,9,11,3,3,2,8,-2,0
Montenegro,2024,Friendly,4,5,2,2,0,4,-1,0
Montenegro,2024,UEFA Nations League,4,9,1,5,0,6,-5,0
Montenegro,2025,FIFA World Cup qualification,4,1,2,0,0,2,3,1
Montserrat,1991,CFU Caribbean Cup qualification,1,4,0,1,1,2,-3,0
Montserrat,1992,CFU Caribbean Cup qualification,0,15,0,2,0,2,-15,0
Montserrat,1994,CFU Caribbean Cup qualification,1,17,0,2,0,2,-16,0
Montserrat,1995,CFU Caribbean Cup qualification,4,2,2,0,0,2,2,0
Montserrat,1999,CFU Caribbean Cup qualification,1,6,0,2,0,2,-5,0
Montserrat,2000,FIFA World Cup qualification,1,6,0,2,0,2,-5,0
Montserrat,2001,CFU Caribbean Cup qualification,2,7,0,2,0,2,-5,0
Montserrat,2002,The Other Final,0,4,0,1,0,1,-4,0
Montserrat,2004,CFU Caribbean Cup qualification,5,11,0,2,0,2,-6,0
Montserrat,2004,FIFA World Cup qualification,0,20,0,2,0,2,-20,0
Montserrat,2008,FIFA World Cup qualification,1,7,0,1,0,1,-6,0
Montserrat,2010,CFU Caribbean Cup qualification,0,9,0,2,0,2,-9,0
Montserrat,2011,FIFA World Cup qualification,3,8,0,2,0,2,-5,0
Montserrat,2012,CFU Caribbean Cup qualification,8,12,1,2,0,3,-4,0
Montserrat,2014,CFU Caribbean Cup qualification,1,0,1,0,0,1,1,0
Montserrat,2015,FIFA World Cup qualification,3,4,0,1,1,2,-1,0
Montserrat,2018,CONCACAF Nations League qualification,4,2,2,1,0,3,2,0
Montserrat,2019,CONCACAF Nations League,4,5,2,2,2,6,-1,1
Montserrat,2019,CONCACAF Nations League qualification,2,1,1,0,0,1,1,0
Montserrat,2021,FIFA World Cup qualification,9,4,2,0,2,4,5,0
Montserrat,2021,Gold Cup qualification,1,6,0,1,0,1,-5,0
Montserrat,2022,CONCACAF Nations League,6,7,1,2,0,3,-1,0
Montserrat,2023,CONCACAF Nations League,9,18,3,4,1,8,-9,0
Montserrat,2024,CONCACAF Nations League,3,10,1,5,0,6,-7,0
Montserrat,2024,FIFA World Cup qualification,2,7,0,2,0,2,-5,0
Morocco,1958,Friendly,3,1,1,0,0,1,2,0
Morocco,1960,FIFA World Cup qualification,3,3,1,1,0,2,0,0
Morocco,1960,Friendly,2,8,0,2,0,2,-6,0
Morocco,1961,FIFA World Cup qualification,4,5,1,2,2,5,-1,0
Morocco,1961,Friendly,6,4,2,1,0,3,2,0
Morocco,1962,Friendly,5,9,1,2,1,4,-4,0
Morocco,1963,African Cup of Nations qualification,5,6,1,1,0,2,-1,0
Morocco,1963,Friendly,3,5,1,1,1,3,-2,0
Morocco,1965,Friendly,2,2,1,2,2,5,0,0
Morocco,1966,Friendly,6,7,3,1,1,5,-1,0
Morocco,1967,Friendly,1,5,0,1,0,1,-4,0
Morocco,1968,FIFA World Cup qualification,1,0,1,0,0,1,1,0
Morocco,1968,Friendly,0,0,0,0,1,1,0,0
Morocco,1969,African Cup of Nations qualification,2,2,1,1,0,2,0,0
Morocco,1969,FIFA World Cup qualification,10,7,3,2,4,9,3,0
Morocco,1969,Friendly,4,6,1,3,0,4,-2,1
Morocco,1970,African Cup of Nations qualification,4,3,1,1,0,2,1,1
Morocco,1970,FIFA World Cup,2,6,0,2,1,3,-4,0
Morocco,1971,African Cup of Nations qualification,5,3,1,1,0,2,2,0
Morocco,1972,African Cup of Nations,3,3,0,0,3,3,0,0
Morocco,1972,FIFA World Cup qualification,2,1,1,0,1,2,1,0
Morocco,1972,Friendly,3,4,1,1,0,2,-1,0
Morocco,1973,FIFA World Cup qualification,10,10,3,2,2,7,0,0
Morocco,1973,Friendly,3,3,1,1,0,2,0,0
Morocco,1974,African Cup of Nations qualification,6,0,2,0,0,2,6,1
Morocco,1974,Friendly,6,0,4,0,4,8,6,0
Morocco,1974,Kuneitra Cup,6,2,2,0,1,3,4,0
Morocco,1975,African Cup of Nations qualification,7,4,2,2,0,4,3,0
Morocco,1975,Friendly,0,0,0,0,1,1,0,0
Morocco,1976,African Cup of Nations,11,6,4,0,2,6,5,0
Morocco,1976,FIFA World Cup qualification,1,1,0,0,1,1,0,0
Morocco,1976,Friendly,4,0,2,0,0,2,4,0
Morocco,1977,Beijing International Friendship Tournament,3,4,0,1,1,2,-1,0
Morocco,1977,FIFA World Cup qualification,1,1,0,0,1,1,0,0
Morocco,1977,Friendly,10,7,3,2,1,6,3,0
Morocco,1978,African Cup of Nations,2,4,1,1,1,3,-2,0
Morocco,1978,Friendly,3,3,1,1,0,2,0,0
Morocco,1979,African Cup of Nations qualification,14,5,2,1,1,4,9,0
Morocco,1980,African Cup of Nations,4,3,2,2,1,5,1,0
Morocco,1980,FIFA World Cup qualification,3,2,2,1,1,4,1,0
Morocco,1980,Friendly,9,6,3,0,2,5,3,0
Morocco,1980,Merdeka Tournament,15,5,5,0,2,7,10,1
Morocco,1981,African Cup of Nations qualification,10,4,3,1,0,4,6,0
Morocco,1981,FIFA World Cup qualification,2,4,1,2,1,4,-2,0
Morocco,1981,Friendly,6,5,1,1,2,4,1,0
Morocco,1982,Beijing International Friendship Tournament,3,3,0,0,2,2,0,0
Morocco,1982,Friendly,3,3,1,1,0,2,0,0
Morocco,1983,African Cup of Nations qualification,4,2,1,1,2,4,2,0
Morocco,1983,Friendly,0,2,0,2,1,3,-2,0
Morocco,1984,FIFA World Cup qualification,5,0,2,0,0,2,5,0
Morocco,1984,Friendly,9,7,2,0,2,4,2,0
Morocco,1985,African Cup of Nations qualification,1,0,1,0,1,2,1,0
Morocco,1985,FIFA World Cup qualification,7,1,3,1,2,6,6,0
Morocco,1985,Friendly,0,0,0,0,1,1,0,0
Morocco,1985,Nehru Cup,1,1,1,1,0,2,0,0
Morocco,1986,African Cup of Nations,4,5,1,2,2,5,-1,0
Morocco,1986,FIFA World Cup,3,2,1,1,2,4,1,0
Morocco,1986,Friendly,1,2,0,1,1,2,-1,0
Morocco,1987,Friendly,1,2,0,1,0,1,-1,0
Morocco,1987,Korea Cup,0,1,0,1,0,1,-1,0
Morocco,1988,African Cup of Nations,3,3,1,1,3,5,0,0
Morocco,1988,Friendly,8,3,3,0,1,4,5,0
Morocco,1988,Tournoi de France,4,3,1,1,0,2,1,0
Morocco,1989,African Cup of Nations qualification,1,1,0,0,2,2,0,0
Morocco,1989,FIFA World Cup qualification,4,5,1,2,3,6,-1,0
Morocco,1989,Friendly,2,1,1,0,1,2,1,0
Morocco,1990,African Cup of Nations qualification,6,0,2,0,0,2,6,0
Morocco,1990,Friendly,2,2,1,1,1,3,0,0
Morocco,1991,African Cup of Nations qualification,5,4,2,2,0,4,1,0
Morocco,1991,Friendly,6,3,1,0,3,4,3,0
Morocco,1992,African Cup of Nations,1,2,0,1,1,2,-1,0
Morocco,1992,African Cup of Nations qualification,1,2,0,1,1,2,-1,0
Morocco,1992,FIFA World Cup qualification,7,1,2,0,1,3,6,0
Morocco,1992,Friendly,3,1,1,0,0,1,2,0
Morocco,1993,African Cup of Nations qualification,4,2,2,1,1,4,2,0
Morocco,1993,FIFA World Cup qualification,12,3,5,1,1,7,9,0
Morocco,1993,Friendly,4,0,2,0,0,2,4,0
Morocco,1994,African Cup of Nations qualification,2,2,1,1,0,2,0,0
Morocco,1994,FIFA World Cup,2,5,0,3,0,3,-3,0
Morocco,1994,Friendly,5,6,1,1,3,5,-1,0
Morocco,1994,United Arab Emirates Friendship Tournament,4,3,1,0,2,3,1,0
Morocco,1995,African Cup of Nations qualification,0,2,0,1,1,2,-2,0
Morocco,1995,Friendly,7,0,3,0,1,4,7,0
Morocco,1996,FIFA World Cup qualification,4,0,1,0,0,1,4,0
Morocco,1996,Friendly,18,1,4,0,0,4,17,0
Morocco,1996,King Hassan II Tournament,4,2,1,0,1,2,2,0
Morocco,1996,United Arab Emirates Friendship Tournament,4,3,1,1,1,3,1,0
Morocco,1997,African Cup of Nations qualification,9,0,4,0,0,4,9,0
Morocco,1997,FIFA World Cup qualification,10,2,4,0,1,5,8,0
Morocco,1997,Friendly,3,2,1,1,0,2,1,0
Morocco,1998,African Cup of Nations,6,3,2,1,1,4,3,0
Morocco,1998,FIFA World Cup,5,5,1,1,1,3,0,0
Morocco,1998,Friendly,9,4,3,1,1,5,5,0
Morocco,1998,King Hassan II Tournament,2,3,0,1,1,2,-1,0
Morocco,1999,African Cup of Nations qualification,6,4,2,0,2,4,2,0
Morocco,1999,Friendly,4,7,2,2,1,5,-3,0
Morocco,2000,African Cup of Nations,1,2,1,1,1,3,-1,0
Morocco,2000,African Cup of Nations qualification,1,2,1,1,0,2,-1,0
Morocco,2000,FIFA World Cup qualification,5,1,3,0,1,4,4,0
Morocco,2000,Friendly,3,5,1,2,1,4,-2,0
Morocco,2000,King Hassan II Tournament,2,5,1,1,0,2,-3,0
Morocco,2001,African Cup of Nations qualification,4,2,2,1,1,4,2,0
Morocco,2001,FIFA World Cup qualification,6,2,3,1,2,6,4,0
Morocco,2001,Friendly,4,3,2,2,0,4,1,0
Morocco,2001,United Arab Emirates Friendship Tournament,2,2,0,0,2,2,0,0
Morocco,2002,African Cup of Nations,3,4,1,1,1,3,-1,0
Morocco,2002,African Cup of Nations qualification,6,0,2,0,0,2,6,0
Morocco,2002,Friendly,14,6,4,1,1,6,8,0
Morocco,2003,African Cup of Nations qualification,4,0,3,0,1,4,4,0
Morocco,2003,Friendly,4,2,3,2,1,6,2,0
Morocco,2004,African Cup of Nations,14,4,4,1,1,6,10,0
Morocco,2004,FIFA World Cup qualification,4,3,1,0,3,4,1,0
Morocco,2004,Friendly,9,3,3,1,1,5,6,0
Morocco,2005,FIFA World Cup qualification,13,4,4,0,2,6,9,0
Morocco,2005,Friendly,0,1,0,1,1,2,-1,0
Morocco,2006,African Cup of Nations,0,1,0,1,2,3,-1,0
Morocco,2006,Friendly,14,5,5,2,1,8,9,0
Morocco,2007,African Cup of Nations qualification,4,1,2,0,1,3,3,0
Morocco,2007,Friendly,8,5,2,1,2,5,3,0
Morocco,2008,African Cup of Nations,7,6,1,2,0,3,1,0
Morocco,2008,FIFA World Cup qualification,11,5,3,1,0,4,6,0
Morocco,2008,Friendly,14,3,5,0,1,6,11,0
Morocco,2009,FIFA World Cup qualification,3,8,0,3,3,6,-5,0
Morocco,2009,Friendly,3,1,1,0,2,3,2,0
Morocco,2010,African Cup of Nations qualification,1,0,1,0,1,2,1,0
Morocco,2010,Friendly,3,2,1,0,1,2,1,0
Morocco,2011,African Cup of Nations qualification,7,2,2,1,1,4,5,0
Morocco,2011,Friendly,6,2,2,1,1,4,4,0
Morocco,2012,African Cup of Nations,4,5,1,2,0,3,-1,0
Morocco,2012,African Cup of Nations qualification,4,2,1,1,0,2,2,0
Morocco,2012,FIFA World Cup qualification,3,3,0,0,2,2,0,0
Morocco,2012,Friendly,3,8,1,4,0,5,-5,0
Morocco,2013,African Cup of Nations,3,3,0,0,3,3,0,0
Morocco,2013,FIFA World Cup qualification,6,5,2,1,1,4,1,0
Morocco,2013,Friendly,4,4,1,1,2,4,0,0
Morocco,2014,Friendly,19,7,5,2,2,9,12,0
Morocco,2015,African Cup of Nations qualification,4,0,2,0,0,2,4,0
Morocco,2015,FIFA World Cup qualification,2,1,1,1,0,2,1,0
Morocco,2015,Friendly,1,3,0,2,1,3,-2,0
Morocco,2016,African Cup of Nations qualification,6,1,3,0,1,4,5,0
Morocco,2016,FIFA World Cup qualification,0,0,0,0,2,2,0,0
Morocco,2016,Friendly,8,1,3,0,1,4,7,0
Morocco,2017,African Cup of Nations,4,3,2,2,0,4,1,0
Morocco,2017,African Cup of Nations qualification,0,1,0,1,0,1,-1,0
Morocco,2017,FIFA World Cup qualification,11,0,3,0,1,4,11,0
Morocco,2017,Friendly,7,4,3,2,0,5,3,0
Morocco,2018,African Cup of Nations qualification,8,2,3,0,1,4,6,0
Morocco,2018,FIFA World Cup,2,4,0,2,1,3,-2,0
Morocco,2018,Friendly,10,3,5,0,1,6,7,0
Morocco,2019,African Cup of Nations,4,1,3,0,1,4,3,0
Morocco,2019,African Cup of Nations qualification,3,0,1,0,2,3,3,0
Morocco,2019,Friendly,7,10,1,4,2,7,-3,0
Morocco,2020,African Cup of Nations qualification,6,1,2,0,0,2,5,0
Morocco,2020,Friendly,4,2,1,0,1,2,2,0
Morocco,2021,African Cup of Nations qualification,1,0,1,0,1,2,1,0
Morocco,2021,Arab Cup,11,2,3,0,1,4,9,0
Morocco,2021,FIFA World Cup qualification,20,1,6,0,0,6,19,1
Morocco,2021,Friendly,2,0,2,0,0,2,2,0
Morocco,2022,African Cup of Nations,8,5,3,1,1,5,3,0
Morocco,2022,African Cup of Nations qualification,4,1,2,0,0,2,3,0
Morocco,2022,FIFA World Cup,6,5,3,2,2,7,1,0
Morocco,2022,FIFA World Cup qualification,5,2,1,0,1,2,3,0
Morocco,2022,Friendly,5,3,2,1,1,4,2,0
Morocco,2023,African Cup of Nations qualification,4,2,1,1,0,2,2,1
Morocco,2023,FIFA World Cup qualification,2,0,1,0,0,1,2,0
Morocco,2023,Friendly,4,2,2,0,3,5,2,0
Morocco,2024,African Cup of Nations,5,3,2,1,1,4,2,0
Morocco,2024,African Cup of Nations qualification,14,1,4,0,0,4,13,0
Morocco,2024,FIFA World Cup qualification,8,1,2,0,0,2,7,0
Morocco,2024,Friendly,4,1,2,0,1,3,3,0
Morocco,2025,FIFA World Cup qualification,4,1,2,0,0,2,3,0
Mozambique,1975,Friendly,4,5,2,1,0,3,-1,0
Mozambique,1977,Friendly,1,4,0,2,0,2,-3,0
Mozambique,1978,Friendly,6,1,2,0,0,2,5,0
Mozambique,1979,Friendly,0,6,0,1,0,1,-6,0
Mozambique,1980,African Cup of Nations qualification,7,3,1,1,0,2,4,0
Mozambique,1980,FIFA World Cup qualification,3,7,0,2,0,2,-4,0
Mozambique,1980,Friendly,2,11,0,3,0,3,-9,0
Mozambique,1981,African Cup of Nations qualification,4,5,0,1,1,2,-1,0
Mozambique,1981,Friendly,5,8,1,3,0,4,-3,0
Mozambique,1982,Friendly,1,1,0,0,1,1,0,0
Mozambique,1983,African Cup of Nations qualification,3,4,1,1,0,2,-1,0
Mozambique,1983,Friendly,0,2,0,1,1,2,-2,0
Mozambique,1984,African Cup of Nations qualification,3,0,1,0,1,2,3,0
Mozambique,1985,African Cup of Nations qualification,5,5,1,1,2,4,0,1
Mozambique,1985,Friendly,1,2,0,1,1,2,-1,0
Mozambique,1986,African Cup of Nations,0,7,0,3,0,3,-7,0
Mozambique,1986,Friendly,1,4,0,1,0,1,-3,0
Mozambique,1987,African Cup of Nations qualification,1,2,0,1,1,2,-1,0
Mozambique,1988,Friendly,3,5,0,2,2,4,-2,0
Mozambique,1989,African Cup of Nations qualification,0,4,0,2,0,2,-4,0
Mozambique,1989,Friendly,4,2,2,1,1,4,2,0
Mozambique,1990,African Cup of Nations qualification,2,2,1,1,0,2,0,0
Mozambique,1990,Friendly,12,12,3,4,1,8,0,0
Mozambique,1991,African Cup of Nations qualification,1,1,1,1,0,2,0,0
Mozambique,1991,Friendly,5,5,2,2,1,5,0,0
Mozambique,1992,African Cup of Nations qualification,3,2,1,1,0,2,1,0
Mozambique,1992,FIFA World Cup qualification,1,4,0,2,0,2,-3,0
Mozambique,1992,Friendly,4,1,1,0,0,1,3,0
Mozambique,1993,African Cup of Nations qualification,2,5,0,1,3,4,-3,0
Mozambique,1993,FIFA World Cup qualification,2,7,0,1,1,2,-5,0
Mozambique,1994,African Cup of Nations qualification,6,4,2,1,0,3,2,0
Mozambique,1994,Friendly,1,0,1,0,0,1,1,0
Mozambique,1995,African Cup of Nations qualification,10,4,4,1,2,7,6,0
Mozambique,1995,Friendly,5,4,1,1,0,2,1,0
Mozambique,1996,African Cup of Nations,1,4,0,2,1,3,-3,0
Mozambique,1996,African Cup of Nations qualification,0,1,0,1,0,1,-1,0
Mozambique,1996,FIFA World Cup qualification,1,3,0,1,1,2,-2,0
Mozambique,1996,Friendly,4,1,3,1,0,4,3,0
Mozambique,1997,African Cup of Nations qualification,10,6,3,1,1,5,4,0
Mozambique,1997,COSAFA Cup,7,5,1,1,2,4,2,0
Mozambique,1997,COSAFA Cup qualification,4,0,1,0,0,1,4,0
Mozambique,1997,Friendly,2,3,0,1,1,2,-1,0
Mozambique,1998,African Cup of Nations,1,8,0,3,0,3,-7,0
Mozambique,1998,African Cup of Nations qualification,5,2,2,0,1,3,3,0
Mozambique,1998,COSAFA Cup,2,6,0,3,1,4,-4,0
Mozambique,1998,COSAFA Cup qualification,2,1,1,0,0,1,1,0
Mozambique,1998,Friendly,10,19,1,6,3,10,-9,0
Mozambique,1999,African Cup of Nations qualification,1,8,0,3,0,3,-7,0
Mozambique,1999,COSAFA Cup,1,1,0,0,1,1,0,0
Mozambique,1999,COSAFA Cup qualification,3,3,1,1,0,2,0,1
Mozambique,1999,Friendly,0,1,0,1,0,1,-1,0
Mozambique,2000,African Cup of Nations qualification,1,1,1,1,0,2,0,0
Mozambique,2000,COSAFA Cup,1,2,0,1,0,1,-1,0
Mozambique,2000,FIFA World Cup qualification,2,2,1,1,0,2,0,0
Mozambique,2000,Friendly,1,3,0,1,2,3,-2,0
Mozambique,2001,COSAFA Cup,0,3,0,1,0,1,-3,0
Mozambique,2001,Friendly,4,1,2,0,1,3,3,0
Mozambique,2002,African Cup of Nations qualification,1,4,0,1,1,2,-3,0
Mozambique,2002,COSAFA Cup,2,3,1,1,0,2,-1,0
Mozambique,2002,Friendly,4,3,1,0,2,3,1,0
Mozambique,2003,African Cup of Nations qualification,2,4,2,1,1,4,-2,0
Mozambique,2003,COSAFA Cup,2,4,0,1,1,2,-2,0
Mozambique,2003,FIFA World Cup qualification,3,5,0,2,0,2,-2,0
Mozambique,2003,Friendly,2,0,1,0,0,1,2,0
Mozambique,2004,COSAFA Cup,4,1,2,1,0,3,3,0
Mozambique,2004,Friendly,3,1,1,0,2,3,2,0
Mozambique,2005,COSAFA Cup,0,3,0,1,0,1,-3,0
Mozambique,2005,Friendly,4,2,2,0,1,3,2,0
Mozambique,2006,African Cup of Nations qualification,0,2,0,1,1,2,-2,0
Mozambique,2006,COSAFA Cup,0,0,0,0,2,2,0,0
Mozambique,2006,Friendly,5,2,1,1,0,2,3,0
Mozambique,2007,African Cup of Nations qualification,5,1,2,0,2,4,4,0
Mozambique,2007,COSAFA Cup,2,3,1,1,1,3,-1,0
Mozambique,2007,Friendly,0,0,0,0,1,1,0,0
Mozambique,2008,COSAFA Cup,5,3,2,1,0,3,2,0
Mozambique,2008,FIFA World Cup qualification,7,5,2,2,2,6,2,0
Mozambique,2008,Friendly,6,7,2,4,0,6,-1,0
Mozambique,2009,COSAFA Cup,2,2,2,1,0,3,0,0
Mozambique,2009,FIFA World Cup qualification,3,5,2,3,1,6,-2,0
Mozambique,2009,Friendly,3,1,2,1,0,3,2,0
Mozambique,2010,African Cup of Nations,2,7,0,2,1,3,-5,0
Mozambique,2010,African Cup of Nations qualification,1,0,1,0,1,2,1,0
Mozambique,2010,Friendly,3,10,1,4,0,5,-7,0
Mozambique,2011,African Cup of Nations qualification,3,6,1,3,0,4,-3,0
Mozambique,2011,FIFA World Cup qualification,5,1,2,0,0,2,4,0
Mozambique,2011,Friendly,3,1,1,0,1,2,2,0
Mozambique,2012,African Cup of Nations qualification,4,6,1,1,2,4,-2,0
Mozambique,2012,FIFA World Cup qualification,0,2,0,1,1,2,-2,0
Mozambique,2012,Friendly,0,7,0,3,1,4,-7,0
Mozambique,2013,COSAFA Cup,3,3,2,1,0,3,0,0
Mozambique,2013,FIFA World Cup qualification,2,8,0,2,2,4,-6,0
Mozambique,2013,Friendly,0,0,0,0,1,1,0,0
Mozambique,2014,African Cup of Nations qualification,13,7,3,2,5,10,6,0
Mozambique,2014,Friendly,2,2,0,0,2,2,0,0
Mozambique,2015,African Cup of Nations qualification,0,2,0,2,0,2,-2,0
Mozambique,2015,COSAFA Cup,4,5,1,1,1,3,-1,0
Mozambique,2015,FIFA World Cup qualification,1,1,1,1,0,2,0,0
Mozambique,2015,Friendly,2,1,1,0,0,1,1,0
Mozambique,2016,African Cup of Nations qualification,5,5,2,1,1,4,0,0
Mozambique,2016,COSAFA Cup,0,4,0,2,0,2,-4,0
Mozambique,2016,Friendly,1,4,0,2,1,3,-3,0
Mozambique,2017,African Cup of Nations qualification,1,0,1,0,0,1,1,0
Mozambique,2017,COSAFA Cup,3,9,1,2,0,3,-6,0
Mozambique,2017,Friendly,4,1,2,0,1,3,3,0
Mozambique,2018,African Cup of Nations qualification,4,5,1,2,1,4,-1,0
Mozambique,2018,COSAFA Cup,6,3,2,1,0,3,3,0
Mozambique,2019,African Cup of Nations qualification,6,4,1,0,2,3,2,0
Mozambique,2019,COSAFA Cup,2,3,0,1,2,3,-1,0
Mozambique,2019,FIFA World Cup qualification,3,0,2,0,0,2,3,0
Mozambique,2019,Friendly,1,0,1,0,0,1,1,0
Mozambique,2020,African Cup of Nations qualification,1,6,0,2,0,2,-5,0
Mozambique,2020,Friendly,0,3,0,1,0,1,-3,0
Mozambique,2021,African Cup of Nations qualification,0,2,0,2,0,2,-2,0
Mozambique,2021,COSAFA Cup,4,5,2,2,2,6,-1,0
Mozambique,2021,FIFA World Cup qualification,2,8,1,4,1,6,-6,0
Mozambique,2021,Friendly,6,1,1,0,1,2,5,0
Mozambique,2022,African Cup of Nations qualification,2,1,1,0,1,2,1,0
Mozambique,2022,COSAFA Cup,1,2,0,1,2,3,-1,0
Mozambique,2022,Friendly,3,6,0,3,1,4,-3,0
Mozambique,2023,African Cup of Nations qualification,6,8,2,2,0,4,-2,0
Mozambique,2023,COSAFA Cup,2,2,1,1,1,3,0,0
Mozambique,2023,FIFA World Cup qualification,3,4,1,1,0,2,-1,0
Mozambique,2023,Friendly,4,5,0,1,2,3,-1,0
Mozambique,2024,African Cup of Nations,4,7,0,1,2,3,-3,0
Mozambique,2024,African Cup of Nations qualification,7,3,2,0,2,4,4,0
Mozambique,2024,FIFA World Cup qualification,3,1,2,0,0,2,2,0
Mozambique,2024,Friendly,3,1,1,0,1,2,2,0
Mozambique,2025,FIFA World Cup qualification,4,6,1,1,0,2,-2,0
Myanmar,1951,Asian Games,0,2,0,1,0,1,-2,0
Myanmar,1952,Friendly,0,5,0,2,0,2,-5,0
Myanmar,1953,Friendly,6,7,1,1,1,3,-1,0
Myanmar,1954,Asian Games,10,8,2,0,2,4,2,0
Myanmar,1954,Friendly,3,5,0,2,1,3,-2,0
Myanmar,1955,Friendly,6,8,1,3,1,5,-2,1
Myanmar,1956,Friendly,2,3,0,1,0,1,-1,0
Myanmar,1957,Friendly,3,3,1,1,0,2,0,0
Myanmar,1957,Merdeka Tournament,11,10,2,2,0,4,1,0
Myanmar,1958,Asian Games,4,7,0,2,0,2,-3,0
Myanmar,1959,Southeast Asian Peninsular Games,3,10,0,3,0,3,-7,0
Myanmar,1961,Friendly,3,0,1,0,0,1,3,0
Myanmar,1961,Southeast Asian Peninsular Games,7,5,2,2,0,4,2,0
Myanmar,1962,Merdeka Tournament,5,5,1,2,0,3,0,0
Myanmar,1963,Friendly,3,13,1,3,0,4,-10,0
Myanmar,1964,Merdeka Tournament,7,4,3,1,0,4,3,1
Myanmar,1965,Friendly,1,1,0,0,1,1,0,0
Myanmar,1965,Merdeka Tournament,10,8,2,1,2,5,2,0
Myanmar,1965,Southeast Asian Peninsular Games,5,2,2,0,1,3,3,0
Myanmar,1966,Asian Games,8,3,4,0,2,6,5,1
Myanmar,1966,Merdeka Tournament,9,3,3,1,2,6,6,0
Myanmar,1967,AFC Asian Cup qualification,5,0,3,0,0,3,5,1
Myanmar,1967,Merdeka Tournament,12,3,3,2,1,6,9,0
Myanmar,1967,Southeast Asian Peninsular Games,7,2,4,0,0,4,5,1
Myanmar,1968,AFC Asian Cup,5,4,2,1,1,4,1,0
Myanmar,1968,King's Cup,8,4,3,2,0,5,4,0
Myanmar,1968,Merdeka Tournament,10,8,3,2,2,7,2,0
Myanmar,1969,Merdeka Tournament,24,6,4,1,0,5,18,1
Myanmar,1969,Southeast Asian Peninsular Games,8,1,2,0,1,3,7,1
Myanmar,1970,Asian Games,9,5,4,1,2,7,4,0
Myanmar,1970,Merdeka Tournament,15,5,5,1,1,7,10,0
Myanmar,1971,Indonesia Tournament,22,2,5,0,1,6,20,1
Myanmar,1971,Korea Cup,13,2,4,0,2,6,11,0
Myanmar,1971,Merdeka Tournament,18,4,4,1,1,6,14,1
Myanmar,1971,Southeast Asian Peninsular Games,13,3,3,0,1,4,10,1
Myanmar,1972,Indonesia Tournament,12,9,2,2,1,5,3,0
Myanmar,1972,Korea Cup,10,2,4,0,1,5,8,1
Myanmar,1973,Indonesia Tournament,2,2,0,0,2,2,0,0
Myanmar,1973,King's Cup,9,8,2,4,0,6,1,0
Myanmar,1973,Korea Cup,4,5,1,1,2,4,-1,0
Myanmar,1973,Merdeka Tournament,14,4,5,1,1,7,10,0
Myanmar,1973,Southeast Asian Peninsular Games,15,4,4,0,0,4,11,1
Myanmar,1974,Asian Games,14,13,2,3,1,6,1,0
Myanmar,1974,Indonesia Tournament,7,2,2,0,0,2,5,0
Myanmar,1974,Korea Cup,8,4,2,1,0,3,4,1
Myanmar,1975,Indonesia Tournament,4,2,2,1,0,3,2,0
Myanmar,1975,King's Cup,9,4,2,1,0,3,5,0
Myanmar,1975,Korea Cup,4,2,1,1,0,2,2,0
Myanmar,1975,Merdeka Tournament,18,8,4,3,0,7,10,0
Myanmar,1975,Southeast Asian Peninsular Games,3,3,1,1,1,3,0,0
Myanmar,1976,Indonesia Tournament,4,2,1,0,1,2,2,0
Myanmar,1976,King's Cup,0,1,0,1,1,2,-1,0
Myanmar,1976,Korea Cup,2,2,1,1,0,2,0,0
Myanmar,1976,Merdeka Tournament,13,10,2,1,3,6,3,0
Myanmar,1977,Merdeka Tournament,4,10,1,3,1,5,-6,0
Myanmar,1977,Southeast Asian Games,11,10,3,1,0,4,1,0
Myanmar,1978,Asian Games,1,5,0,2,0,2,-4,0
Myanmar,1979,Merdeka Tournament,11,6,3,2,0,5,5,1
Myanmar,1979,Southeast Asian Games,2,5,0,3,1,4,-3,0
Myanmar,1980,Friendly,2,0,1,0,0,1,2,0
Myanmar,1980,Merdeka Tournament,9,12,1,3,3,7,-3,0
Myanmar,1981,Southeast Asian Games,3,4,0,1,1,2,-1,0
Myanmar,1982,Asian Games,3,8,1,2,0,3,-5,0
Myanmar,1983,Southeast Asian Games,3,4,1,2,0,3,-1,0
Myanmar,1985,Friendly,2,1,1,0,0,1,1,0
Myanmar,1986,Friendly,3,1,1,0,0,1,2,0
Myanmar,1989,Southeast Asian Games,0,7,0,2,0,2,-7,0
Myanmar,1991,Southeast Asian Games,1,6,0,2,0,2,-5,0
Myanmar,1993,Friendly,1,3,0,1,0,1,-2,0
Myanmar,1993,Southeast Asian Games,21,11,3,2,1,6,10,0
Myanmar,1994,Asian Games,2,9,0,2,1,3,-7,0
Myanmar,1994,Friendly,2,2,0,0,1,1,0,0
Myanmar,1995,Friendly,7,2,2,1,0,3,5,0
Myanmar,1995,Southeast Asian Games,10,8,3,3,0,6,2,0
Myanmar,1996,AFC Asian Cup qualification,11,20,2,3,1,6,-9,0
Myanmar,1996,AFF Championship,11,12,2,2,0,4,-1,0
Myanmar,1997,Friendly,0,5,0,1,0,1,-5,0
Myanmar,1997,Southeast Asian Games,10,8,1,2,1,4,2,0
Myanmar,1998,AFF Championship,8,9,1,1,1,3,-1,0
Myanmar,1998,AFF Championship qualification,7,1,2,0,0,2,6,0
Myanmar,1999,Southeast Asian Games,4,10,1,2,1,4,-6,0
Myanmar,2000,AFC Asian Cup qualification,6,4,2,1,0,3,2,0
Myanmar,2000,AFF Championship,4,8,1,2,0,3,-4,0
Myanmar,2000,Friendly,3,12,1,3,0,4,-9,0
Myanmar,2002,AFF Championship,13,5,2,1,1,4,8,0
Myanmar,2002,Friendly,1,1,0,0,2,2,0,0
Myanmar,2003,AFC Asian Cup qualification,11,18,3,5,0,8,-7,0
Myanmar,2004,AFF Championship,9,6,3,1,1,5,3,0
Myanmar,2004,Friendly,3,12,0,4,1,5,-9,0
Myanmar,2005,AFF Championship,3,6,0,2,0,2,-3,0
Myanmar,2006,Merdeka Tournament,4,2,2,0,1,3,2,1
Myanmar,2007,AFF Championship,1,1,0,0,3,3,0,0
Myanmar,2007,FIFA World Cup qualification,0,11,0,2,0,2,-11,0
Myanmar,2007,Merdeka Tournament,5,1,3,0,0,3,4,1
Myanmar,2008,AFC Challenge Cup,6,7,2,3,0,5,-1,0
Myanmar,2008,AFF Championship,4,8,1,2,0,3,-4,0
Myanmar,2008,Friendly,19,12,5,2,1,8,7,0
Myanmar,2008,Merdeka Tournament,1,4,1,1,0,2,-3,0
Myanmar,2009,AFC Challenge Cup qualification,7,1,3,0,0,3,6,0
Myanmar,2010,AFC Challenge Cup,6,10,2,3,0,5,-4,0
Myanmar,2010,AFF Championship,2,9,0,2,1,3,-7,0
Myanmar,2011,AFC Challenge Cup qualification,2,6,0,2,1,3,-4,0
Myanmar,2011,FIFA World Cup qualification,2,5,1,3,0,4,-3,0
Myanmar,2011,Friendly,1,4,0,2,1,3,-3,0
Myanmar,2012,AFF Championship,1,7,0,2,1,3,-6,0
Myanmar,2012,AFF Championship qualification,6,1,3,0,1,4,5,0
Myanmar,2012,Friendly,1,1,0,0,1,1,0,0
Myanmar,2013,AFC Challenge Cup qualification,6,0,2,0,0,2,6,0
Myanmar,2013,Friendly,0,3,0,2,1,3,-3,0
Myanmar,2014,AFC Challenge Cup,3,5,1,2,0,3,-2,0
Myanmar,2014,AFF Championship,2,6,0,2,1,3,-4,0
Myanmar,2014,AFF Championship qualification,6,2,3,0,1,4,4,1
Myanmar,2014,Friendly,7,9,2,1,0,3,-2,0
Myanmar,2015,FIFA World Cup qualification,8,20,2,4,1,7,-12,0
Myanmar,2015,Friendly,2,10,0,4,1,5,-8,0
Myanmar,2016,AFF Championship,5,9,2,3,0,5,-4,0
Myanmar,2016,FIFA World Cup qualification,1,1,0,0,1,1,0,0
Myanmar,2016,Friendly,4,6,1,3,2,6,-2,0
Myanmar,2017,AFC Asian Cup qualification,8,5,1,1,2,4,3,0
Myanmar,2017,Friendly,7,5,3,1,0,4,2,0
Myanmar,2018,AFC Asian Cup qualification,2,5,1,1,0,2,-3,0
Myanmar,2018,AFF Championship,7,5,2,1,1,4,2,0
Myanmar,2018,Friendly,1,11,0,4,0,4,-10,0
Myanmar,2019,FIFA World Cup qualification,5,13,2,3,0,5,-8,0
Myanmar,2019,Friendly,3,7,1,2,1,4,-4,0
Myanmar,2021,AFF Championship,4,10,1,3,0,4,-6,0
Myanmar,2021,FIFA World Cup qualification,1,22,0,3,0,3,-21,0
Myanmar,2021,Friendly,2,6,0,2,0,2,-4,0
Myanmar,2022,AFC Asian Cup qualification,2,12,0,3,0,3,-10,0
Myanmar,2022,AFF Championship,4,6,0,2,1,3,-2,0
Myanmar,2022,Friendly,0,10,0,3,1,4,-10,0
Myanmar,2023,AFF Championship,0,3,0,1,0,1,-3,0
Myanmar,2023,FIFA World Cup qualification,6,12,1,2,1,4,-6,0
Myanmar,2023,Friendly,3,4,2,1,1,4,-1,0
Myanmar,2023,Tri Nation Tournament,1,2,0,1,1,2,-1,0
Myanmar,2024,ASEAN Championship,4,9,1,2,1,4,-5,0
Myanmar,2024,FIFA World Cup qualification,2,17,0,3,1,4,-15,0
Myanmar,2024,Friendly,6,6,1,2,1,4,0,0
Myanmar,2025,AFC Asian Cup qualification,2,1,1,0,0,1,1,0
Namibia,1989,Friendly,0,1,0,1,0,1,-1,0
Namibia,1990,Friendly,1,2,0,1,0,1,-1,0
Namibia,1992,FIFA World Cup qualification,0,9,0,3,0,3,-9,0
Namibia,1992,Friendly,2,4,0,1,1,2,-2,0
Namibia,1993,FIFA World Cup qualification,0,5,0,2,0,2,-5,0
Namibia,1994,African Cup of Nations qualification,3,4,1,1,1,3,-1,0
Namibia,1994,Friendly,5,4,2,1,0,3,1,0
Namibia,1995,African Cup of Nations qualification,5,12,0,3,4,7,-7,0
Namibia,1996,African Cup of Nations qualification,6,0,1,0,1,2,6,0
Namibia,1996,FIFA World Cup qualification,4,8,1,1,1,3,-4,0
Namibia,1997,African Cup of Nations qualification,1,5,0,1,1,2,-4,0
Namibia,1997,COSAFA Cup,6,3,1,0,3,4,3,0
Namibia,1997,COSAFA Cup qualification,2,1,1,0,0,1,1,1
Namibia,1997,FIFA World Cup qualification,5,10,1,3,1,5,-5,0
Namibia,1998,African Cup of Nations,7,11,0,2,1,3,-4,0
Namibia,1998,African Cup of Nations qualification,3,2,2,1,0,3,1,0
Namibia,1998,COSAFA Cup,6,8,1,1,2,4,-2,0
Namibia,1998,COSAFA Cup qualification,3,2,1,0,0,1,1,0
Namibia,1998,Friendly,3,7,0,3,0,3,-4,0
Namibia,1999,African Cup of Nations qualification,2,9,0,3,2,5,-7,0
Namibia,1999,COSAFA Cup,3,4,0,1,3,4,-1,0
Namibia,1999,COSAFA Cup qualification,1,2,0,1,1,2,-1,0
Namibia,1999,Friendly,1,2,0,1,1,2,-1,0
Namibia,2000,African Cup of Nations qualification,9,10,1,3,0,4,-1,0
Namibia,2000,COSAFA Cup,2,3,0,1,0,1,-1,0
Namibia,2000,FIFA World Cup qualification,4,1,1,0,2,3,3,0
Namibia,2000,Friendly,4,2,2,0,0,2,2,0
Namibia,2001,African Cup of Nations qualification,4,5,1,1,2,4,-1,0
Namibia,2001,COSAFA Cup,0,1,0,1,0,1,-1,0
Namibia,2001,FIFA World Cup qualification,3,26,0,6,1,7,-23,0
Namibia,2001,Friendly,3,5,0,2,0,2,-2,0
Namibia,2002,African Cup of Nations qualification,0,1,0,1,0,1,-1,0
Namibia,2002,COSAFA Cup,1,2,0,1,0,1,-1,0
Namibia,2002,Friendly,1,3,0,1,0,1,-2,0
Namibia,2003,African Cup of Nations qualification,2,4,1,2,0,3,-2,0
Namibia,2003,COSAFA Cup,0,1,0,1,0,1,-1,0
Namibia,2003,FIFA World Cup qualification,1,4,0,1,1,2,-3,0
Namibia,2003,Friendly,1,5,0,2,0,2,-4,0
Namibia,2004,COSAFA Cup,1,2,0,1,0,1,-1,0
Namibia,2004,Friendly,0,0,0,0,1,1,0,0
Namibia,2005,COSAFA Cup,1,1,0,0,1,1,0,0
Namibia,2005,Friendly,2,1,1,0,0,1,1,0
Namibia,2006,African Cup of Nations qualification,3,3,1,1,0,2,0,0
Namibia,2006,COSAFA Cup,4,3,1,0,1,2,1,0
Namibia,2006,Friendly,2,4,0,2,0,2,-2,0
Namibia,2007,African Cup of Nations qualification,6,5,2,1,1,4,1,0
Namibia,2007,COSAFA Cup,3,3,1,1,0,2,0,0
Namibia,2007,Friendly,3,9,1,5,0,6,-6,0
Namibia,2008,African Cup of Nations,2,7,0,2,1,3,-5,0
Namibia,2008,COSAFA Cup,0,1,0,1,0,1,-1,0
Namibia,2008,COSAFA Cup qualification,5,1,2,0,1,3,4,1
Namibia,2008,FIFA World Cup qualification,7,12,2,4,0,6,-5,0
Namibia,2008,Friendly,2,9,0,3,0,3,-7,0
Namibia,2009,COSAFA Cup,0,1,0,1,0,1,-1,0
Namibia,2009,Friendly,6,2,1,0,4,5,4,0
Namibia,2010,African Cup of Nations qualification,1,3,0,1,0,1,-2,0
Namibia,2010,Friendly,1,3,0,1,2,3,-2,0
Namibia,2011,African Cup of Nations qualification,2,8,1,2,0,3,-6,0
Namibia,2011,FIFA World Cup qualification,8,0,2,0,0,2,8,0
Namibia,2011,Friendly,3,3,1,1,3,5,0,0
Namibia,2012,African Cup of Nations qualification,0,1,0,1,1,2,-1,0
Namibia,2012,FIFA World Cup qualification,1,1,1,1,0,2,0,0
Namibia,2012,Friendly,2,2,0,0,4,4,0,0
Namibia,2013,COSAFA Cup,7,6,2,2,0,4,1,0
Namibia,2013,FIFA World Cup qualification,1,3,0,2,2,4,-2,0
Namibia,2013,Friendly,1,2,0,1,2,3,-1,0
Namibia,2014,African Cup of Nations qualification,1,3,1,1,0,2,-2,0
Namibia,2014,Friendly,1,2,0,1,1,2,-1,0
Namibia,2015,African Cup of Nations qualification,0,3,0,2,0,2,-3,0
Namibia,2015,COSAFA Cup,11,3,4,0,2,6,8,1
Namibia,2015,FIFA World Cup qualification,3,5,1,2,1,4,-2,0
Namibia,2015,Friendly,0,1,0,1,1,2,-1,0
Namibia,2016,African Cup of Nations qualification,5,6,2,2,0,4,-1,0
Namibia,2016,COSAFA Cup,5,1,2,0,1,3,4,0
Namibia,2017,African Cup of Nations qualification,0,1,0,1,0,1,-1,0
Namibia,2017,COSAFA Cup,1,1,1,1,1,3,0,0
Namibia,2017,Friendly,3,1,1,0,0,1,2,0
Namibia,2018,African Cup of Nations qualification,4,2,2,0,2,4,2,0
Namibia,2018,COSAFA Cup,1,4,0,1,1,2,-3,0
Namibia,2018,Friendly,2,2,1,1,0,2,0,0
Namibia,2019,African Cup of Nations,1,6,0,3,0,3,-5,0
Namibia,2019,African Cup of Nations qualification,3,7,1,2,0,3,-4,0
Namibia,2019,COSAFA Cup,6,3,2,1,0,3,3,0
Namibia,2019,FIFA World Cup qualification,4,1,2,0,0,2,3,0
Namibia,2019,Friendly,0,2,0,1,0,1,-2,0
Namibia,2020,African Cup of Nations qualification,1,3,0,2,0,2,-2,0
Namibia,2020,Friendly,1,1,0,0,1,1,0,0
Namibia,2021,African Cup of Nations qualification,5,1,2,0,0,2,4,0
Namibia,2021,COSAFA Cup,5,3,2,1,1,4,2,0
Namibia,2021,FIFA World Cup qualification,5,10,1,3,2,6,-5,0
Namibia,2022,African Cup of Nations qualification,1,1,0,0,1,1,0,0
Namibia,2022,COSAFA Cup,3,1,2,1,0,3,2,0
Namibia,2023,African Cup of Nations qualification,5,5,1,1,1,3,0,0
Namibia,2023,COSAFA Cup,2,3,0,1,2,3,-1,0
Namibia,2023,FIFA World Cup qualification,2,1,1,1,0,2,1,0
Namibia,2023,Friendly,0,0,0,0,1,1,0,0
Namibia,2024,African Cup of Nations,1,7,1,2,1,4,-6,0
Namibia,2024,African Cup of Nations qualification,2,7,0,4,0,4,-5,0
Namibia,2024,FIFA World Cup qualification,1,1,0,0,2,2,0,0
Namibia,2024,Friendly,0,0,0,0,1,1,0,0
Namibia,2025,FIFA World Cup qualification,2,1,1,0,1,2,1,0
Nepal,1972,Friendly,2,6,0,1,0,1,-4,0
Nepal,1982,Asian Games,1,9,0,3,0,3,-8,0
Nepal,1982,Friendly,5,3,2,1,1,4,2,0
Nepal,1982,King's Cup,0,2,0,1,0,1,-2,0
Nepal,1983,Merdeka Tournament,0,8,0,2,0,2,-8,0
Nepal,1984,AFC Asian Cup qualification,0,30,0,4,0,4,-30,0
Nepal,1984,South Asian Games,13,7,3,1,0,4,6,1
Nepal,1985,FIFA World Cup qualification,0,11,0,3,1,4,-11,0
Nepal,1985,Friendly,1,9,0,2,0,2,-8,0
Nepal,1985,South Asian Games,3,4,1,1,1,3,-1,0
Nepal,1986,Asian Games,0,17,0,4,0,4,-17,0
Nepal,1986,Friendly,12,21,3,4,1,8,-9,0
Nepal,1987,South Asian Games,7,3,2,1,0,3,4,0
Nepal,1988,AFC Asian Cup qualification,0,7,0,3,1,4,-7,0
Nepal,1989,FIFA World Cup qualification,0,28,0,6,0,6,-28,0
Nepal,1989,South Asian Games,1,2,0,1,2,3,-1,0
Nepal,1991,South Asian Games,2,5,0,2,1,3,-3,0
Nepal,1993,South Asian Games,3,2,1,0,2,3,1,0
Nepal,1994,Asian Games,0,20,0,3,0,3,-20,0
Nepal,1995,SAFF Cup,3,4,1,2,0,3,-1,0
Nepal,1995,South Asian Games,2,5,1,2,1,4,-3,0
Nepal,1996,AFC Asian Cup qualification,2,26,0,6,0,6,-24,0
Nepal,1997,FIFA World Cup qualification,2,19,0,5,1,6,-17,0
Nepal,1997,SAFF Cup,1,5,0,2,0,2,-4,0
Nepal,1998,Asian Games,0,6,0,2,0,2,-6,0
Nepal,1998,Friendly,0,2,0,1,0,1,-2,0
Nepal,1999,SAFF Cup,6,9,1,3,0,4,-3,0
Nepal,1999,South Asian Games,12,7,3,2,0,5,5,0
Nepal,2000,AFC Asian Cup qualification,3,13,1,3,0,4,-10,0
Nepal,2001,FIFA World Cup qualification,13,25,2,4,0,6,-12,0
Nepal,2003,AFC Asian Cup qualification,4,45,1,7,0,8,-41,0
Nepal,2003,SAFF Cup,4,4,1,2,0,3,0,0
Nepal,2005,SAFF Cup,4,5,1,2,0,3,-1,0
Nepal,2006,AFC Challenge Cup,5,4,1,1,2,4,1,0
Nepal,2007,FIFA World Cup qualification,0,4,0,2,0,2,-4,0
Nepal,2008,AFC Challenge Cup,3,4,1,2,0,3,-1,0
Nepal,2008,AFC Challenge Cup qualification,4,2,2,0,0,2,2,0
Nepal,2008,Friendly,2,10,1,2,0,3,-8,0
Nepal,2008,Merdeka Tournament,2,6,0,1,1,2,-4,0
Nepal,2008,SAFF Cup,5,9,1,2,0,3,-4,0
Nepal,2009,AFC Challenge Cup qualification,1,1,0,0,2,2,0,0
Nepal,2009,Friendly,5,2,2,0,0,2,3,0
Nepal,2009,SAFF Cup,4,1,1,0,1,2,3,0
Nepal,2011,AFC Challenge Cup qualification,1,1,1,1,1,3,0,0
Nepal,2011,FIFA World Cup qualification,8,11,2,1,1,4,-3,0
Nepal,2011,Friendly,3,5,2,1,0,3,-2,0
Nepal,2011,SAFF Cup,3,3,1,1,2,4,0,0
Nepal,2012,AFC Challenge Cup,0,6,0,3,0,3,-6,0
Nepal,2012,Friendly,1,1,0,0,1,1,0,0
Nepal,2012,Nehru Cup,1,9,0,3,1,4,-8,0
Nepal,2013,AFC Challenge Cup qualification,6,2,1,1,1,3,4,0
Nepal,2013,Friendly,0,4,0,3,0,3,-4,0
Nepal,2013,SAFF Cup,5,3,2,1,1,4,2,0
Nepal,2014,Friendly,0,7,0,3,0,3,-7,0
Nepal,2015,FIFA World Cup qualification,0,2,0,1,1,2,-2,0
Nepal,2015,Friendly,0,1,0,1,1,2,-1,0
Nepal,2015,SAFF Cup,1,5,0,2,0,2,-4,0
Nepal,2016,AFC Challenge Cup,6,2,2,0,2,4,4,1
Nepal,2016,Friendly,6,2,2,0,2,4,4,0
Nepal,2017,AFC Asian Cup qualification,2,9,0,3,2,5,-7,0
Nepal,2017,Friendly,0,2,0,1,0,1,-2,0
Nepal,2018,AFC Asian Cup qualification,1,2,0,1,0,1,-1,0
Nepal,2018,SAFF Cup,7,5,2,2,0,4,2,0
Nepal,2019,FIFA World Cup qualification,2,16,1,4,0,5,-14,0
Nepal,2019,Friendly,1,4,0,2,2,4,-3,0
Nepal,2020,Friendly,0,2,0,1,1,2,-2,0
Nepal,2021,FIFA World Cup qualification,2,6,1,2,0,3,-4,0
Nepal,2021,Friendly,6,10,1,2,2,5,-4,0
Nepal,2021,SAFF Cup,5,7,2,2,1,5,-2,0
Nepal,2022,AFC Asian Cup qualification,1,13,0,3,0,3,-12,0
Nepal,2022,Friendly,6,5,4,2,0,6,1,0
Nepal,2023,FIFA World Cup qualification,2,7,1,2,1,4,-5,0
Nepal,2023,Friendly,0,2,0,2,1,3,-2,0
Nepal,2023,SAFF Cup,2,5,1,2,0,3,-3,0
Nepal,2023,Tri Nation Tournament,5,2,2,0,1,3,3,1
Nepal,2024,FIFA World Cup qualification,2,14,0,3,1,4,-12,0
Nepal,2024,Friendly,2,4,1,1,0,2,-2,0
Nepal,2025,AFC Asian Cup qualification,0,2,0,1,0,1,-2,0
Nepal,2025,Friendly,1,0,1,0,0,1,1,0
Netherlands,1905,Friendly,8,1,2,0,0,2,7,0
Netherlands,1906,Friendly,2,8,0,2,0,2,-6,0
Netherlands,1907,Friendly,4,3,1,1,0,2,1,0
Netherlands,1908,Friendly,16,6,4,0,0,4,10,0
Netherlands,1908,Olympic Games,2,0,1,0,0,1,2,1
Netherlands,1909,Friendly,8,2,2,0,0,2,6,0
Netherlands,1910,Friendly,15,6,3,1,0,4,9,0
Netherlands,1911,Friendly,8,2,2,0,0,2,6,0
Netherlands,1912,Friendly,14,11,3,0,1,4,3,0
Netherlands,1912,Olympic Games,17,8,3,1,0,4,9,0
Netherlands,1913,Friendly,5,7,0,1,1,2,-2,0
Netherlands,1914,Friendly,15,12,2,1,1,4,3,0
Netherlands,1919,Friendly,5,6,1,1,1,3,-1,0
Netherlands,1920,Friendly,4,3,1,1,1,3,1,0
Netherlands,1920,Olympic Games,9,10,2,2,0,4,-1,0
Netherlands,1921,Friendly,9,4,1,0,3,4,5,0
Netherlands,1922,Friendly,3,11,1,3,0,4,-8,0
Netherlands,1923,Friendly,13,3,2,0,2,4,10,0
Netherlands,1924,Friendly,4,4,1,1,2,4,0,0
Netherlands,1924,Olympic Games,11,7,2,2,1,5,4,0
Netherlands,1925,Friendly,13,7,4,1,0,5,6,0
Netherlands,1926,Friendly,12,17,1,4,1,6,-5,0
Netherlands,1927,Friendly,7,7,2,1,2,5,0,0
Netherlands,1928,Friendly,8,10,1,4,2,7,-2,0
Netherlands,1928,Olympic Games,5,5,1,1,1,3,0,0
Netherlands,1929,Friendly,11,21,1,4,1,6,-10,0
Netherlands,1930,Friendly,9,18,0,3,2,5,-9,0
Netherlands,1931,Friendly,12,10,3,1,1,5,2,0
Netherlands,1932,Friendly,9,6,3,2,0,5,3,0
Netherlands,1933,Friendly,5,8,1,4,0,5,-3,0
Netherlands,1934,FIFA World Cup,2,3,0,1,0,1,-1,0
Netherlands,1934,FIFA World Cup qualification,9,4,2,0,0,2,5,0
Netherlands,1934,Friendly,17,10,2,1,0,3,7,0
Netherlands,1935,Friendly,16,9,4,2,0,6,7,0
Netherlands,1936,Friendly,18,5,2,0,2,4,13,0
Netherlands,1937,FIFA World Cup qualification,4,0,1,0,0,1,4,1
Netherlands,1937,Friendly,8,8,2,2,1,5,0,0
Netherlands,1938,FIFA World Cup,0,3,0,1,0,1,-3,0
Netherlands,1938,FIFA World Cup qualification,1,1,0,0,1,1,0,0
Netherlands,1938,Friendly,19,9,2,1,1,4,10,0
Netherlands,1939,Friendly,11,11,2,2,0,4,0,0
Netherlands,1940,Friendly,9,14,1,2,0,3,-5,0
Netherlands,1946,Friendly,16,15,2,1,1,4,1,0
Netherlands,1947,Friendly,10,8,3,1,0,4,2,0
Netherlands,1948,Friendly,7,5,2,0,3,5,2,0
Netherlands,1949,Friendly,13,8,3,2,1,6,5,0
Netherlands,1950,Friendly,11,29,0,6,0,6,-18,0
Netherlands,1951,Friendly,17,18,1,2,1,4,-1,0
Netherlands,1952,Friendly,9,13,0,3,3,6,-4,0
Netherlands,1953,Friendly,3,10,1,4,0,5,-7,0
Netherlands,1954,Friendly,14,26,2,6,1,9,-12,0
Netherlands,1955,Friendly,13,6,4,1,2,7,7,0
Netherlands,1956,Friendly,15,13,5,1,1,7,2,0
Netherlands,1957,FIFA World Cup qualification,12,7,2,1,1,4,5,0
Netherlands,1957,Friendly,8,10,1,2,1,4,-2,0
Netherlands,1958,Friendly,35,11,6,1,1,8,24,0
Netherlands,1959,Friendly,21,16,2,3,2,7,5,0
Netherlands,1960,Friendly,15,18,3,4,1,8,-3,0
Netherlands,1961,FIFA World Cup qualification,4,7,0,1,2,3,-3,0
Netherlands,1961,Friendly,7,8,1,2,0,3,-1,0
Netherlands,1962,Friendly,15,11,2,4,0,6,4,0
Netherlands,1962,UEFA Euro qualification,3,1,1,0,0,1,2,0
Netherlands,1963,Friendly,3,2,2,1,1,4,1,0
Netherlands,1963,UEFA Euro qualification,3,4,0,1,2,3,-1,0
Netherlands,1964,FIFA World Cup qualification,4,0,2,0,0,2,4,0
Netherlands,1964,Friendly,2,4,0,2,3,5,-2,0
Netherlands,1965,FIFA World Cup qualification,2,4,0,2,2,4,-2,0
Netherlands,1965,Friendly,1,0,1,0,0,1,1,0
Netherlands,1966,Friendly,10,9,2,3,0,5,1,0
Netherlands,1966,UEFA Euro qualification,4,2,1,0,1,2,2,0
Netherlands,1967,Friendly,4,4,1,2,0,3,0,0
Netherlands,1967,UEFA Euro qualification,7,9,1,3,0,4,-2,0
Netherlands,1968,FIFA World Cup qualification,2,2,1,1,0,2,0,0
Netherlands,1968,Friendly,1,2,0,1,3,4,-1,0
Netherlands,1969,FIFA World Cup qualification,7,3,2,1,1,4,4,0
Netherlands,1969,Friendly,2,1,1,1,0,2,1,0
Netherlands,1970,Friendly,3,0,2,0,1,3,3,0
Netherlands,1970,UEFA Euro qualification,1,2,0,1,1,2,-1,0
Netherlands,1971,Friendly,2,1,1,0,0,1,1,0
Netherlands,1971,UEFA Euro qualification,17,4,3,1,0,4,13,0
Netherlands,1972,FIFA World Cup qualification,9,0,1,0,1,2,9,0
Netherlands,1972,Friendly,10,1,3,0,0,3,9,0
Netherlands,1973,FIFA World Cup qualification,15,2,3,0,1,4,13,0
Netherlands,1973,Friendly,4,4,1,1,1,3,0,0
Netherlands,1974,FIFA World Cup,15,3,5,1,1,7,12,0
Netherlands,1974,Friendly,11,3,3,0,2,5,8,0
Netherlands,1974,UEFA Euro qualification,6,2,2,0,0,2,4,0
Netherlands,1975,Friendly,1,2,0,1,1,2,-1,0
Netherlands,1975,UEFA Euro qualification,8,6,2,2,0,4,2,0
Netherlands,1976,FIFA World Cup qualification,3,2,1,0,1,2,1,0
Netherlands,1976,UEFA Euro,4,5,1,1,0,2,-1,0
Netherlands,1976,UEFA Euro qualification,7,1,2,0,0,2,6,0
Netherlands,1977,FIFA World Cup qualification,8,1,4,0,0,4,7,0
Netherlands,1977,Friendly,2,0,1,0,1,2,2,0
Netherlands,1978,FIFA World Cup,15,10,3,2,2,7,5,0
Netherlands,1978,Friendly,8,4,3,1,0,4,4,0
Netherlands,1978,UEFA Euro qualification,9,1,3,0,0,3,8,0
Netherlands,1979,FIFA 75th Anniversary Cup,0,0,0,0,1,1,0,0
Netherlands,1979,Friendly,1,3,1,1,0,2,-2,0
Netherlands,1979,UEFA Euro qualification,11,5,3,1,1,5,6,0
Netherlands,1980,FIFA World Cup qualification,1,3,0,2,0,2,-2,0
Netherlands,1980,Friendly,1,2,0,1,2,3,-1,0
Netherlands,1980,Mundialito,0,2,0,1,0,1,-2,0
Netherlands,1980,UEFA Euro,4,4,1,1,1,3,0,0
Netherlands,1981,FIFA World Cup qualification,10,4,4,1,1,6,6,0
Netherlands,1981,Friendly,1,2,0,1,0,1,-1,0
Netherlands,1981,Mundialito,1,1,0,0,1,1,0,0
Netherlands,1982,Friendly,3,6,1,3,0,4,-3,0
Netherlands,1982,UEFA Euro qualification,9,2,2,0,1,3,7,1
Netherlands,1983,Friendly,1,4,0,1,1,2,-3,0
Netherlands,1983,UEFA Euro qualification,13,4,4,1,0,5,9,0
Netherlands,1984,FIFA World Cup qualification,2,3,1,2,0,3,-1,1
Netherlands,1984,Friendly,6,0,1,0,0,1,6,0
Netherlands,1985,FIFA World Cup qualification,11,4,3,1,1,5,7,0
Netherlands,1985,Friendly,1,0,1,0,0,1,1,0
Netherlands,1986,Friendly,2,4,1,2,1,4,-2,0
Netherlands,1986,UEFA Euro qualification,3,0,2,0,1,3,3,1
Netherlands,1987,Friendly,2,1,1,0,2,3,1,0
Netherlands,1987,UEFA Euro qualification,20,1,5,0,1,6,19,0
Netherlands,1988,FIFA World Cup qualification,1,0,1,0,1,2,1,0
Netherlands,1988,Friendly,5,5,1,2,1,4,0,0
Netherlands,1988,UEFA Euro,8,3,4,1,0,5,5,1
Netherlands,1989,FIFA World Cup qualification,7,2,3,0,1,4,5,0
Netherlands,1989,Friendly,6,3,2,1,1,4,3,0
Netherlands,1990,FIFA World Cup,3,4,0,1,3,4,-1,0
Netherlands,1990,Friendly,5,6,1,3,1,5,-1,0
Netherlands,1990,UEFA Euro qualification,10,1,2,1,0,3,9,0
Netherlands,1991,Friendly,1,1,0,0,1,1,0,0
Netherlands,1991,UEFA Euro qualification,7,1,4,0,1,5,6,0
Netherlands,1992,FIFA World Cup qualification,6,5,1,1,1,3,1,0
Netherlands,1992,Friendly,12,8,3,2,1,6,4,0
Netherlands,1992,UEFA Euro,6,3,2,0,2,4,3,0
Netherlands,1993,FIFA World Cup qualification,23,4,5,0,2,7,19,0
Netherlands,1994,FIFA World Cup,8,6,3,2,0,5,2,0
Netherlands,1994,Friendly,16,5,4,1,1,6,11,0
Netherlands,1994,UEFA Euro qualification,10,1,2,0,2,4,9,0
Netherlands,1995,Friendly,0,2,0,2,0,2,-2,0
Netherlands,1995,UEFA Euro qualification,15,4,5,2,0,7,11,1
Netherlands,1996,FIFA World Cup qualification,13,2,3,0,0,3,11,0
Netherlands,1996,Friendly,7,4,2,1,1,4,3,0
Netherlands,1996,UEFA Euro,3,4,1,1,2,4,-1,0
Netherlands,1997,FIFA World Cup qualification,13,2,3,1,1,5,11,0
Netherlands,1997,Friendly,3,2,1,1,0,2,1,0
Netherlands,1998,FIFA World Cup,13,7,3,1,3,7,6,0
Netherlands,1998,Friendly,18,5,5,0,3,8,13,0
Netherlands,1999,Friendly,13,16,0,2,7,9,-3,0
Netherlands,2000,FIFA World Cup qualification,6,4,1,1,1,3,2,0
Netherlands,2000,Friendly,11,6,4,0,2,6,5,0
Netherlands,2000,UEFA Euro,13,3,4,0,1,5,10,0
Netherlands,2001,FIFA World Cup qualification,24,5,5,1,1,7,19,0
Netherlands,2001,Friendly,3,1,1,0,2,3,2,0
Netherlands,2002,Friendly,8,2,4,0,1,5,6,0
Netherlands,2002,UEFA Euro qualification,6,0,2,0,0,2,6,0
Netherlands,2003,Friendly,3,2,1,0,2,3,1,0
Netherlands,2003,UEFA Euro qualification,20,7,5,2,1,8,13,1
Netherlands,2004,FIFA World Cup qualification,10,3,3,0,1,4,7,0
Netherlands,2004,Friendly,13,4,4,2,2,8,9,0
Netherlands,2004,UEFA Euro,7,6,1,2,2,5,1,0
Netherlands,2005,FIFA World Cup qualification,17,0,7,0,1,8,17,0
Netherlands,2005,Friendly,3,5,0,1,2,3,-2,0
Netherlands,2006,FIFA World Cup,3,2,2,1,1,4,1,0
Netherlands,2006,Friendly,10,3,4,0,2,6,7,0
Netherlands,2006,UEFA Euro qualification,7,2,3,0,1,4,5,0
Netherlands,2007,Friendly,10,4,3,1,0,4,6,0
Netherlands,2007,UEFA Euro qualification,8,3,5,2,1,8,5,0
Netherlands,2008,FIFA World Cup qualification,5,1,3,0,0,3,4,0
Netherlands,2008,Friendly,18,8,5,1,2,8,10,0
Netherlands,2008,UEFA Euro,10,4,3,1,0,4,6,0
Netherlands,2009,FIFA World Cup qualification,12,1,5,0,0,5,11,0
Netherlands,2009,Friendly,6,3,1,0,5,6,3,0
Netherlands,2010,FIFA World Cup,12,6,6,1,0,7,6,0
Netherlands,2010,Friendly,16,5,5,0,1,6,11,0
Netherlands,2010,UEFA Euro qualification,12,2,4,0,0,4,10,0
Netherlands,2011,Copa Confraternidad,1,1,0,0,1,1,0,0
Netherlands,2011,Friendly,3,4,1,1,2,4,-1,0
Netherlands,2011,UEFA Euro qualification,25,6,5,1,0,6,19,0
Netherlands,2012,FIFA World Cup qualification,13,2,4,0,0,4,11,0
Netherlands,2012,Friendly,14,8,3,2,1,6,6,0
Netherlands,2012,UEFA Euro,2,5,0,3,0,3,-3,0
Netherlands,2013,FIFA World Cup qualification,21,3,5,0,1,6,18,0
Netherlands,2013,Friendly,9,4,2,0,4,6,5,0
Netherlands,2014,FIFA World Cup,15,4,5,0,2,7,11,0
Netherlands,2014,Friendly,6,8,2,3,1,6,-2,0
Netherlands,2014,UEFA Euro qualification,10,5,2,2,0,4,5,0
Netherlands,2015,Friendly,8,6,2,1,0,3,2,0
Netherlands,2015,UEFA Euro qualification,7,9,2,3,1,6,-2,0
Netherlands,2016,FIFA World Cup qualification,8,4,2,1,1,4,4,0
Netherlands,2016,Friendly,11,9,3,2,2,7,2,0
Netherlands,2017,FIFA World Cup qualification,13,8,4,2,0,6,5,0
Netherlands,2017,Friendly,12,3,4,1,0,5,9,0
Netherlands,2018,Friendly,8,5,2,1,3,6,3,0
Netherlands,2018,UEFA Nations League,8,4,2,1,1,4,4,0
Netherlands,2019,UEFA Euro qualification,24,7,6,1,1,8,17,0
Netherlands,2019,UEFA Nations League,3,2,1,1,0,2,1,0
Netherlands,2020,Friendly,1,2,0,1,1,2,-1,0
Netherlands,2020,UEFA Nations League,7,4,3,1,2,6,3,0
Netherlands,2021,FIFA World Cup qualification,33,8,7,1,2,10,25,0
Netherlands,2021,Friendly,5,2,1,0,1,2,3,0
Netherlands,2021,UEFA Euro,8,4,3,1,0,4,4,0
Netherlands,2022,FIFA World Cup,10,4,3,0,2,5,6,0
Netherlands,2022,Friendly,5,3,1,0,1,2,2,0
Netherlands,2022,UEFA Nations League,14,6,5,0,1,6,8,0
Netherlands,2023,UEFA Euro qualification,17,7,6,2,0,8,10,0
Netherlands,2023,UEFA Nations League,4,7,0,2,0,2,-3,0
Netherlands,2024,Friendly,13,2,3,1,0,4,11,0
Netherlands,2024,UEFA Euro,10,7,3,2,1,6,3,0
Netherlands,2024,UEFA Nations League,13,7,2,1,3,6,6,0
Netherlands,2025,UEFA Nations League,5,5,0,0,2,2,0,0
New Caledonia,1951,Friendly,9,9,2,2,0,4,0,0
New Caledonia,1953,Friendly,13,2,3,0,0,3,11,0
New Caledonia,1955,Friendly,1,1,0,0,1,1,0,0
New Caledonia,1957,Friendly,6,5,2,1,0,3,1,0
New Caledonia,1958,Friendly,3,9,0,3,0,3,-6,0
New Caledonia,1959,Friendly,5,5,1,1,0,2,0,0
New Caledonia,1961,Friendly,7,3,2,0,1,3,4,0
New Caledonia,1962,Friendly,3,8,0,2,0,2,-5,0
New Caledonia,1963,South Pacific Games,10,3,2,0,0,2,7,1
New Caledonia,1964,Friendly,3,4,1,1,0,2,-1,0
New Caledonia,1965,Friendly,6,2,2,0,0,2,4,0
New Caledonia,1966,South Pacific Games,17,2,3,1,0,4,15,0
New Caledonia,1967,Friendly,4,0,1,0,0,1,4,0
New Caledonia,1968,Friendly,6,4,2,1,1,4,2,0
New Caledonia,1969,Friendly,5,2,2,0,1,3,3,0
New Caledonia,1969,South Pacific Games,20,3,4,0,1,5,17,0
New Caledonia,1970,Friendly,4,7,1,3,0,4,-3,0
New Caledonia,1971,Friendly,6,3,2,0,0,2,3,0
New Caledonia,1971,South Pacific Games,16,2,3,0,1,4,14,0
New Caledonia,1972,Friendly,5,7,1,2,0,3,-2,0
New Caledonia,1973,Friendly,3,5,0,1,0,1,-2,0
New Caledonia,1973,Oceania Nations Cup,10,6,3,2,0,5,4,1
New Caledonia,1974,Friendly,5,5,1,1,1,3,0,0
New Caledonia,1975,South Pacific Games,16,4,4,1,0,5,12,0
New Caledonia,1976,Friendly,2,1,1,0,0,1,1,0
New Caledonia,1977,Friendly,0,7,0,2,0,2,-7,0
New Caledonia,1978,Friendly,5,4,1,1,0,2,1,0
New Caledonia,1979,South Pacific Games,27,7,3,2,0,5,20,0
New Caledonia,1980,Oceania Nations Cup,14,12,3,1,0,4,2,1
New Caledonia,1981,South Pacific Mini Games,19,6,3,2,2,7,13,0
New Caledonia,1983,South Pacific Games,16,11,4,2,0,6,5,1
New Caledonia,1987,Friendly,0,0,0,0,1,1,0,0
New Caledonia,1987,South Pacific Games,26,4,5,1,0,6,22,1
New Caledonia,1988,Friendly,6,5,1,3,0,4,1,0
New Caledonia,1989,Friendly,9,5,3,1,0,4,4,0
New Caledonia,1990,Friendly,5,3,2,1,1,4,2,0
New Caledonia,1991,South Pacific Games,25,10,2,2,1,5,15,1
New Caledonia,1992,Friendly,5,5,2,2,1,5,0,0
New Caledonia,1993,South Pacific Mini Games,16,5,2,1,2,5,11,0
New Caledonia,1994,Oceania Nations Cup qualification,5,9,1,3,0,4,-4,0
New Caledonia,1995,South Pacific Games,19,3,2,2,0,4,16,0
New Caledonia,1997,Friendly,1,5,0,1,0,1,-4,0
New Caledonia,1998,Oceania Nations Cup qualification,4,10,0,4,0,4,-6,0
New Caledonia,2000,Friendly,4,1,2,0,0,2,3,0
New Caledonia,2000,Oceania Nations Cup qualification,11,11,2,2,0,4,0,0
New Caledonia,2002,Oceania Nations Cup,1,14,0,3,0,3,-13,0
New Caledonia,2002,Oceania Nations Cup qualification,25,4,3,1,0,4,21,1
New Caledonia,2003,South Pacific Games,29,3,4,1,1,6,26,0
New Caledonia,2004,FIFA World Cup qualification,16,2,2,1,1,4,14,0
New Caledonia,2007,Friendly,5,5,1,1,0,2,0,0
New Caledonia,2007,Oceania Nations Cup,7,3,1,0,1,2,4,1
New Caledonia,2007,South Pacific Games,10,3,5,0,1,6,7,1
New Caledonia,2008,Coupe de l'Outre-Mer,5,7,2,1,1,4,-2,0
New Caledonia,2008,Oceania Nations Cup,5,7,1,2,1,4,-2,0
New Caledonia,2010,Coupe de l'Outre-Mer,2,6,0,1,2,3,-4,0
New Caledonia,2011,Friendly,6,9,1,3,1,5,-3,0
New Caledonia,2011,Pacific Games,36,3,6,1,0,7,33,0
New Caledonia,2012,Coupe de l'Outre-Mer,16,6,1,3,0,4,10,0
New Caledonia,2012,FIFA World Cup qualification,15,4,3,1,0,4,11,0
New Caledonia,2012,Oceania Nations Cup,19,7,3,2,0,5,12,0
New Caledonia,2013,FIFA World Cup qualification,2,2,1,1,0,2,0,0
New Caledonia,2016,FIFA World Cup qualification,0,2,0,1,1,2,-2,0
New Caledonia,2016,Friendly,5,2,2,1,0,3,3,0
New Caledonia,2016,Oceania Nations Cup,9,3,1,1,2,4,6,0
New Caledonia,2017,FIFA World Cup qualification,4,3,1,0,1,2,1,0
New Caledonia,2017,Friendly,1,1,0,0,1,1,0,0
New Caledonia,2017,Pacific Mini Games,7,10,1,3,1,5,-3,0
New Caledonia,2018,Friendly,6,6,1,1,2,4,0,0
New Caledonia,2019,Friendly,1,6,0,2,0,2,-5,0
New Caledonia,2019,Pacific Games,22,0,5,0,0,5,22,0
New Caledonia,2022,FIFA World Cup qualification,2,10,0,3,0,3,-8,0
New Caledonia,2022,MSG Prime Minister's Cup,0,2,0,2,0,2,-2,0
New Caledonia,2023,Friendly,3,2,1,1,0,2,1,0
New Caledonia,2023,MSG Prime Minister's Cup,7,2,2,1,0,3,5,0
New Caledonia,2023,Pacific Games,18,2,3,0,1,4,16,0
New Caledonia,2024,FIFA World Cup qualification,7,4,2,0,1,3,3,0
New Caledonia,2025,FIFA World Cup qualification,3,3,1,1,0,2,0,0
New Zealand,1922,Friendly,7,3,2,0,1,3,4,0
New Zealand,1923,Friendly,8,5,2,1,0,3,3,0
New Zealand,1927,Friendly,5,8,1,2,1,4,-3,0
New Zealand,1933,Friendly,8,14,0,3,0,3,-6,0
New Zealand,1936,Friendly,2,21,0,3,0,3,-19,0
New Zealand,1947,Friendly,9,24,0,4,0,4,-15,0
New Zealand,1948,Friendly,1,25,0,4,0,4,-24,0
New Zealand,1951,Friendly,24,13,4,2,0,6,11,0
New Zealand,1952,Friendly,23,7,4,0,1,5,16,0
New Zealand,1954,Friendly,4,9,1,2,0,3,-5,0
New Zealand,1958,Friendly,13,8,3,1,1,5,5,0
New Zealand,1960,Friendly,7,2,2,0,0,2,5,0
New Zealand,1962,Friendly,8,3,2,0,0,2,5,0
New Zealand,1967,Friendly,8,6,1,1,0,2,2,0
New Zealand,1967,Vietnam Independence Cup,7,11,1,2,0,3,-4,0
New Zealand,1968,Friendly,6,3,1,1,0,2,3,0
New Zealand,1969,FIFA World Cup qualification,0,6,0,2,0,2,-6,0
New Zealand,1969,Friendly,4,5,1,2,1,4,-1,0
New Zealand,1971,Friendly,3,6,0,2,0,2,-3,0
New Zealand,1972,Friendly,9,9,2,2,1,5,0,0
New Zealand,1973,FIFA World Cup qualification,5,12,0,3,3,6,-7,0
New Zealand,1973,Friendly,0,0,0,0,1,1,0,0
New Zealand,1973,Oceania Nations Cup,13,4,4,0,1,5,9,0
New Zealand,1975,Friendly,10,8,2,1,3,6,2,0
New Zealand,1976,Friendly,2,6,0,3,0,3,-4,0
New Zealand,1976,Korea Cup,5,3,2,1,0,3,2,0
New Zealand,1977,FIFA World Cup qualification,14,4,2,1,1,4,10,0
New Zealand,1977,Friendly,7,0,2,0,0,2,7,0
New Zealand,1978,Friendly,2,0,1,0,0,1,2,0
New Zealand,1979,Friendly,14,1,5,0,0,5,13,0
New Zealand,1980,Friendly,7,8,2,2,1,5,-1,0
New Zealand,1980,Merdeka Tournament,9,9,2,2,3,7,0,0
New Zealand,1980,Oceania Nations Cup,7,8,1,2,0,3,-1,0
New Zealand,1981,FIFA World Cup qualification,42,9,8,1,5,14,33,1
New Zealand,1981,Merdeka Tournament,2,1,2,1,2,5,1,0
New Zealand,1982,FIFA World Cup,2,12,0,3,0,3,-10,0
New Zealand,1982,FIFA World Cup qualification,2,1,1,0,0,1,1,1
New Zealand,1982,Friendly,2,4,0,2,0,2,-2,0
New Zealand,1983,Friendly,5,3,3,1,0,4,2,0
New Zealand,1983,Korea Cup,3,1,1,0,1,2,2,0
New Zealand,1984,Friendly,11,3,3,0,2,5,8,0
New Zealand,1985,FIFA World Cup qualification,13,7,3,2,1,6,6,0
New Zealand,1985,Friendly,10,0,3,0,0,3,10,0
New Zealand,1986,Friendly,8,6,2,1,1,4,2,0
New Zealand,1987,Friendly,2,1,1,0,1,2,1,0
New Zealand,1988,FIFA World Cup qualification,8,1,2,0,0,2,7,0
New Zealand,1988,Friendly,7,10,2,4,1,7,-3,0
New Zealand,1989,FIFA World Cup qualification,5,7,1,2,1,4,-2,0
New Zealand,1990,Friendly,3,1,2,0,0,2,2,0
New Zealand,1991,Friendly,1,6,0,4,0,4,-5,0
New Zealand,1992,FIFA World Cup qualification,15,1,3,0,0,3,14,0
New Zealand,1993,FIFA World Cup qualification,0,4,0,2,0,2,-4,0
New Zealand,1993,Friendly,8,4,2,2,0,4,4,0
New Zealand,1995,Friendly,9,16,1,4,1,6,-7,0
New Zealand,1995,Oceania Nations Cup,0,3,0,1,1,2,-3,0
New Zealand,1996,Friendly,6,10,2,3,1,6,-4,0
New Zealand,1997,FIFA World Cup qualification,13,6,3,3,0,6,7,0
New Zealand,1997,Friendly,1,12,0,4,0,4,-11,0
New Zealand,1998,Friendly,0,1,0,1,1,2,-1,0
New Zealand,1998,Oceania Nations Cup,11,1,4,0,0,4,10,1
New Zealand,1999,Confederations Cup,1,6,0,3,0,3,-5,0
New Zealand,1999,Four Nations' Cup,2,2,0,0,2,2,0,0
New Zealand,1999,Friendly,10,8,2,3,2,7,2,0
New Zealand,2000,Friendly,1,4,0,3,1,4,-3,0
New Zealand,2000,Merdeka Tournament,3,0,2,0,1,3,3,1
New Zealand,2000,Oceania Nations Cup,7,3,3,1,0,4,4,0
New Zealand,2001,FIFA World Cup qualification,20,7,4,2,0,6,13,0
New Zealand,2001,Friendly,0,3,0,1,0,1,-3,0
New Zealand,2002,Friendly,2,5,0,2,0,2,-3,0
New Zealand,2002,Oceania Nations Cup,23,2,5,0,0,5,21,1
New Zealand,2003,Confederations Cup,1,11,0,3,0,3,-10,0
New Zealand,2003,Friendly,2,6,0,2,1,3,-4,0
New Zealand,2004,Oceania Nations Cup,17,5,3,2,0,5,12,0
New Zealand,2005,Friendly,0,1,0,1,0,1,-1,0
New Zealand,2006,Friendly,8,14,3,4,1,8,-6,0
New Zealand,2007,Friendly,2,11,0,2,1,3,-9,0
New Zealand,2007,Oceania Nations Cup,8,2,3,0,0,3,6,0
New Zealand,2008,Oceania Nations Cup,6,3,2,1,0,3,3,0
New Zealand,2009,Confederations Cup,0,7,0,2,1,3,-7,0
New Zealand,2009,FIFA World Cup qualification,1,0,1,0,1,2,1,0
New Zealand,2009,Friendly,8,10,1,3,1,5,-2,0
New Zealand,2010,FIFA World Cup,2,2,0,0,3,3,0,0
New Zealand,2010,Friendly,4,10,1,4,1,6,-6,0
New Zealand,2011,Friendly,1,7,0,2,1,3,-6,0
New Zealand,2012,FIFA World Cup qualification,13,1,4,0,0,4,12,0
New Zealand,2012,Friendly,6,6,1,1,2,4,0,0
New Zealand,2012,Oceania Nations Cup,8,7,3,1,1,5,1,1
New Zealand,2013,FIFA World Cup qualification,7,10,2,2,0,4,-3,0
New Zealand,2013,Friendly,0,0,0,0,1,1,0,0
New Zealand,2013,OSN Cup,1,2,1,1,0,2,-1,0
New Zealand,2014,Friendly,4,10,0,3,2,5,-6,0
New Zealand,2015,Friendly,2,2,1,1,1,3,0,0
New Zealand,2016,FIFA World Cup qualification,2,0,1,0,1,2,2,0
New Zealand,2016,Friendly,1,2,0,1,0,1,-1,0
New Zealand,2016,Oceania Nations Cup,10,1,4,0,1,5,9,0
New Zealand,2017,Confederations Cup,1,8,0,3,0,3,-7,0
New Zealand,2017,FIFA World Cup qualification,12,5,3,1,2,6,7,0
New Zealand,2017,Friendly,0,2,0,2,0,2,-2,0
New Zealand,2017,Kirin Challenge Cup,1,2,0,1,0,1,-1,0
New Zealand,2018,Friendly,0,1,0,1,0,1,-1,0
New Zealand,2018,Intercontinental Cup,4,3,2,1,0,3,1,0
New Zealand,2019,Friendly,1,4,0,2,0,2,-3,0
New Zealand,2021,Friendly,5,1,3,0,0,3,4,0
New Zealand,2022,FIFA World Cup qualification,18,2,5,1,0,6,16,0
New Zealand,2022,Friendly,1,7,0,4,1,5,-6,0
New Zealand,2023,Friendly,5,11,1,3,3,7,-6,0
New Zealand,2024,FIFA Series,0,1,0,1,1,2,-1,0
New Zealand,2024,FIFA World Cup qualification,19,1,3,0,0,3,18,0
New Zealand,2024,Friendly,5,4,1,1,1,3,1,0
New Zealand,2024,Oceania Nations Cup,15,0,4,0,0,4,15,1
New Zealand,2025,FIFA World Cup qualification,10,0,2,0,0,2,10,0
Nicaragua,1929,Friendly,0,9,0,1,0,1,-9,0
Nicaragua,1941,CCCF Championship,5,29,0,4,0,4,-24,0
Nicaragua,1943,CCCF Championship,7,39,0,6,0,6,-32,0
Nicaragua,1946,CCCF Championship,5,31,1,4,0,5,-26,0
Nicaragua,1951,CCCF Championship,4,22,0,4,0,4,-18,0
Nicaragua,1953,CCCF Championship,4,18,1,5,0,6,-14,0
Nicaragua,1961,CCCF Championship,1,2,0,1,0,1,-1,0
Nicaragua,1963,CONCACAF Championship,2,15,0,4,0,4,-13,0
Nicaragua,1965,CONCACAF Championship qualification,2,4,1,1,0,2,-2,0
Nicaragua,1966,Friendly,1,3,0,1,0,1,-2,0
Nicaragua,1967,CONCACAF Championship,3,12,0,4,1,5,-9,0
Nicaragua,1967,CONCACAF Championship qualification,4,4,1,1,0,2,0,0
Nicaragua,1971,CONCACAF Championship qualification,2,4,0,2,0,2,-2,0
Nicaragua,1973,Friendly,0,2,0,1,0,1,-2,0
Nicaragua,1984,Friendly,0,2,0,1,0,1,-2,0
Nicaragua,1991,UNCAF Cup,2,3,0,1,0,1,-1,0
Nicaragua,1992,FIFA World Cup qualification,1,10,0,2,0,2,-9,0
Nicaragua,1992,Friendly,1,7,0,1,0,1,-6,0
Nicaragua,1993,UNCAF Cup,0,8,0,2,0,2,-8,0
Nicaragua,1995,UNCAF Cup,0,7,0,2,0,2,-7,0
Nicaragua,1996,FIFA World Cup qualification,1,3,0,2,0,2,-2,0
Nicaragua,1996,Friendly,0,1,0,1,0,1,-1,0
Nicaragua,1997,UNCAF Cup,2,11,0,2,0,2,-9,0
Nicaragua,1999,UNCAF Cup,0,2,0,2,0,2,-2,0
Nicaragua,2000,FIFA World Cup qualification,0,10,0,4,0,4,-10,0
Nicaragua,2000,Friendly,0,4,0,1,0,1,-4,0
Nicaragua,2001,Friendly,1,4,0,2,0,2,-3,0
Nicaragua,2001,UNCAF Cup,2,19,0,3,0,3,-17,0
Nicaragua,2002,Friendly,2,7,1,1,0,2,-5,0
Nicaragua,2003,UNCAF Cup,1,11,1,4,0,5,-10,0
Nicaragua,2004,FIFA World Cup qualification,3,6,0,1,1,2,-3,0
Nicaragua,2004,Friendly,8,12,2,3,2,7,-4,0
Nicaragua,2005,UNCAF Cup,2,9,1,2,0,3,-7,0
Nicaragua,2007,Friendly,0,2,0,1,0,1,-2,0
Nicaragua,2007,UNCAF Cup,6,14,1,3,0,4,-8,0
Nicaragua,2008,FIFA World Cup qualification,0,3,0,2,0,2,-3,0
Nicaragua,2009,Gold Cup,0,8,0,3,0,3,-8,0
Nicaragua,2009,UNCAF Cup,5,6,1,1,2,4,-1,0
Nicaragua,2010,Friendly,0,5,0,1,0,1,-5,0
Nicaragua,2011,FIFA World Cup qualification,5,7,2,2,0,4,-2,0
Nicaragua,2011,Friendly,2,3,0,1,1,2,-1,0
Nicaragua,2011,UNCAF Cup,2,7,0,3,1,4,-5,0
Nicaragua,2012,Friendly,7,5,2,1,1,4,2,0
Nicaragua,2013,UNCAF Cup,2,5,0,2,1,3,-3,0
Nicaragua,2014,Friendly,0,5,0,2,0,2,-5,0
Nicaragua,2014,UNCAF Cup,0,3,0,1,0,1,-3,0
Nicaragua,2015,FIFA World Cup qualification,15,5,5,1,0,6,10,0
Nicaragua,2015,Friendly,6,0,2,0,0,2,6,0
Nicaragua,2016,Friendly,3,5,1,2,0,3,-2,0
Nicaragua,2017,Friendly,2,10,0,5,1,6,-8,0
Nicaragua,2017,Gold Cup,1,7,0,3,0,3,-6,0
Nicaragua,2017,UNCAF Cup,4,4,1,2,0,3,0,0
Nicaragua,2018,CONCACAF Nations League qualification,8,2,2,1,0,3,6,0
Nicaragua,2018,Friendly,6,4,1,0,1,2,2,0
Nicaragua,2019,CONCACAF Nations League,9,11,2,3,1,6,-2,0
Nicaragua,2019,CONCACAF Nations League qualification,1,0,1,0,0,1,1,0
Nicaragua,2019,Friendly,3,9,0,3,2,5,-6,0
Nicaragua,2019,Gold Cup,0,8,0,3,0,3,-8,0
Nicaragua,2020,Friendly,1,1,0,0,2,2,0,0
Nicaragua,2021,FIFA World Cup qualification,10,1,2,1,0,3,9,0
Nicaragua,2021,Friendly,6,6,2,2,1,5,0,0
Nicaragua,2022,CONCACAF Nations League,10,3,3,0,1,4,7,0
Nicaragua,2022,Friendly,8,8,2,4,1,7,0,0
Nicaragua,2023,CONCACAF Nations League,22,3,6,0,2,8,19,0
Nicaragua,2023,Friendly,3,9,0,3,0,3,-6,0
Nicaragua,2024,CONCACAF Nations League,5,5,2,1,1,4,0,0
Nicaragua,2024,FIFA World Cup qualification,8,1,2,0,0,2,7,0
Nicaragua,2024,Friendly,1,4,0,2,1,3,-3,0
Nicaragua,2025,Gold Cup qualification,0,2,0,2,0,2,-2,0
Niger,1961,African Friendship Games,2,2,0,0,1,1,0,0
Niger,1963,African Friendship Games,3,7,0,3,0,3,-4,0
Niger,1966,Friendly,2,1,1,0,0,1,1,0
Niger,1967,African Cup of Nations qualification,0,1,0,1,0,1,-1,0
Niger,1967,Friendly,5,9,0,3,0,3,-4,0
Niger,1969,African Cup of Nations qualification,1,15,0,2,0,2,-14,0
Niger,1969,Friendly,1,1,0,0,1,1,0,0
Niger,1970,African Cup of Nations qualification,1,4,0,2,0,2,-3,0
Niger,1970,Friendly,3,3,0,0,1,1,0,0
Niger,1971,Friendly,0,1,0,1,0,1,-1,0
Niger,1975,African Cup of Nations qualification,2,7,0,2,0,2,-5,0
Niger,1975,Friendly,1,4,0,1,0,1,-3,0
Niger,1976,FIFA World Cup qualification,3,6,1,1,0,2,-3,0
Niger,1979,Friendly,3,2,1,0,1,2,1,0
Niger,1980,FIFA World Cup qualification,3,3,1,1,2,4,0,0
Niger,1980,Friendly,0,1,0,1,0,1,-1,0
Niger,1981,FIFA World Cup qualification,1,4,1,1,0,2,-3,0
Niger,1981,Friendly,2,3,1,1,0,2,-1,0
Niger,1982,African Cup of Nations qualification,0,1,0,1,1,2,-1,0
Niger,1982,Friendly,3,3,0,0,2,2,0,0
Niger,1982,West African Cup,3,5,0,1,2,3,-2,0
Niger,1983,Friendly,5,4,2,1,3,6,1,0
Niger,1984,Friendly,1,4,0,2,0,2,-3,0
Niger,1986,West African Cup,6,10,2,3,1,6,-4,0
Niger,1987,Friendly,1,0,1,0,0,1,1,0
Niger,1987,West African Cup,0,5,0,2,0,2,-5,0
Niger,1988,Tournament Burkina Faso,8,3,2,3,0,5,5,0
Niger,1990,African Cup of Nations qualification,7,4,1,2,0,3,3,0
Niger,1991,African Cup of Nations qualification,2,1,2,1,0,3,1,0
Niger,1991,Friendly,4,7,0,1,1,2,-3,0
Niger,1992,African Cup of Nations qualification,3,4,1,1,0,2,-1,0
Niger,1992,FIFA World Cup qualification,1,0,1,0,1,2,1,0
Niger,1992,Friendly,0,4,0,3,1,4,-4,0
Niger,1993,African Cup of Nations qualification,4,6,1,2,1,4,-2,0
Niger,1993,FIFA World Cup qualification,2,2,1,1,0,2,0,0
Niger,1993,Friendly,4,9,0,2,1,3,-5,0
Niger,1994,Friendly,12,15,2,3,1,6,-3,0
Niger,1996,Friendly,0,0,0,0,1,1,0,0
Niger,1998,African Cup of Nations qualification,2,3,1,1,0,2,-1,0
Niger,1998,Friendly,4,6,2,2,1,5,-2,0
Niger,2000,African Cup of Nations qualification,0,7,0,2,0,2,-7,0
Niger,2002,African Cup of Nations qualification,3,2,1,1,0,2,1,0
Niger,2002,Friendly,4,9,0,1,2,3,-5,0
Niger,2003,African Cup of Nations qualification,2,4,2,2,0,4,-2,0
Niger,2003,FIFA World Cup qualification,0,7,0,2,0,2,-7,0
Niger,2003,TIFOCO Tournament,1,1,0,0,1,1,0,0
Niger,2006,African Cup of Nations qualification,0,2,0,1,1,2,-2,0
Niger,2006,Friendly,1,1,0,0,1,1,0,0
Niger,2007,African Cup of Nations qualification,5,9,1,3,0,4,-4,0
Niger,2007,Friendly,1,1,0,0,1,1,0,0
Niger,2008,FIFA World Cup qualification,5,11,1,5,0,6,-6,0
Niger,2008,Friendly,2,6,0,1,0,1,-4,0
Niger,2010,African Cup of Nations qualification,1,2,1,1,0,2,-1,0
Niger,2010,Friendly,4,2,1,0,3,4,2,0
Niger,2011,African Cup of Nations qualification,5,6,2,2,0,4,-1,0
Niger,2011,Friendly,4,8,0,2,3,5,-4,0
Niger,2012,African Cup of Nations,1,5,0,3,0,3,-4,0
Niger,2012,African Cup of Nations qualification,2,1,1,1,0,2,1,0
Niger,2012,FIFA World Cup qualification,3,1,1,1,0,2,2,0
Niger,2012,Friendly,1,6,0,3,2,5,-5,0
Niger,2013,African Cup of Nations,0,4,0,2,1,3,-4,0
Niger,2013,FIFA World Cup qualification,3,11,0,3,1,4,-8,0
Niger,2013,Friendly,5,4,1,1,1,3,1,0
Niger,2014,African Cup of Nations qualification,4,11,0,3,3,6,-7,0
Niger,2014,Friendly,4,3,1,1,1,3,1,0
Niger,2015,African Cup of Nations qualification,1,2,1,1,0,2,-1,0
Niger,2015,FIFA World Cup qualification,6,3,2,1,1,4,3,0
Niger,2015,Friendly,2,5,1,2,1,4,-3,0
Niger,2016,African Cup of Nations qualification,4,6,1,3,0,4,-2,0
Niger,2017,African Cup of Nations qualification,0,0,0,0,1,1,0,0
Niger,2017,Friendly,2,2,1,1,0,2,0,0
Niger,2018,African Cup of Nations qualification,3,10,1,3,0,4,-7,0
Niger,2018,Friendly,5,4,1,0,1,2,1,0
Niger,2019,African Cup of Nations qualification,3,8,0,2,1,3,-5,0
Niger,2019,Friendly,1,6,0,3,1,4,-5,0
Niger,2020,African Cup of Nations qualification,1,3,1,1,0,2,-2,0
Niger,2020,Friendly,3,0,2,0,0,2,3,0
Niger,2021,African Cup of Nations qualification,0,3,0,1,1,2,-3,0
Niger,2021,FIFA World Cup qualification,13,17,2,3,1,6,-4,0
Niger,2021,Friendly,3,9,1,4,0,5,-6,0
Niger,2022,African Cup of Nations qualification,2,2,0,0,2,2,0,0
Niger,2022,Friendly,5,12,0,4,2,6,-7,0
Niger,2023,African Cup of Nations qualification,1,6,0,4,0,4,-5,0
Niger,2023,FIFA World Cup qualification,2,2,1,1,0,2,0,0
Niger,2023,Friendly,4,1,1,0,1,2,3,0
Niger,2024,African Cup of Nations qualification,1,5,0,3,1,4,-4,0
Niger,2024,Friendly,1,3,0,2,0,2,-2,0
Niger,2025,FIFA World Cup qualification,1,2,0,1,0,1,-1,0
Niger,2025,Friendly,6,0,1,0,0,1,6,0
Nigeria,1949,Friendly,2,0,1,0,0,1,2,0
Nigeria,1950,Friendly,0,1,0,1,0,1,-1,0
Nigeria,1951,Friendly,5,0,1,0,0,1,5,0
Nigeria,1953,Friendly,0,1,0,1,0,1,-1,0
Nigeria,1954,Friendly,3,0,1,0,0,1,3,0
Nigeria,1955,Friendly,0,8,0,2,0,2,-8,0
Nigeria,1956,Friendly,4,1,1,0,1,2,3,0
Nigeria,1957,Friendly,3,3,0,0,1,1,0,0
Nigeria,1958,Friendly,3,2,1,0,0,1,1,0
Nigeria,1959,Friendly,13,6,2,1,0,3,7,0
Nigeria,1960,FIFA World Cup qualification,3,6,0,1,1,2,-3,0
Nigeria,1960,Friendly,10,12,1,3,3,7,-2,0
Nigeria,1961,African Cup of Nations qualification,4,3,1,0,2,3,1,1
Nigeria,1961,Friendly,5,9,1,2,0,3,-4,0
Nigeria,1962,Friendly,3,1,1,0,1,2,2,0
Nigeria,1963,African Cup of Nations,3,10,0,2,0,2,-7,0
Nigeria,1963,African Cup of Nations qualification,2,2,0,0,1,1,0,0
Nigeria,1963,African Friendship Games,2,5,1,1,0,2,-3,0
Nigeria,1963,Friendly,16,5,4,0,2,6,11,0
Nigeria,1965,Friendly,6,11,1,3,1,5,-5,0
Nigeria,1966,Friendly,8,7,2,1,2,5,1,0
Nigeria,1967,African Cup of Nations qualification,4,4,1,1,1,3,0,0
Nigeria,1967,Friendly,7,10,0,2,4,6,-3,0
Nigeria,1968,FIFA World Cup qualification,4,3,1,0,1,2,1,0
Nigeria,1968,Friendly,13,4,3,0,0,3,9,0
Nigeria,1969,FIFA World Cup qualification,11,9,2,1,3,6,2,0
Nigeria,1969,Friendly,0,5,0,1,0,1,-5,0
Nigeria,1970,African Cup of Nations qualification,1,2,0,1,1,2,-1,0
Nigeria,1971,Friendly,6,3,3,1,0,4,3,0
Nigeria,1972,FIFA World Cup qualification,3,2,1,0,1,2,1,0
Nigeria,1972,Friendly,33,12,10,1,3,14,21,0
Nigeria,1973,African Cup of Nations qualification,7,9,2,1,1,4,-2,0
Nigeria,1973,All-African Games,14,7,4,0,1,5,7,1
Nigeria,1973,FIFA World Cup qualification,2,3,0,1,1,2,-1,0
Nigeria,1974,Friendly,3,2,1,1,1,3,1,0
Nigeria,1975,African Cup of Nations qualification,3,1,2,0,0,2,2,0
Nigeria,1975,Friendly,9,11,5,3,2,10,-2,0
Nigeria,1976,African Cup of Nations,11,10,3,2,1,6,1,0
Nigeria,1976,FIFA World Cup qualification,6,2,1,0,1,2,4,0
Nigeria,1976,Friendly,4,2,1,0,2,3,2,0
Nigeria,1977,African Cup of Nations qualification,7,4,2,1,1,4,3,0
Nigeria,1977,FIFA World Cup qualification,11,6,2,2,2,6,5,0
Nigeria,1977,Friendly,9,1,2,0,0,2,8,0
Nigeria,1978,African Cup of Nations,6,5,1,1,2,4,1,0
Nigeria,1978,All-African Games,6,4,2,1,2,5,2,0
Nigeria,1978,Friendly,1,0,1,0,0,1,1,0
Nigeria,1979,Friendly,10,3,2,0,3,5,7,0
Nigeria,1980,African Cup of Nations,8,1,4,0,1,5,7,1
Nigeria,1980,FIFA World Cup qualification,5,3,2,1,1,4,2,0
Nigeria,1980,Friendly,2,0,2,0,1,3,2,0
Nigeria,1981,FIFA World Cup qualification,3,5,1,2,1,4,-2,0
Nigeria,1981,Friendly,9,9,3,3,2,8,0,0
Nigeria,1982,African Cup of Nations,4,5,1,2,0,3,-1,0
Nigeria,1983,African Cup of Nations qualification,2,1,1,1,2,4,1,0
Nigeria,1983,Friendly,6,7,3,2,4,9,-1,0
Nigeria,1983,Korea Cup,2,2,1,1,1,3,0,0
Nigeria,1984,African Cup of Nations,7,8,1,1,3,5,-1,0
Nigeria,1984,FIFA World Cup qualification,4,0,2,0,0,2,4,0
Nigeria,1984,Friendly,0,5,0,1,0,1,-5,0
Nigeria,1985,African Cup of Nations qualification,0,1,0,1,1,2,-1,0
Nigeria,1985,FIFA World Cup qualification,7,3,3,1,0,4,4,0
Nigeria,1985,Friendly,4,2,1,0,3,4,2,0
Nigeria,1986,Friendly,2,4,0,1,1,2,-2,0
Nigeria,1987,African Cup of Nations qualification,6,3,2,1,1,4,3,0
Nigeria,1987,Friendly,0,0,0,0,1,1,0,0
Nigeria,1987,Nehru Cup,1,0,1,0,0,1,1,1
Nigeria,1988,African Cup of Nations,5,3,1,1,3,5,2,0
Nigeria,1989,African Cup of Nations qualification,8,2,2,0,2,4,6,0
Nigeria,1989,FIFA World Cup qualification,7,5,3,2,1,6,2,0
Nigeria,1990,African Cup of Nations,5,6,3,2,0,5,-1,0
Nigeria,1990,African Cup of Nations qualification,4,1,2,1,0,3,3,0
Nigeria,1990,Friendly,3,1,1,0,1,2,2,0
Nigeria,1991,African Cup of Nations qualification,11,2,2,0,3,5,9,0
Nigeria,1991,Friendly,14,6,4,3,0,7,8,0
Nigeria,1992,African Cup of Nations,8,5,4,1,0,5,3,0
Nigeria,1992,African Cup of Nations qualification,2,0,1,0,1,2,2,0
Nigeria,1992,FIFA World Cup qualification,5,0,2,0,0,2,5,0
Nigeria,1992,Friendly,1,1,0,0,1,1,0,0
Nigeria,1993,African Cup of Nations qualification,10,1,2,1,1,4,9,0
Nigeria,1993,FIFA World Cup qualification,12,5,3,1,2,6,7,0
Nigeria,1994,African Cup of Nations,9,3,3,0,2,5,6,1
Nigeria,1994,FIFA World Cup,7,4,2,2,0,4,3,0
Nigeria,1994,Friendly,9,8,2,3,2,7,1,0
Nigeria,1995,Confederations Cup,4,1,1,0,2,3,3,0
Nigeria,1995,Friendly,4,2,2,0,0,2,2,0
Nigeria,1995,USA Cup,3,6,0,3,0,3,-3,0
Nigeria,1996,FIFA World Cup qualification,2,0,1,0,0,1,2,0
Nigeria,1996,Friendly,1,3,0,1,0,1,-2,0
Nigeria,1996,King Hassan II Tournament,1,4,0,2,0,2,-3,0
Nigeria,1997,FIFA World Cup qualification,8,4,3,1,1,5,4,0
Nigeria,1997,Friendly,1,2,1,1,1,3,-1,0
Nigeria,1998,FIFA World Cup,6,9,2,2,0,4,-3,0
Nigeria,1998,Friendly,3,16,0,4,1,5,-13,0
Nigeria,1998,Lunar New Year Cup,1,0,1,0,0,1,1,0
Nigeria,1999,Friendly,4,7,2,2,1,5,-3,0
Nigeria,2000,African Cup of Nations,12,5,4,0,2,6,7,0
Nigeria,2000,African Cup of Nations qualification,4,0,1,0,1,2,4,0
Nigeria,2000,FIFA World Cup qualification,7,2,2,1,1,4,5,0
Nigeria,2000,Friendly,7,3,2,0,0,2,4,0
Nigeria,2001,African Cup of Nations qualification,5,1,3,0,1,4,4,0
Nigeria,2001,FIFA World Cup qualification,12,1,4,1,1,6,11,0
Nigeria,2001,Friendly,5,6,0,1,2,3,-1,0
Nigeria,2002,African Cup of Nations,5,2,4,1,1,6,3,0
Nigeria,2002,African Cup of Nations qualification,0,0,0,0,1,1,0,0
Nigeria,2002,FIFA World Cup,1,3,0,2,1,3,-2,0
Nigeria,2002,Friendly,14,7,5,0,5,10,7,0
Nigeria,2003,African Cup of Nations qualification,7,3,2,0,1,3,4,0
Nigeria,2003,Friendly,7,10,3,3,0,6,-3,0
Nigeria,2004,African Cup of Nations,11,5,4,1,1,6,6,0
Nigeria,2004,FIFA World Cup qualification,7,2,3,1,1,5,5,0
Nigeria,2004,Friendly,8,4,2,1,1,4,4,0
Nigeria,2005,FIFA World Cup qualification,14,5,3,0,2,5,9,0
Nigeria,2005,Friendly,1,3,1,1,0,2,-2,0
Nigeria,2006,African Cup of Nations,7,3,4,1,1,6,4,0
Nigeria,2006,African Cup of Nations qualification,3,0,2,0,0,2,3,0
Nigeria,2007,African Cup of Nations qualification,7,3,3,1,0,4,4,0
Nigeria,2007,Friendly,5,7,2,2,2,6,-2,0
Nigeria,2008,African Cup of Nations,3,3,1,2,1,4,0,0
Nigeria,2008,FIFA World Cup qualification,11,1,6,0,0,6,10,0
Nigeria,2008,Friendly,3,2,1,1,1,3,1,0
Nigeria,2009,FIFA World Cup qualification,9,4,3,0,3,6,5,0
Nigeria,2009,Friendly,2,1,1,0,2,3,1,0
Nigeria,2010,African Cup of Nations,6,4,3,2,1,6,2,0
Nigeria,2010,African Cup of Nations qualification,2,1,1,1,0,2,1,0
Nigeria,2010,FIFA World Cup,3,5,0,2,1,3,-2,0
Nigeria,2010,Friendly,10,6,2,1,2,5,4,0
Nigeria,2011,African Cup of Nations qualification,10,4,2,0,2,4,6,0
Nigeria,2011,Friendly,12,5,4,1,2,7,7,0
Nigeria,2012,African Cup of Nations qualification,10,3,2,0,2,4,7,0
Nigeria,2012,FIFA World Cup qualification,2,1,1,0,1,2,1,0
Nigeria,2012,Friendly,7,5,2,2,2,6,2,0
Nigeria,2013,African Cup of Nations,11,4,4,0,2,6,7,1
Nigeria,2013,Confederations Cup,7,6,1,2,0,3,1,0
Nigeria,2013,FIFA World Cup qualification,9,3,4,0,2,6,6,0
Nigeria,2013,Friendly,11,7,2,1,4,7,4,0
Nigeria,2014,African Cup of Nations qualification,9,7,2,2,2,6,2,0
Nigeria,2014,FIFA World Cup,3,5,1,2,1,4,-2,0
Nigeria,2014,Friendly,5,5,1,1,2,4,0,0
Nigeria,2015,African Cup of Nations qualification,0,0,0,0,1,1,0,0
Nigeria,2015,FIFA World Cup qualification,2,0,1,0,1,2,2,0
Nigeria,2015,Friendly,8,5,3,3,1,7,3,0
Nigeria,2016,African Cup of Nations qualification,2,2,1,1,1,3,0,0
Nigeria,2016,FIFA World Cup qualification,5,2,2,0,0,2,3,0
Nigeria,2016,Friendly,4,1,2,0,0,2,3,0
Nigeria,2017,African Cup of Nations qualification,0,2,0,1,0,1,-2,0
Nigeria,2017,FIFA World Cup qualification,6,4,2,1,1,4,2,0
Nigeria,2017,Friendly,9,4,2,0,2,4,5,0
Nigeria,2018,African Cup of Nations qualification,11,3,3,0,1,4,8,0
Nigeria,2018,FIFA World Cup,3,4,1,2,0,3,-1,0
Nigeria,2018,Friendly,5,7,2,3,2,7,-2,0
Nigeria,2019,African Cup of Nations,9,7,5,2,0,7,2,0
Nigeria,2019,African Cup of Nations qualification,9,4,3,0,0,3,5,0
Nigeria,2019,Friendly,4,4,1,1,3,5,0,0
Nigeria,2020,African Cup of Nations qualification,4,4,0,0,2,2,0,0
Nigeria,2020,Friendly,1,2,0,1,1,2,-1,0
Nigeria,2021,African Cup of Nations qualification,4,0,2,0,0,2,4,0
Nigeria,2021,FIFA World Cup qualification,9,3,4,1,1,6,6,0
Nigeria,2021,Friendly,0,5,0,2,1,3,-5,0
Nigeria,2022,African Cup of Nations,6,2,3,1,0,4,4,0
Nigeria,2022,African Cup of Nations qualification,12,1,2,0,0,2,11,1
Nigeria,2022,FIFA World Cup qualification,1,1,0,0,2,2,0,0
Nigeria,2022,Friendly,2,11,0,5,0,5,-9,0
Nigeria,2023,African Cup of Nations qualification,10,3,3,1,0,4,7,0
Nigeria,2023,FIFA World Cup qualification,2,2,0,0,2,2,0,0
Nigeria,2023,Friendly,5,4,1,0,1,2,1,0
Nigeria,2024,African Cup of Nations,8,4,4,1,2,7,4,0
Nigeria,2024,African Cup of Nations qualification,4,0,2,0,1,3,4,0
Nigeria,2024,FIFA World Cup qualification,2,3,0,1,1,2,-1,0
Nigeria,2024,Friendly,2,3,1,1,0,2,-1,0
Nigeria,2025,FIFA World Cup qualification,3,1,1,0,1,2,2,0
Niue,1983,South Pacific Games,0,33,0,2,0,2,-33,0
North Korea,1956,Friendly,4,0,2,0,0,2,4,0
North Korea,1959,Friendly,6,0,2,0,0,2,6,0
North Korea,1960,Friendly,13,3,2,1,0,3,10,0
North Korea,1963,Friendly,22,2,3,0,1,4,20,0
North Korea,1965,FIFA World Cup qualification,9,2,2,0,0,2,7,0
North Korea,1965,Friendly,14,0,5,0,0,5,14,0
North Korea,1966,FIFA World Cup,5,9,1,2,1,4,-4,0
North Korea,1966,GaNEFo,26,3,5,0,0,5,23,0
North Korea,1969,Friendly,3,1,1,0,0,1,2,0
North Korea,1973,FIFA World Cup qualification,5,5,1,2,3,6,0,0
North Korea,1973,Friendly,0,3,0,1,0,1,-3,0
North Korea,1974,Asian Games,11,8,3,3,1,7,3,0
North Korea,1974,Friendly,1,6,0,1,0,1,-5,0
North Korea,1975,AFC Asian Cup qualification,7,4,3,1,1,5,3,1
North Korea,1976,Friendly,0,3,0,1,0,1,-3,0
North Korea,1978,Asian Games,12,3,4,0,2,6,9,0
North Korea,1978,Friendly,0,1,0,1,0,1,-1,0
North Korea,1979,AFC Asian Cup qualification,9,2,4,0,1,5,7,1
North Korea,1979,Friendly,0,0,0,0,1,1,0,0
North Korea,1980,AFC Asian Cup,10,12,3,3,0,6,-2,0
North Korea,1980,FIFA World Cup qualification,7,2,3,0,1,4,5,0
North Korea,1981,FIFA World Cup qualification,2,4,0,1,0,1,-2,0
North Korea,1982,Asian Games,9,8,2,2,2,6,1,0
North Korea,1982,Friendly,0,2,0,1,0,1,-2,0
North Korea,1985,FIFA World Cup qualification,3,2,1,1,2,4,1,0
North Korea,1985,Friendly,16,2,3,1,1,5,14,0
North Korea,1986,Friendly,2,5,0,1,1,2,-3,0
North Korea,1986,Merlion Cup,5,2,2,1,2,5,3,0
North Korea,1987,King's Cup,1,0,1,0,0,1,1,1
North Korea,1988,AFC Asian Cup qualification,3,2,2,1,1,4,1,0
North Korea,1988,Friendly,0,0,0,0,1,1,0,0
North Korea,1989,FIFA World Cup qualification,13,9,5,4,2,11,4,0
North Korea,1989,King's Cup,1,3,0,1,0,1,-2,0
North Korea,1989,Nehru Cup,2,1,1,0,0,1,1,1
North Korea,1990,Asian Games,2,2,1,1,3,5,0,0
North Korea,1990,Dynasty Cup,1,3,1,2,0,3,-2,0
North Korea,1990,Friendly,2,2,1,1,0,2,0,0
North Korea,1991,Friendly,2,1,1,0,0,1,1,0
North Korea,1992,AFC Asian Cup,2,5,0,2,1,3,-3,0
North Korea,1992,AFC Asian Cup qualification,8,0,2,0,1,3,8,0
North Korea,1992,Dynasty Cup,4,7,0,1,3,4,-3,0
North Korea,1993,East Asian Games,14,1,2,0,1,3,13,0
North Korea,1993,FIFA World Cup qualification,24,18,8,4,1,13,6,0
North Korea,1993,Nehru Cup,5,3,2,0,0,2,2,1
North Korea,1998,Asian Games,6,8,1,1,2,4,-2,0
North Korea,1998,Friendly,0,4,0,1,0,1,-4,0
North Korea,1999,King's Cup,2,2,0,0,1,1,0,0
North Korea,2000,AFC Asian Cup qualification,8,7,1,1,2,4,1,0
North Korea,2000,Friendly,1,6,0,2,1,3,-5,0
North Korea,2001,Friendly,5,6,1,3,2,6,-1,0
North Korea,2002,Friendly,1,2,0,1,1,2,-1,0
North Korea,2002,King's Cup,6,3,2,0,2,4,3,0
North Korea,2003,AFC Asian Cup qualification,5,12,1,4,2,7,-7,0
North Korea,2003,King's Cup,5,9,0,1,3,4,-4,0
North Korea,2004,FIFA World Cup qualification,11,5,3,1,2,6,6,0
North Korea,2005,EAFF Championship,30,2,4,1,1,6,28,0
North Korea,2005,FIFA World Cup qualification,5,11,1,5,0,6,-6,0
North Korea,2005,Friendly,0,3,0,1,1,2,-3,0
North Korea,2005,King's Cup,4,3,1,1,1,3,1,0
North Korea,2006,Friendly,0,0,0,0,1,1,0,0
North Korea,2007,EAFF Championship,15,1,3,0,0,3,14,1
North Korea,2007,FIFA World Cup qualification,9,2,2,0,0,2,7,0
North Korea,2007,Friendly,3,4,0,1,2,3,-1,0
North Korea,2007,King's Cup,2,3,0,1,1,2,-1,0
North Korea,2008,AFC Challenge Cup,9,1,4,1,0,5,8,0
North Korea,2008,EAFF Championship,3,5,0,1,2,3,-2,0
North Korea,2008,FIFA World Cup qualification,8,4,4,1,4,9,4,0
North Korea,2008,Friendly,1,2,0,1,1,2,-1,0
North Korea,2008,VFF Cup,0,1,0,1,1,2,-1,0
North Korea,2009,EAFF Championship,9,2,1,0,1,2,7,0
North Korea,2009,East Asian Games,8,0,1,0,0,1,8,1
North Korea,2009,FIFA World Cup qualification,3,1,2,1,2,5,2,0
North Korea,2009,Friendly,3,4,2,1,1,4,-1,0
North Korea,2009,King's Cup,0,1,0,1,0,1,-1,0
North Korea,2010,AFC Challenge Cup,11,2,2,0,2,4,9,0
North Korea,2010,FIFA World Cup,1,12,0,3,0,3,-11,0
North Korea,2010,Friendly,10,16,1,6,5,12,-6,1
North Korea,2010,VFF Cup,4,1,2,0,0,2,3,1
North Korea,2011,AFC Asian Cup,0,2,0,2,1,3,-2,0
North Korea,2011,AFC Challenge Cup qualification,7,0,3,0,0,3,7,1
North Korea,2011,FIFA World Cup qualification,2,3,2,3,0,5,-1,0
North Korea,2011,Friendly,4,3,2,1,2,5,1,0
North Korea,2012,AFC Challenge Cup,12,1,5,0,0,5,11,1
North Korea,2012,EAFF Championship,10,1,2,0,1,3,9,0
North Korea,2012,FIFA World Cup qualification,1,1,0,0,1,1,0,0
North Korea,2012,Friendly,3,1,1,0,1,2,2,0
North Korea,2013,Friendly,2,2,1,1,1,3,0,0
North Korea,2013,King's Cup,3,3,0,0,2,2,0,0
North Korea,2014,EAFF Championship,7,2,2,0,0,2,5,0
North Korea,2014,Friendly,3,8,0,3,1,4,-5,0
North Korea,2015,AFC Asian Cup,2,7,0,3,0,3,-5,0
North Korea,2015,EAFF Championship,2,3,1,1,1,3,-1,0
North Korea,2015,FIFA World Cup qualification,12,5,5,1,1,7,7,0
North Korea,2015,Friendly,2,1,1,0,1,2,1,0
North Korea,2016,EAFF Championship,5,0,3,0,0,3,5,1
North Korea,2016,FIFA World Cup qualification,2,3,0,1,0,1,-1,0
North Korea,2016,Friendly,8,7,2,1,1,4,1,0
North Korea,2017,AFC Asian Cup qualification,11,10,2,1,2,5,1,0
North Korea,2017,EAFF Championship,1,3,0,2,1,3,-2,0
North Korea,2017,Friendly,2,2,0,0,1,1,0,0
North Korea,2017,King's Cup,3,6,0,1,1,2,-3,0
North Korea,2018,AFC Asian Cup qualification,2,0,1,0,0,1,2,0
North Korea,2018,EAFF Championship,6,1,2,0,1,3,5,0
North Korea,2018,Friendly,1,7,0,2,1,3,-6,0
North Korea,2019,AFC Asian Cup,1,14,0,3,0,3,-13,0
North Korea,2019,FIFA World Cup qualification,4,3,2,1,2,5,1,0
North Korea,2019,Friendly,0,4,0,1,0,1,-4,0
North Korea,2019,Intercontinental Cup,9,7,3,1,0,4,2,1
North Korea,2023,FIFA World Cup qualification,6,2,1,1,0,2,4,0
North Korea,2024,FIFA World Cup qualification,10,11,2,5,2,9,-1,0
North Korea,2024,Friendly,1,2,0,1,1,2,-1,0
North Korea,2025,FIFA World Cup qualification,2,7,0,2,0,2,-5,0
North Korea,2025,Friendly,1,1,0,0,1,1,0,0
North Macedonia,1993,Friendly,4,1,1,0,0,1,3,0
North Macedonia,1994,Friendly,9,3,3,1,0,4,6,0
North Macedonia,1994,UEFA Euro qualification,5,4,1,1,2,4,1,0
North Macedonia,1995,Friendly,1,2,0,1,1,2,-1,0
North Macedonia,1995,UEFA Euro qualification,4,14,0,4,2,6,-10,0
North Macedonia,1996,FIFA World Cup qualification,15,8,2,2,1,5,7,0
North Macedonia,1996,Friendly,3,3,2,1,0,3,0,0
North Macedonia,1997,FIFA World Cup qualification,7,10,2,3,0,5,-3,0
North Macedonia,1997,Friendly,0,1,0,1,0,1,-1,0
North Macedonia,1998,Friendly,8,7,2,1,5,8,1,0
North Macedonia,1998,UEFA Euro qualification,8,4,2,1,0,3,4,0
North Macedonia,1999,Friendly,0,2,0,1,0,1,-2,0
North Macedonia,1999,UEFA Euro qualification,5,10,0,3,2,5,-5,0
North Macedonia,2000,FIFA World Cup qualification,3,2,1,1,1,3,1,0
North Macedonia,2000,Friendly,6,10,2,5,0,7,-4,0
North Macedonia,2001,FIFA World Cup qualification,8,16,0,4,3,7,-8,0
North Macedonia,2001,Friendly,2,11,0,4,2,6,-9,0
North Macedonia,2002,Friendly,13,8,2,1,2,5,5,0
North Macedonia,2002,Prime Minister's Cup,1,4,0,1,2,3,-3,0
North Macedonia,2002,UEFA Euro qualification,4,5,0,1,2,3,-1,0
North Macedonia,2003,Friendly,5,7,1,2,2,5,-2,0
North Macedonia,2003,UEFA Euro qualification,7,9,1,3,1,5,-2,0
North Macedonia,2004,FIFA World Cup qualification,6,7,1,3,1,5,-1,0
North Macedonia,2004,Friendly,6,4,3,2,1,6,2,0
North Macedonia,2005,FIFA World Cup qualification,5,17,1,4,2,7,-12,0
North Macedonia,2005,Friendly,2,1,1,0,0,1,1,0
North Macedonia,2006,Friendly,3,2,2,1,0,3,1,0
North Macedonia,2006,UEFA Euro qualification,4,3,2,2,1,5,1,0
North Macedonia,2007,Friendly,1,0,1,0,1,2,1,0
North Macedonia,2007,UEFA Euro qualification,8,9,2,4,1,7,-1,0
North Macedonia,2008,FIFA World Cup qualification,2,3,1,2,0,3,-1,0
North Macedonia,2008,Friendly,9,7,1,1,3,5,2,0
North Macedonia,2009,FIFA World Cup qualification,3,8,1,3,1,5,-5,0
North Macedonia,2009,Friendly,9,6,2,1,2,5,3,0
North Macedonia,2010,Friendly,7,4,3,1,2,6,3,0
North Macedonia,2010,UEFA Euro qualification,4,4,1,2,1,4,0,0
North Macedonia,2011,Friendly,1,1,1,1,1,3,0,0
North Macedonia,2011,UEFA Euro qualification,4,10,1,4,1,6,-6,0
North Macedonia,2012,FIFA World Cup qualification,3,4,1,2,1,4,-1,0
North Macedonia,2012,Friendly,6,8,2,2,2,6,-2,0
North Macedonia,2013,FIFA World Cup qualification,4,12,1,5,0,6,-8,0
North Macedonia,2013,Friendly,5,3,2,2,0,4,2,0
North Macedonia,2014,Friendly,2,5,1,2,2,5,-3,0
North Macedonia,2014,UEFA Euro qualification,4,10,1,3,0,4,-6,0
North Macedonia,2015,Friendly,4,2,1,1,1,3,2,0
North Macedonia,2015,UEFA Euro qualification,2,8,0,5,1,6,-6,0
North Macedonia,2016,FIFA World Cup qualification,4,11,0,4,0,4,-7,0
North Macedonia,2016,Friendly,4,7,1,3,0,4,-3,0
North Macedonia,2017,FIFA World Cup qualification,11,4,3,1,2,6,7,0
North Macedonia,2017,Friendly,5,0,2,0,1,3,5,0
North Macedonia,2018,Friendly,1,1,0,0,2,2,0,0
North Macedonia,2018,UEFA Nations League,14,5,5,1,0,6,9,0
North Macedonia,2019,UEFA Euro qualification,12,13,4,4,2,10,-1,0
North Macedonia,2020,UEFA Euro qualification,3,1,2,0,0,2,2,0
North Macedonia,2020,UEFA Nations League,9,8,2,1,3,6,1,0
North Macedonia,2021,FIFA World Cup qualification,23,11,5,2,3,10,12,0
North Macedonia,2021,Friendly,5,1,1,0,1,2,4,0
North Macedonia,2021,UEFA Euro,2,8,0,3,0,3,-6,0
North Macedonia,2022,FIFA World Cup qualification,1,2,1,1,0,2,-1,0
North Macedonia,2022,Friendly,2,5,0,2,1,3,-3,0
North Macedonia,2022,UEFA Nations League,7,7,2,3,1,6,0,0
North Macedonia,2023,Friendly,4,1,2,0,0,2,3,0
North Macedonia,2023,UEFA Euro qualification,10,20,2,4,2,8,-10,0
North Macedonia,2024,Friendly,2,7,0,3,1,4,-5,0
North Macedonia,2024,UEFA Nations League,10,1,5,0,1,6,9,0
North Macedonia,2025,FIFA World Cup qualification,4,1,1,0,1,2,3,0
North Vietnam,1956,Friendly,3,8,0,2,0,2,-5,0
North Vietnam,1959,Friendly,0,7,0,2,0,2,-7,0
North Vietnam,1960,Friendly,7,8,1,2,0,3,-1,0
North Vietnam,1963,Friendly,14,13,2,4,0,6,1,0
North Vietnam,1965,Friendly,7,8,1,2,2,5,-1,0
North Vietnam,1966,GaNEFo,16,7,2,2,1,5,9,0
North Vietnam,1970,Friendly,2,1,1,0,0,1,1,0
Northern Cyprus,1977,Friendly,0,1,0,1,0,1,-1,0
Northern Cyprus,1980,Friendly,0,7,0,2,0,2,-7,0
Northern Cyprus,2006,ELF Cup,28,2,5,0,0,5,26,1
Northern Cyprus,2006,FIFI Wild Cup,6,1,3,0,1,4,5,0
Northern Cyprus,2006,Friendly,3,2,1,0,0,1,1,0
Northern Cyprus,2007,Friendly,1,2,0,1,0,1,-1,0
Northern Cyprus,2012,Viva World Cup,19,4,2,2,0,4,15,0
Northern Cyprus,2016,CONIFA World Football Cup,12,4,3,1,1,5,8,1
Northern Cyprus,2017,CONIFA European Football Cup,12,2,3,0,2,5,10,0
Northern Cyprus,2018,CONIFA World Football Cup,17,6,3,0,3,6,11,0
Northern Ireland,1882,Friendly,1,20,0,2,0,2,-19,0
Northern Ireland,1883,Friendly,1,8,0,1,1,2,-7,0
Northern Ireland,1884,British Home Championship,1,19,0,3,0,3,-18,0
Northern Ireland,1885,British Home Championship,4,20,0,3,0,3,-16,0
Northern Ireland,1886,British Home Championship,3,18,0,3,0,3,-15,0
Northern Ireland,1887,British Home Championship,5,12,1,2,0,3,-7,0
Northern Ireland,1888,British Home Championship,3,26,0,3,0,3,-23,0
Northern Ireland,1889,British Home Championship,2,16,0,3,0,3,-14,0
Northern Ireland,1890,British Home Championship,4,18,0,3,0,3,-14,0
Northern Ireland,1891,British Home Championship,9,10,1,2,0,3,-1,0
Northern Ireland,1892,British Home Championship,3,6,0,2,1,3,-3,0
Northern Ireland,1893,British Home Championship,2,12,0,2,0,2,-10,0
Northern Ireland,1894,British Home Championship,4,8,0,2,1,3,-4,0
Northern Ireland,1895,British Home Championship,3,14,0,2,1,3,-11,0
Northern Ireland,1896,British Home Championship,4,11,0,2,1,3,-7,0
Northern Ireland,1897,British Home Championship,5,14,1,2,0,3,-9,0
Northern Ireland,1898,British Home Championship,3,6,1,2,0,3,-3,0
Northern Ireland,1899,British Home Championship,4,22,1,2,0,3,-18,0
Northern Ireland,1900,British Home Championship,0,7,0,3,0,3,-7,0
Northern Ireland,1901,British Home Championship,0,15,0,3,0,3,-15,0
Northern Ireland,1902,British Home Championship,4,6,1,2,0,3,-2,0
Northern Ireland,1903,British Home Championship,4,4,2,1,0,3,0,0
Northern Ireland,1904,British Home Championship,3,4,1,1,1,3,-1,0
Northern Ireland,1905,British Home Championship,3,7,0,1,2,3,-4,0
Northern Ireland,1906,British Home Championship,4,10,0,2,1,3,-6,0
Northern Ireland,1907,British Home Championship,2,7,0,3,0,3,-5,0
Northern Ireland,1908,British Home Championship,2,8,1,2,0,3,-6,1
Northern Ireland,1909,British Home Championship,2,12,0,3,0,3,-10,0
Northern Ireland,1910,British Home Championship,3,5,1,1,1,3,-2,0
Northern Ireland,1911,British Home Championship,2,6,0,3,0,3,-4,0
Northern Ireland,1912,British Home Championship,5,12,1,2,0,3,-7,1
Northern Ireland,1913,British Home Championship,3,4,1,2,0,3,-1,0
Northern Ireland,1914,British Home Championship,6,2,2,0,1,3,4,0
Northern Ireland,1919,British Home Championship,1,1,0,0,1,1,0,0
Northern Ireland,1920,British Home Championship,2,7,0,2,1,3,-5,0
Northern Ireland,1921,British Home Championship,2,5,0,2,1,3,-3,0
Northern Ireland,1922,British Home Championship,1,4,0,2,0,2,-3,0
Northern Ireland,1922,Friendly,1,2,0,1,0,1,-1,0
Northern Ireland,1923,British Home Championship,5,2,2,1,0,3,3,1
Northern Ireland,1924,British Home Championship,1,6,0,3,0,3,-5,0
Northern Ireland,1924,Friendly,1,2,0,1,0,1,-1,0
Northern Ireland,1925,British Home Championship,0,3,0,1,2,3,-3,0
Northern Ireland,1926,British Home Championship,6,7,1,1,1,3,-1,0
Northern Ireland,1927,British Home Championship,4,4,1,1,1,3,0,0
Northern Ireland,1928,British Home Championship,3,4,1,2,0,3,-1,0
Northern Ireland,1928,Friendly,0,4,0,1,0,1,-4,0
Northern Ireland,1929,British Home Championship,5,12,0,2,1,3,-7,0
Northern Ireland,1930,British Home Championship,9,8,1,2,0,3,1,0
Northern Ireland,1931,British Home Championship,9,12,1,3,1,5,-3,1
Northern Ireland,1932,British Home Championship,1,9,0,3,0,3,-8,0
Northern Ireland,1933,British Home Championship,3,5,1,1,1,3,-2,0
Northern Ireland,1934,British Home Championship,2,1,1,0,0,1,1,0
Northern Ireland,1935,British Home Championship,4,10,0,4,0,4,-6,0
Northern Ireland,1936,British Home Championship,5,8,1,2,0,3,-3,0
Northern Ireland,1937,British Home Championship,3,10,0,2,1,3,-7,0
Northern Ireland,1938,British Home Championship,1,9,1,2,0,3,-8,0
Northern Ireland,1939,British Home Championship,1,3,0,1,0,1,-2,0
Northern Ireland,1945,Friendly,0,1,0,1,0,1,-1,0
Northern Ireland,1946,British Home Championship,2,7,0,1,1,2,-5,0
Northern Ireland,1947,British Home Championship,6,3,2,0,1,3,3,0
Northern Ireland,1948,British Home Championship,4,11,0,3,0,3,-7,0
Northern Ireland,1948,Friendly,5,0,1,0,0,1,5,0
Northern Ireland,1949,British Home Championship,0,2,0,1,0,1,-2,0
Northern Ireland,1949,FIFA World Cup qualification,4,17,0,2,0,2,-13,0
Northern Ireland,1950,British Home Championship,2,10,0,2,0,2,-8,0
Northern Ireland,1950,FIFA World Cup qualification,0,0,0,0,1,1,0,0
Northern Ireland,1951,British Home Championship,1,7,0,3,0,3,-6,0
Northern Ireland,1951,Friendly,2,2,0,0,1,1,0,0
Northern Ireland,1952,British Home Championship,3,6,0,1,2,3,-3,0
Northern Ireland,1952,Friendly,1,3,0,1,0,1,-2,0
Northern Ireland,1953,British Home Championship,4,9,0,3,0,3,-5,0
Northern Ireland,1954,British Home Championship,4,5,1,1,1,3,-1,0
Northern Ireland,1955,British Home Championship,4,7,1,2,0,3,-3,0
Northern Ireland,1956,British Home Championship,2,3,0,1,2,3,-1,0
Northern Ireland,1957,British Home Championship,4,3,1,0,2,3,1,0
Northern Ireland,1957,FIFA World Cup qualification,4,2,1,1,1,3,2,0
Northern Ireland,1957,Friendly,2,2,0,0,1,1,0,0
Northern Ireland,1958,British Home Championship,6,6,0,0,3,3,0,0
Northern Ireland,1958,FIFA World Cup,6,10,2,2,1,5,-4,0
Northern Ireland,1958,FIFA World Cup qualification,2,1,1,0,0,1,1,0
Northern Ireland,1958,Friendly,2,6,0,1,0,1,-4,0
Northern Ireland,1959,British Home Championship,5,7,1,2,0,3,-2,0
Northern Ireland,1960,British Home Championship,6,13,0,3,0,3,-7,0
Northern Ireland,1960,FIFA World Cup qualification,3,4,0,1,0,1,-1,0
Northern Ireland,1961,British Home Championship,3,12,0,2,1,3,-9,0
Northern Ireland,1961,FIFA World Cup qualification,4,4,1,2,0,3,0,0
Northern Ireland,1961,Friendly,2,3,0,1,0,1,-1,0
Northern Ireland,1962,British Home Championship,2,12,0,3,0,3,-10,0
Northern Ireland,1962,Friendly,0,4,0,1,0,1,-4,0
Northern Ireland,1962,UEFA Euro qualification,4,0,2,0,0,2,4,0
Northern Ireland,1963,British Home Championship,6,13,1,2,0,3,-7,0
Northern Ireland,1963,UEFA Euro qualification,1,2,0,1,1,2,-1,0
Northern Ireland,1964,British Home Championship,8,9,1,2,0,3,-1,0
Northern Ireland,1964,FIFA World Cup qualification,2,2,1,1,0,2,0,0
Northern Ireland,1964,Friendly,3,0,1,0,0,1,3,0
Northern Ireland,1965,British Home Championship,4,9,1,2,0,3,-5,0
Northern Ireland,1965,FIFA World Cup qualification,7,3,2,0,2,4,4,0
Northern Ireland,1966,British Home Championship,5,5,1,2,0,3,0,0
Northern Ireland,1966,Friendly,4,3,1,1,0,2,1,0
Northern Ireland,1967,British Home Championship,1,2,1,1,1,3,-1,0
Northern Ireland,1968,British Home Championship,0,2,0,1,0,1,-2,0
Northern Ireland,1968,FIFA World Cup qualification,7,1,2,0,0,2,6,0
Northern Ireland,1968,Friendly,3,2,1,0,0,1,1,0
Northern Ireland,1969,British Home Championship,2,4,0,1,2,3,-2,0
Northern Ireland,1969,FIFA World Cup qualification,0,2,0,1,1,2,-2,0
Northern Ireland,1970,British Home Championship,1,5,0,3,0,3,-4,0
Northern Ireland,1970,UEFA Euro qualification,0,3,0,1,0,1,-3,0
Northern Ireland,1971,British Home Championship,2,1,2,1,0,3,1,1
Northern Ireland,1971,UEFA Euro qualification,9,2,2,1,1,4,7,0
Northern Ireland,1972,British Home Championship,1,2,1,1,1,3,-1,0
Northern Ireland,1972,FIFA World Cup qualification,0,3,0,1,0,1,-3,0
Northern Ireland,1972,UEFA Euro qualification,1,1,0,0,1,1,0,0
Northern Ireland,1973,British Home Championship,4,3,2,1,0,3,1,0
Northern Ireland,1973,FIFA World Cup qualification,5,3,1,1,3,5,2,0
Northern Ireland,1974,British Home Championship,1,2,1,2,0,3,-1,0
Northern Ireland,1974,UEFA Euro qualification,3,2,1,1,0,2,1,0
Northern Ireland,1975,British Home Championship,1,3,1,1,1,3,-2,0
Northern Ireland,1975,UEFA Euro qualification,5,3,2,2,0,4,2,0
Northern Ireland,1976,British Home Championship,0,8,0,3,0,3,-8,0
Northern Ireland,1976,FIFA World Cup qualification,2,4,0,1,1,2,-2,0
Northern Ireland,1976,Friendly,1,1,0,0,1,1,0,0
Northern Ireland,1977,British Home Championship,2,6,0,2,1,3,-4,0
Northern Ireland,1977,FIFA World Cup qualification,5,2,2,2,0,4,3,0
Northern Ireland,1977,Friendly,0,5,0,1,0,1,-5,0
Northern Ireland,1978,British Home Championship,1,3,0,2,1,3,-2,0
Northern Ireland,1978,UEFA Euro qualification,4,1,2,0,1,3,3,0
Northern Ireland,1979,British Home Championship,1,4,0,2,1,3,-3,0
Northern Ireland,1979,UEFA Euro qualification,4,13,2,3,0,5,-9,0
Northern Ireland,1980,British Home Championship,3,1,2,0,1,3,2,0
Northern Ireland,1980,FIFA World Cup qualification,3,1,1,1,1,3,2,0
Northern Ireland,1980,Friendly,3,2,1,0,1,2,1,0
Northern Ireland,1981,British Home Championship,0,2,0,1,0,1,-2,0
Northern Ireland,1981,FIFA World Cup qualification,3,2,2,1,2,5,1,0
Northern Ireland,1982,British Home Championship,1,8,0,2,1,3,-7,0
Northern Ireland,1982,FIFA World Cup,5,7,1,1,3,5,-2,0
Northern Ireland,1982,Friendly,0,4,0,1,0,1,-4,0
Northern Ireland,1982,UEFA Euro qualification,1,2,1,1,1,3,-1,0
Northern Ireland,1983,British Home Championship,2,1,1,1,2,4,1,1
Northern Ireland,1983,UEFA Euro qualification,7,3,4,1,0,5,4,0
Northern Ireland,1984,British Home Championship,1,2,0,1,1,2,-1,0
Northern Ireland,1984,FIFA World Cup qualification,5,4,2,1,0,3,1,0
Northern Ireland,1984,Friendly,3,0,1,0,0,1,3,0
Northern Ireland,1985,FIFA World Cup qualification,3,1,2,1,2,5,2,0
Northern Ireland,1985,Friendly,0,0,0,0,1,1,0,0
Northern Ireland,1986,FIFA World Cup,2,6,0,2,1,3,-4,0
Northern Ireland,1986,Friendly,3,2,1,0,2,3,1,0
Northern Ireland,1986,UEFA Euro qualification,0,3,0,1,1,2,-3,0
Northern Ireland,1987,Friendly,1,1,0,0,1,1,0,0
Northern Ireland,1987,UEFA Euro qualification,2,7,1,3,0,4,-5,0
Northern Ireland,1988,FIFA World Cup qualification,3,5,1,2,1,4,-2,0
Northern Ireland,1988,Friendly,3,4,0,1,2,3,-1,0
Northern Ireland,1989,FIFA World Cup qualification,3,7,1,3,0,4,-4,0
Northern Ireland,1989,Friendly,0,1,0,1,0,1,-1,0
Northern Ireland,1990,Friendly,3,3,1,1,0,2,0,0
Northern Ireland,1990,UEFA Euro qualification,1,3,0,1,2,3,-2,0
Northern Ireland,1991,Friendly,3,1,1,0,0,1,2,0
Northern Ireland,1991,UEFA Euro qualification,10,8,2,2,1,5,2,0
Northern Ireland,1992,FIFA World Cup qualification,5,3,1,1,2,4,2,0
Northern Ireland,1992,Friendly,1,2,0,1,1,2,-1,0
Northern Ireland,1993,FIFA World Cup qualification,9,10,4,3,1,8,-1,0
Northern Ireland,1994,Friendly,2,5,1,2,0,3,-3,0
Northern Ireland,1994,UEFA Euro qualification,7,8,2,2,0,4,-1,0
Northern Ireland,1995,Friendly,1,4,0,2,0,2,-3,0
Northern Ireland,1995,UEFA Euro qualification,13,7,3,1,2,6,6,0
Northern Ireland,1996,FIFA World Cup qualification,4,3,1,1,2,4,1,0
Northern Ireland,1996,Friendly,2,5,0,2,1,3,-3,0
Northern Ireland,1997,FIFA World Cup qualification,2,7,0,4,2,6,-5,0
Northern Ireland,1997,Friendly,3,2,1,1,1,3,1,0
Northern Ireland,1998,Friendly,3,4,2,1,0,3,-1,0
Northern Ireland,1998,UEFA Euro qualification,3,5,1,1,1,3,-2,0
Northern Ireland,1999,Friendly,2,2,1,1,1,3,0,0
Northern Ireland,1999,UEFA Euro qualification,1,14,0,4,1,5,-13,0
Northern Ireland,2000,FIFA World Cup qualification,2,2,1,1,1,3,0,0
Northern Ireland,2000,Friendly,7,4,2,2,0,4,3,0
Northern Ireland,2001,FIFA World Cup qualification,9,10,2,4,1,7,-1,0
Northern Ireland,2001,Friendly,0,4,0,1,0,1,-4,0
Northern Ireland,2002,Friendly,1,9,0,2,2,4,-8,0
Northern Ireland,2002,UEFA Euro qualification,0,3,0,1,1,2,-3,0
Northern Ireland,2003,Friendly,0,3,0,2,0,2,-3,0
Northern Ireland,2003,UEFA Euro qualification,0,5,0,4,2,6,-5,0
Northern Ireland,2004,FIFA World Cup qualification,5,8,0,1,3,4,-3,0
Northern Ireland,2004,Friendly,9,6,3,1,3,7,3,0
Northern Ireland,2005,FIFA World Cup qualification,5,10,2,4,0,6,-5,0
Northern Ireland,2005,Friendly,3,7,0,2,2,4,-4,0
Northern Ireland,2006,Friendly,3,4,2,2,0,4,-1,0
Northern Ireland,2006,UEFA Euro qualification,4,5,2,1,1,4,-1,0
Northern Ireland,2007,Friendly,0,0,0,0,1,1,0,0
Northern Ireland,2007,UEFA Euro qualification,13,9,4,3,1,8,4,0
Northern Ireland,2008,FIFA World Cup qualification,5,4,1,2,1,4,1,0
Northern Ireland,2008,Friendly,4,4,1,2,1,4,0,0
Northern Ireland,2009,FIFA World Cup qualification,8,5,3,1,2,6,3,0
Northern Ireland,2009,Friendly,1,5,0,2,1,3,-4,0
Northern Ireland,2010,Friendly,1,7,0,4,1,5,-6,0
Northern Ireland,2010,UEFA Euro qualification,2,1,1,0,2,3,1,0
Northern Ireland,2011,Nations Cup,0,10,0,3,0,3,-10,0
Northern Ireland,2011,UEFA Euro qualification,7,12,1,5,1,7,-5,0
Northern Ireland,2012,FIFA World Cup qualification,3,5,0,1,3,4,-2,0
Northern Ireland,2012,Friendly,3,12,0,2,1,3,-9,0
Northern Ireland,2013,FIFA World Cup qualification,6,12,1,4,1,6,-6,0
Northern Ireland,2013,Friendly,0,1,0,1,1,2,-1,0
Northern Ireland,2014,Friendly,0,1,0,1,1,2,-1,0
Northern Ireland,2014,UEFA Euro qualification,6,3,3,1,0,4,3,0
Northern Ireland,2015,Friendly,2,2,1,1,1,3,0,0
Northern Ireland,2015,UEFA Euro qualification,10,5,3,0,3,6,5,0
Northern Ireland,2016,FIFA World Cup qualification,8,2,2,1,1,4,6,0
Northern Ireland,2016,Friendly,5,4,2,1,2,5,1,0
Northern Ireland,2016,UEFA Euro,2,3,1,3,0,4,-1,0
Northern Ireland,2017,FIFA World Cup qualification,9,5,4,3,1,8,4,0
Northern Ireland,2017,Friendly,1,0,1,0,0,1,1,0
Northern Ireland,2018,Friendly,5,4,2,1,2,5,1,0
Northern Ireland,2018,UEFA Nations League,2,7,0,4,0,4,-5,0
Northern Ireland,2019,Friendly,4,2,2,0,0,2,2,0
Northern Ireland,2019,UEFA Euro qualification,9,13,4,3,1,8,-4,0
Northern Ireland,2020,UEFA Euro qualification,2,3,0,1,1,2,-1,0
Northern Ireland,2020,UEFA Nations League,4,11,0,4,2,6,-7,0
Northern Ireland,2021,FIFA World Cup qualification,6,7,2,3,3,8,-1,0
Northern Ireland,2021,Friendly,5,3,2,2,0,4,2,0
Northern Ireland,2022,Friendly,3,2,1,1,0,2,1,0
Northern Ireland,2022,UEFA Nations League,7,10,1,3,2,6,-3,0
Northern Ireland,2023,UEFA Euro qualification,9,13,3,7,0,10,-4,0
Northern Ireland,2024,Friendly,5,6,2,1,1,4,-1,0
Northern Ireland,2024,UEFA Nations League,11,3,3,1,2,6,8,0
Northern Ireland,2025,Friendly,2,6,0,1,1,2,-4,0
Northern Mariana Islands,1998,Friendly,4,2,1,1,0,2,2,0
Northern Mariana Islands,1999,Friendly,0,7,0,1,0,1,-7,0
Northern Mariana Islands,2007,EAFF Championship,2,12,0,2,0,2,-10,0
Northern Mariana Islands,2008,Friendly,2,3,0,1,0,1,-1,0
Northern Mariana Islands,2009,EAFF Championship,3,12,0,3,0,3,-9,0
Northern Mariana Islands,2010,Friendly,1,1,0,0,1,1,0,0
Northern Mariana Islands,2012,EAFF Championship,2,8,0,2,0,2,-6,0
Northern Mariana Islands,2012,Friendly,0,8,0,1,0,1,-8,0
Northern Mariana Islands,2013,AFC Challenge Cup qualification,0,19,0,3,0,3,-19,0
Northern Mariana Islands,2014,EAFF Championship,2,10,1,2,0,3,-8,0
Northern Mariana Islands,2016,EAFF Championship,1,11,0,2,0,2,-10,0
Northern Mariana Islands,2018,EAFF Championship,1,14,0,2,1,3,-13,0
Northern Mariana Islands,2023,Pacific Games,5,19,1,3,0,4,-14,0
Northern Mariana Islands,2024,Marianas Cup,4,3,1,0,1,2,1,1
Norway,1908,Friendly,3,11,0,1,0,1,-8,0
Norway,1910,Friendly,0,4,0,1,0,1,-4,0
Norway,1911,Friendly,1,4,0,1,0,1,-3,0
Norway,1912,Friendly,5,13,1,3,0,4,-8,0
Norway,1912,Olympic Games,0,8,0,2,0,2,-8,0
Norway,1913,Friendly,2,11,0,1,2,3,-9,0
Norway,1914,Friendly,1,9,0,2,1,3,-8,0
Norway,1915,Friendly,4,14,0,2,1,3,-10,0
Norway,1916,Friendly,1,17,0,3,2,5,-16,0
Norway,1917,Friendly,4,19,0,3,1,4,-15,0
Norway,1918,Friendly,5,8,2,2,0,4,-3,0
Norway,1919,Friendly,14,12,3,1,1,5,2,0
Norway,1920,Friendly,1,4,0,1,2,3,-3,0
Norway,1920,Olympic Games,1,6,0,2,0,2,-5,0
Norway,1921,Friendly,10,6,3,1,0,4,4,0
Norway,1922,Friendly,15,10,3,1,2,6,5,0
Norway,1923,Friendly,15,9,3,3,1,7,6,0
Norway,1924,Friendly,0,4,0,2,0,2,-4,0
Norway,1924,Nordic Championship,2,9,0,2,0,2,-7,0
Norway,1925,Friendly,1,0,1,0,0,1,1,0
Norway,1925,Nordic Championship,4,12,0,2,0,2,-8,0
Norway,1926,Friendly,8,6,1,1,0,2,2,0
Norway,1926,Nordic Championship,4,5,0,1,1,2,-1,0
Norway,1927,Friendly,5,8,1,2,0,3,-3,0
Norway,1927,Nordic Championship,4,8,0,2,0,2,-4,0
Norway,1928,Friendly,6,2,1,1,0,2,4,0
Norway,1928,Nordic Championship,3,9,0,2,0,2,-6,0
Norway,1929,Friendly,11,12,1,1,1,3,-1,0
Norway,1929,Nordic Championship,11,3,3,0,0,3,8,0
Norway,1930,Friendly,4,1,1,0,1,2,3,0
Norway,1930,Nordic Championship,10,8,2,1,0,3,2,0
Norway,1931,Friendly,2,2,0,0,1,1,0,0
Norway,1931,Nordic Championship,7,8,1,1,1,3,-1,0
Norway,1932,Friendly,3,0,1,0,0,1,3,0
Norway,1932,Nordic Championship,7,4,2,1,0,3,3,0
Norway,1933,Friendly,2,2,0,0,1,1,0,0
Norway,1933,Nordic Championship,7,4,1,1,1,3,3,0
Norway,1934,Nordic Championship,10,6,2,0,1,3,4,0
Norway,1935,Friendly,1,3,0,1,1,2,-2,0
Norway,1935,Nordic Championship,5,4,1,2,0,3,1,0
Norway,1936,Friendly,8,8,1,1,1,3,0,0
Norway,1936,Nordic Championship,3,7,0,2,1,3,-4,0
Norway,1937,FIFA World Cup qualification,6,5,1,0,1,2,1,0
Norway,1937,Friendly,2,15,0,4,0,4,-13,0
Norway,1937,Nordic Championship,6,7,2,1,0,3,-1,0
Norway,1938,FIFA World Cup,1,2,0,1,0,1,-1,0
Norway,1938,Friendly,5,7,2,1,1,4,-2,0
Norway,1938,Nordic Championship,13,3,2,0,1,3,10,1
Norway,1939,Friendly,6,13,1,3,0,4,-7,0
Norway,1939,Nordic Championship,5,8,1,2,0,3,-3,0
Norway,1945,Friendly,3,19,0,3,0,3,-16,0
Norway,1946,Friendly,17,16,2,4,0,6,1,0
Norway,1947,Friendly,10,9,3,1,0,4,1,0
Norway,1947,Nordic Championship,7,12,0,2,1,3,-5,0
Norway,1948,Friendly,13,3,1,1,1,3,10,0
Norway,1948,Nordic Championship,7,6,2,1,0,3,1,0
Norway,1949,Friendly,2,7,0,2,0,2,-5,0
Norway,1949,Nordic Championship,4,6,0,1,2,3,-2,0
Norway,1950,Friendly,8,9,1,1,2,4,-1,0
Norway,1950,Nordic Championship,5,8,1,2,0,3,-3,0
Norway,1951,Friendly,10,10,2,2,0,4,0,0
Norway,1951,Nordic Championship,7,4,2,0,1,3,3,0
Norway,1952,Friendly,2,6,0,2,0,2,-4,0
Norway,1952,Nordic Championship,11,5,2,1,0,3,6,1
Norway,1953,FIFA World Cup qualification,4,9,0,2,2,4,-5,0
Norway,1953,Friendly,7,1,2,0,0,2,6,0
Norway,1953,Nordic Championship,4,2,1,1,1,3,2,0
Norway,1954,Friendly,4,14,1,5,1,7,-10,0
Norway,1954,Nordic Championship,5,2,2,0,1,3,3,1
Norway,1955,Friendly,1,14,0,5,0,5,-13,0
Norway,1955,Nordic Championship,5,3,1,0,2,3,2,0
Norway,1956,Friendly,4,10,0,3,1,4,-6,0
Norway,1956,Nordic Championship,7,4,2,0,1,3,3,0
Norway,1957,FIFA World Cup qualification,3,15,1,3,0,4,-12,0
Norway,1957,Friendly,6,3,2,1,1,4,3,0
Norway,1957,Nordic Championship,8,7,1,1,1,3,1,0
Norway,1958,Friendly,7,9,1,1,1,3,-2,0
Norway,1958,Nordic Championship,4,3,2,1,0,3,1,0
Norway,1959,Friendly,2,7,1,1,0,2,-5,0
Norway,1959,Nordic Championship,6,8,1,1,0,2,-2,0
Norway,1959,UEFA Euro qualification,2,6,0,2,0,2,-4,0
Norway,1960,Friendly,6,5,1,2,0,3,1,0
Norway,1960,Nordic Championship,9,7,2,1,0,3,2,0
Norway,1961,FIFA World Cup qualification,3,11,0,4,0,4,-8,0
Norway,1961,Friendly,2,2,0,0,2,2,0,0
Norway,1961,Nordic Championship,1,10,0,3,0,3,-9,0
Norway,1962,Friendly,10,2,3,0,0,3,8,0
Norway,1962,Nordic Championship,5,8,2,1,0,3,-3,0
Norway,1962,UEFA Euro qualification,1,3,0,1,1,2,-2,0
Norway,1963,Friendly,9,23,2,3,0,5,-14,0
Norway,1963,Nordic Championship,0,6,0,2,1,3,-6,0
Norway,1964,FIFA World Cup qualification,2,1,1,1,0,2,1,0
Norway,1964,Friendly,4,6,1,1,0,2,-2,0
Norway,1964,Nordic Championship,3,3,1,1,1,3,0,0
Norway,1965,FIFA World Cup qualification,8,4,2,1,1,4,4,0
Norway,1965,Friendly,7,0,1,0,0,1,7,0
Norway,1965,Nordic Championship,2,6,0,1,2,3,-4,0
Norway,1966,Friendly,1,13,0,3,0,3,-12,0
Norway,1966,Nordic Championship,4,5,1,1,1,3,-1,0
Norway,1966,UEFA Euro qualification,2,4,0,1,0,1,-2,0
Norway,1967,Nordic Championship,2,5,1,1,0,2,-3,0
Norway,1967,UEFA Euro qualification,7,10,1,3,1,5,-3,0
Norway,1968,FIFA World Cup qualification,1,5,1,1,0,2,-4,0
Norway,1968,Friendly,5,6,1,1,0,2,-1,0
Norway,1968,Nordic Championship,6,7,1,1,1,3,-1,0
Norway,1969,FIFA World Cup qualification,3,8,0,2,0,2,-5,0
Norway,1969,Friendly,9,14,3,3,0,6,-5,0
Norway,1969,Nordic Championship,6,6,1,1,1,3,0,1
Norway,1970,Friendly,0,4,0,2,0,2,-4,0
Norway,1970,Nordic Championship,3,0,2,0,0,2,3,1
Norway,1970,UEFA Euro qualification,3,7,0,2,1,3,-4,0
Norway,1971,Friendly,4,8,1,1,0,2,-4,0
Norway,1971,Nordic Championship,2,8,0,2,1,3,-6,0
Norway,1971,UEFA Euro qualification,2,11,0,3,0,3,-9,0
Norway,1972,FIFA World Cup qualification,4,12,1,2,0,3,-8,0
Norway,1972,Friendly,1,3,0,2,0,2,-2,0
Norway,1972,Nordic Championship,1,3,0,1,1,2,-2,0
Norway,1973,FIFA World Cup qualification,5,4,1,2,0,3,1,0
Norway,1973,Friendly,4,1,1,0,1,2,3,0
Norway,1973,Nordic Championship,0,2,0,2,0,2,-2,0
Norway,1974,Friendly,1,3,0,2,0,2,-2,0
Norway,1974,Nordic Championship,2,4,0,2,0,2,-2,0
Norway,1974,UEFA Euro qualification,3,4,1,1,0,2,-1,0
Norway,1975,Friendly,1,4,0,1,0,1,-3,0
Norway,1975,Nordic Championship,5,3,1,0,0,1,2,0
Norway,1975,UEFA Euro qualification,2,11,0,4,0,4,-9,0
Norway,1976,FIFA World Cup qualification,1,2,1,1,0,2,-1,0
Norway,1976,Friendly,0,4,0,2,0,2,-4,0
Norway,1976,Nordic Championship,3,5,1,1,1,3,-2,1
Norway,1977,FIFA World Cup qualification,2,2,1,1,0,2,0,0
Norway,1977,Friendly,1,4,0,2,0,2,-3,0
Norway,1977,Nordic Championship,1,2,0,1,1,2,-1,0
Norway,1978,Friendly,0,3,0,1,1,2,-3,0
Norway,1978,Nordic Championship,2,3,0,1,1,2,-1,0
Norway,1978,UEFA Euro qualification,3,6,0,2,1,3,-3,0
Norway,1979,Nordic Championship,2,2,1,1,0,2,0,0
Norway,1979,UEFA Euro qualification,2,14,0,5,0,5,-12,0
Norway,1980,FIFA World Cup qualification,3,6,1,1,1,3,-3,0
Norway,1980,Friendly,4,1,2,0,0,2,3,0
Norway,1980,Nordic Championship,7,4,1,1,0,2,3,1
Norway,1981,FIFA World Cup qualification,5,9,1,3,1,5,-4,0
Norway,1981,Friendly,4,7,0,2,1,3,-3,0
Norway,1981,Nordic Championship,2,5,0,2,0,2,-3,0
Norway,1982,Friendly,2,5,0,2,0,2,-3,0
Norway,1982,Nordic Championship,4,2,2,0,1,3,2,1
Norway,1982,UEFA Euro qualification,5,4,1,1,1,3,1,0
Norway,1983,Friendly,0,0,0,0,1,1,0,0
Norway,1983,UEFA Euro qualification,2,4,0,2,1,3,-2,0
Norway,1984,FIFA World Cup qualification,2,3,1,2,1,4,-1,0
Norway,1984,Friendly,8,2,5,0,3,8,6,0
Norway,1985,FIFA World Cup qualification,2,7,0,2,2,4,-5,0
Norway,1985,Friendly,10,7,3,3,1,7,3,0
Norway,1986,Friendly,16,7,6,1,2,9,9,0
Norway,1986,UEFA Euro qualification,0,4,0,1,1,2,-4,0
Norway,1987,Friendly,1,4,0,1,2,3,-3,0
Norway,1987,UEFA Euro qualification,5,8,1,4,1,6,-3,0
Norway,1988,FIFA World Cup qualification,4,3,1,2,0,3,1,0
Norway,1988,Friendly,5,7,0,2,3,5,-2,0
Norway,1989,FIFA World Cup qualification,6,6,1,2,2,5,0,0
Norway,1989,Friendly,8,10,1,2,2,5,-2,0
Norway,1990,Friendly,14,8,3,2,0,5,6,0
Norway,1990,Malta International Tournament,4,3,1,0,1,2,1,0
Norway,1990,UEFA Euro qualification,3,2,1,1,1,3,1,0
Norway,1991,Friendly,4,5,1,2,1,4,-1,0
Norway,1991,UEFA Euro qualification,6,3,2,1,2,5,3,0
Norway,1992,FIFA World Cup qualification,15,2,3,0,1,4,13,0
Norway,1992,Friendly,8,6,2,2,3,7,2,0
Norway,1993,FIFA World Cup qualification,10,3,4,1,1,6,7,0
Norway,1993,Friendly,15,2,3,0,1,4,13,0
Norway,1994,FIFA World Cup,1,1,1,1,1,3,0,0
Norway,1994,Friendly,6,6,2,2,3,7,0,0
Norway,1994,UEFA Euro qualification,7,1,3,0,1,4,6,0
Norway,1995,Friendly,15,6,3,1,3,7,9,0
Norway,1995,UEFA Euro qualification,10,6,3,2,1,6,4,0
Norway,1996,FIFA World Cup qualification,9,0,3,0,0,3,9,0
Norway,1996,Friendly,3,1,2,1,1,4,2,0
Norway,1997,FIFA World Cup qualification,12,2,3,0,2,5,10,0
Norway,1997,Friendly,12,5,4,2,1,7,7,0
Norway,1998,FIFA World Cup,5,5,1,1,2,4,0,0
Norway,1998,Friendly,19,8,3,0,4,7,11,0
Norway,1998,UEFA Euro qualification,5,6,1,1,1,3,-1,0
Norway,1999,Friendly,11,4,3,1,2,6,7,0
Norway,1999,UEFA Euro qualification,16,3,7,0,0,7,13,0
Norway,2000,FIFA World Cup qualification,1,2,0,1,2,3,-1,0
Norway,2000,Friendly,7,4,3,1,1,5,3,0
Norway,2000,Nordic Championship,2,4,0,1,2,3,-2,0
Norway,2000,UEFA Euro,1,1,1,1,1,3,0,0
Norway,2001,FIFA World Cup qualification,11,12,2,3,2,7,-1,0
Norway,2001,Friendly,7,2,2,0,1,3,5,0
Norway,2001,Lunar New Year Cup,3,2,1,0,0,1,1,0
Norway,2002,Friendly,5,3,2,2,3,7,2,0
Norway,2002,UEFA Euro qualification,5,2,2,0,1,3,3,0
Norway,2003,Friendly,5,5,2,3,2,7,0,0
Norway,2003,UEFA Euro qualification,5,8,2,4,1,7,-3,0
Norway,2004,FIFA World Cup qualification,6,3,2,1,1,4,3,0
Norway,2004,Friendly,17,9,4,0,3,7,8,0
Norway,2004,Lunar New Year Cup,6,1,2,0,0,2,5,1
Norway,2005,FIFA World Cup qualification,6,6,3,3,2,8,0,0
Norway,2005,Friendly,11,6,5,1,2,8,5,0
Norway,2006,Friendly,6,13,0,3,4,7,-7,0
Norway,2006,UEFA Euro qualification,6,2,2,1,0,3,4,0
Norway,2007,Friendly,3,3,1,1,0,2,0,0
Norway,2007,UEFA Euro qualification,21,9,5,2,2,9,12,0
Norway,2008,FIFA World Cup qualification,2,3,0,1,2,3,-1,0
Norway,2008,Friendly,4,10,0,3,2,5,-6,0
Norway,2009,FIFA World Cup qualification,7,4,2,1,2,5,3,0
Norway,2009,Friendly,7,4,4,1,0,5,3,0
Norway,2010,Friendly,8,6,4,2,0,6,2,0
Norway,2010,UEFA Euro qualification,5,2,3,0,0,3,3,0
Norway,2011,Friendly,5,5,2,2,0,4,0,0
Norway,2011,UEFA Euro qualification,5,5,2,2,1,5,0,0
Norway,2012,FIFA World Cup qualification,6,5,2,1,1,4,1,0
Norway,2012,Friendly,8,5,2,2,1,5,3,0
Norway,2012,King's Cup,1,0,1,0,0,1,1,1
Norway,2013,FIFA World Cup qualification,4,8,1,3,2,6,-4,0
Norway,2013,Friendly,6,9,2,4,1,7,-3,0
Norway,2014,Friendly,5,13,1,4,3,8,-8,0
Norway,2014,UEFA Euro qualification,6,3,3,1,0,4,3,0
Norway,2015,Friendly,0,0,0,0,1,1,0,0
Norway,2015,UEFA Euro qualification,8,10,3,4,1,8,-2,0
Norway,2016,FIFA World Cup qualification,5,7,1,3,0,4,-2,0
Norway,2016,Friendly,7,9,2,3,1,6,-2,0
Norway,2017,FIFA World Cup qualification,12,9,3,2,1,6,3,0
Norway,2017,Friendly,1,4,0,2,1,3,-3,0
Norway,2018,Friendly,9,3,4,0,0,4,6,0
Norway,2018,UEFA Nations League,7,2,4,1,1,6,5,0
Norway,2019,UEFA Euro qualification,19,11,4,1,5,10,8,0
Norway,2020,UEFA Euro qualification,1,2,0,1,0,1,-1,0
Norway,2020,UEFA Nations League,12,7,3,2,1,6,5,0
Norway,2021,FIFA World Cup qualification,15,8,5,2,3,10,7,0
Norway,2021,Friendly,2,2,1,1,0,2,0,0
Norway,2022,Friendly,14,2,3,0,1,4,12,0
Norway,2022,UEFA Nations League,7,7,3,2,1,6,0,0
Norway,2023,Friendly,8,0,2,0,0,2,8,0
Norway,2023,UEFA Euro qualification,14,12,3,3,2,8,2,0
Norway,2024,Friendly,6,6,1,2,1,4,0,0
Norway,2024,UEFA Nations League,15,7,4,1,1,6,8,0
Norway,2025,FIFA World Cup qualification,9,2,2,0,0,2,7,0
Occitania,2005,Friendly,16,3,1,1,2,4,13,0
Occitania,2006,Viva World Cup,8,10,2,2,0,4,-2,1
Occitania,2008,Friendly,2,2,0,0,1,1,0,0
Occitania,2009,Viva World Cup,2,6,1,2,0,3,-4,0
Occitania,2010,Friendly,5,1,1,0,0,1,4,0
Occitania,2010,Viva World Cup,8,3,2,2,0,4,5,1
Occitania,2011,Friendly,13,2,2,0,0,2,11,0
Occitania,2012,Friendly,3,2,1,0,0,1,1,0
Occitania,2012,Viva World Cup,16,4,3,1,0,4,12,0
Occitania,2013,Friendly,7,1,1,0,0,1,6,0
Occitania,2013,Tynwald Hill Tournament,13,0,2,0,0,2,13,0
Occitania,2014,CONIFA World Football Cup,5,3,2,0,3,5,2,0
Occitania,2014,Friendly,5,1,1,0,0,1,4,0
Oman,1966,Arab Cup,0,21,0,1,0,1,-21,0
Oman,1974,Gulf Cup,0,13,0,3,0,3,-13,0
Oman,1976,Gulf Cup,3,21,0,5,1,6,-18,0
Oman,1979,Gulf Cup,1,21,0,6,0,6,-20,0
Oman,1981,Friendly,0,3,0,2,0,2,-3,0
Oman,1982,Friendly,4,1,2,0,0,2,3,0
Oman,1982,Gulf Cup,2,15,0,5,0,5,-13,0
Oman,1984,AFC Asian Cup qualification,9,15,1,2,1,4,-6,0
Oman,1984,Gulf Cup,3,9,0,4,2,6,-6,0
Oman,1986,Asian Games,3,5,1,1,2,4,-2,0
Oman,1986,Friendly,5,6,2,2,1,5,-1,0
Oman,1986,Gulf Cup,4,11,0,5,1,6,-7,0
Oman,1987,King's Cup,0,2,0,1,0,1,-2,0
Oman,1988,Friendly,1,1,0,0,1,1,0,0
Oman,1988,Gulf Cup,3,9,1,4,1,6,-6,0
Oman,1988,King's Cup,1,6,0,2,0,2,-5,0
Oman,1988,Merdeka Tournament,1,3,0,1,0,1,-2,0
Oman,1989,FIFA World Cup qualification,2,11,0,4,2,6,-9,0
Oman,1990,Gulf Cup,4,6,0,1,3,4,-2,0
Oman,1992,AFC Asian Cup qualification,0,4,0,1,0,1,-4,0
Oman,1992,Friendly,0,4,0,1,0,1,-4,0
Oman,1992,Gulf Cup,1,10,0,5,0,5,-9,0
Oman,1993,FIFA World Cup qualification,10,5,2,2,2,6,5,0
Oman,1993,Friendly,1,0,1,0,0,1,1,0
Oman,1994,Asian Games,4,4,1,1,1,3,0,0
Oman,1994,Friendly,14,8,5,2,3,10,6,0
Oman,1994,Gulf Cup,4,9,0,3,2,5,-5,0
Oman,1996,AFC Asian Cup qualification,23,5,4,2,0,6,18,0
Oman,1996,Friendly,10,14,4,7,3,14,-4,0
Oman,1996,Gulf Cup,2,7,0,3,2,5,-5,0
Oman,1997,FIFA World Cup qualification,14,2,4,1,1,6,12,0
Oman,1997,Friendly,0,1,0,1,0,1,-1,0
Oman,1998,Asian Games,14,13,2,2,1,5,1,0
Oman,1998,Friendly,8,10,2,3,3,8,-2,0
Oman,1998,Gulf Cup,6,12,1,3,1,5,-6,0
Oman,1999,AFC Asian Cup qualification,4,4,1,2,0,3,0,0
Oman,1999,Friendly,6,13,1,2,2,5,-7,0
Oman,2000,Friendly,14,14,4,4,0,8,0,0
Oman,2000,Merdeka Tournament,0,3,0,2,0,2,-3,0
Oman,2001,FIFA World Cup qualification,40,19,6,4,4,14,21,0
Oman,2001,Friendly,23,17,8,5,3,16,6,0
Oman,2002,Friendly,2,3,1,1,0,2,-1,0
Oman,2002,Gulf Cup,5,7,1,3,1,5,-2,0
Oman,2003,AFC Asian Cup qualification,24,2,5,1,0,6,22,0
Oman,2003,Friendly,10,5,4,1,0,5,5,0
Oman,2003,Gulf Cup,3,1,1,0,2,3,2,1
Oman,2004,AFC Asian Cup,4,3,1,1,1,3,1,0
Oman,2004,FIFA World Cup qualification,14,3,3,2,1,6,11,0
Oman,2004,Friendly,11,7,5,1,0,6,4,0
Oman,2004,Gulf Cup,13,10,4,3,1,8,3,0
Oman,2004,Prime Minister's Cup,3,2,1,0,1,2,1,0
Oman,2005,Friendly,5,7,0,1,3,4,-2,0
Oman,2006,AFC Asian Cup qualification,14,6,4,2,0,6,8,0
Oman,2006,Friendly,6,1,3,0,1,4,5,0
Oman,2007,AFC Asian Cup,1,3,0,1,2,3,-2,0
Oman,2007,FIFA World Cup qualification,4,0,2,0,0,2,4,0
Oman,2007,Friendly,14,13,3,1,6,10,1,0
Oman,2007,Gulf Cup,7,4,4,1,0,5,3,0
Oman,2008,FIFA World Cup qualification,5,7,2,2,2,6,-2,0
Oman,2008,Friendly,20,9,8,2,4,14,11,0
Oman,2008,WAFF Championship,1,2,0,1,0,1,-1,0
Oman,2009,AFC Asian Cup qualification,2,3,1,2,1,4,-1,0
Oman,2009,Friendly,10,8,3,3,1,7,2,1
Oman,2009,Gulf Cup,7,0,3,0,2,5,7,0
Oman,2010,AFC Asian Cup qualification,2,1,1,0,1,2,1,0
Oman,2010,Friendly,9,13,3,5,1,9,-4,0
Oman,2010,Gulf Cup,1,1,0,0,3,3,0,0
Oman,2010,WAFF Championship,2,4,0,1,1,2,-2,0
Oman,2011,FIFA World Cup qualification,5,6,3,2,2,7,-1,0
Oman,2011,Friendly,7,4,3,0,4,7,3,0
Oman,2012,FIFA World Cup qualification,6,7,2,2,2,6,-1,0
Oman,2012,Friendly,15,13,3,3,3,9,2,0
Oman,2012,WAFF Championship,5,4,3,2,0,5,1,1
Oman,2013,AFC Asian Cup qualification,4,0,3,0,1,4,4,0
Oman,2013,FIFA World Cup qualification,3,3,1,1,1,3,0,0
Oman,2013,Friendly,8,2,3,0,2,5,6,0
Oman,2013,Gulf Cup,1,4,0,2,1,3,-3,0
Oman,2013,WAFF Championship,0,0,0,0,2,2,0,0
Oman,2014,AFC Asian Cup qualification,3,1,1,0,1,2,2,0
Oman,2014,Friendly,9,12,3,4,2,9,-3,0
Oman,2014,Gulf Cup,7,5,1,2,2,5,2,0
Oman,2015,AFC Asian Cup,1,5,1,2,0,3,-4,0
Oman,2015,FIFA World Cup qualification,10,5,3,1,2,6,5,0
Oman,2015,Friendly,12,12,3,4,1,8,0,0
Oman,2016,FIFA World Cup qualification,1,2,1,1,0,2,-1,0
Oman,2016,Friendly,7,7,2,1,2,5,0,0
Oman,2016,Kirin Challenge Cup,0,4,0,1,0,1,-4,0
Oman,2017,AFC Asian Cup qualification,27,5,4,1,0,5,22,0
Oman,2017,Friendly,3,1,1,0,1,2,2,0
Oman,2017,Gulf Cup,3,1,2,1,0,3,2,0
Oman,2018,AFC Asian Cup qualification,1,0,1,0,0,1,1,0
Oman,2018,Friendly,7,9,3,1,6,10,-2,0
Oman,2018,Gulf Cup,1,0,1,0,1,2,1,0
Oman,2019,AFC Asian Cup,4,6,1,3,0,4,-2,0
Oman,2019,FIFA World Cup qualification,11,4,4,1,0,5,7,0
Oman,2019,Friendly,4,1,2,0,1,3,3,0
Oman,2019,Gulf Cup,3,4,1,1,1,3,-1,0
Oman,2021,Arab Cup,6,5,1,2,1,4,1,0
Oman,2021,Arab Cup qualification,2,1,1,0,0,1,1,0
Oman,2021,FIFA World Cup qualification,11,9,4,4,1,9,2,0
Oman,2021,Friendly,5,2,2,0,2,4,3,0
Oman,2022,FIFA World Cup qualification,5,3,2,1,1,4,2,0
Oman,2022,Friendly,7,2,4,1,1,6,5,0
Oman,2022,Jordan International Tournament,1,2,0,1,1,2,-1,0
Oman,2023,CAFA Nations Cup,4,4,2,1,1,4,0,1
Oman,2023,FIFA World Cup qualification,3,1,1,1,0,2,2,0
Oman,2023,Friendly,4,5,2,1,0,3,-1,0
Oman,2023,Gulf Cup,8,6,3,1,1,5,2,0
Oman,2024,AFC Asian Cup,2,3,0,1,2,3,-1,0
Oman,2024,FIFA World Cup qualification,14,10,5,4,1,10,4,0
Oman,2024,Friendly,1,0,1,0,0,1,1,0
Oman,2024,Gulf Cup,6,4,2,0,2,4,2,1
Oman,2025,FIFA World Cup qualification,2,1,1,0,1,2,1,0
Oman,2025,Friendly,0,0,0,0,1,1,0,0
Oman,2025,Gulf Cup,1,2,0,1,0,1,-1,0
Orkney,2001,Island Games,2,20,0,4,0,4,-18,0
Orkney,2003,Island Games,4,24,1,3,0,4,-20,0
Orkney,2005,Island Games,7,12,1,4,0,5,-5,0
Orkney,2017,Island Games,6,5,2,2,0,4,1,0
Orkney,2019,Inter Games Football Tournament,4,11,1,3,0,4,-7,0
Orkney,2023,Island Games,5,5,1,1,1,3,0,0
Padania,2008,Viva World Cup,16,3,5,0,0,5,13,1
Padania,2009,Viva World Cup,9,1,4,0,0,4,8,1
Padania,2010,Viva World Cup,6,1,4,0,0,4,5,0
Padania,2014,CONIFA World Football Cup,28,7,2,1,2,5,21,0
Padania,2015,CONIFA European Football Cup,13,3,4,0,0,4,10,1
Padania,2016,CONIFA World Football Cup,10,6,2,2,1,5,4,0
Padania,2016,Friendly,2,0,1,0,0,1,2,0
Padania,2017,CONIFA European Football Cup,5,2,2,0,3,5,3,0
Padania,2018,CONIFA World Football Cup,21,5,4,1,1,6,16,0
Padania,2019,CONIFA European Football Cup,10,5,2,2,1,5,5,0
Pakistan,1952,Friendly,3,0,2,0,1,3,3,0
Pakistan,1953,Friendly,1,1,0,0,1,1,0,0
Pakistan,1954,Asian Games,7,4,1,1,0,2,3,0
Pakistan,1954,Friendly,5,4,1,0,2,3,1,0
Pakistan,1955,Friendly,4,2,1,0,0,1,2,0
Pakistan,1956,Friendly,1,1,0,0,1,1,0,0
Pakistan,1958,Asian Games,2,4,0,1,1,2,-2,0
Pakistan,1958,Friendly,6,8,0,1,1,2,-2,0
Pakistan,1959,AFC Asian Cup qualification,2,5,0,2,1,3,-3,0
Pakistan,1960,Friendly,5,11,0,2,1,3,-6,0
Pakistan,1960,Merdeka Tournament,10,6,2,2,0,4,4,0
Pakistan,1962,Merdeka Tournament,3,3,1,1,2,4,0,0
Pakistan,1963,Friendly,4,5,1,1,2,4,-1,0
Pakistan,1965,Friendly,2,7,0,2,0,2,-5,0
Pakistan,1967,AFC Asian Cup qualification,1,3,0,1,1,2,-2,0
Pakistan,1967,Friendly,4,7,0,1,0,1,-3,0
Pakistan,1969,Friendly,7,18,1,3,0,4,-11,0
Pakistan,1970,Friendly,1,10,0,2,0,2,-9,0
Pakistan,1973,Friendly,4,7,0,1,0,1,-3,0
Pakistan,1974,Asian Games,6,13,1,2,0,3,-7,0
Pakistan,1974,Friendly,3,4,0,1,1,2,-1,0
Pakistan,1976,Friendly,2,2,1,1,1,3,0,0
Pakistan,1981,King's Cup,4,3,2,1,0,3,1,1
Pakistan,1982,Friendly,1,4,0,1,0,1,-3,0
Pakistan,1984,AFC Asian Cup qualification,4,14,1,3,0,4,-10,0
Pakistan,1985,Friendly,3,6,1,2,1,4,-3,0
Pakistan,1985,South Asian Games,6,5,1,1,1,3,1,0
Pakistan,1986,Asian Games,2,15,0,4,0,4,-13,0
Pakistan,1986,Friendly,7,5,3,2,0,5,2,0
Pakistan,1987,South Asian Games,2,0,2,0,1,3,2,0
Pakistan,1988,AFC Asian Cup qualification,1,12,0,4,0,4,-11,0
Pakistan,1989,FIFA World Cup qualification,1,12,0,4,0,4,-11,0
Pakistan,1989,South Asian Games,3,0,2,0,1,3,3,1
Pakistan,1990,Asian Games,1,16,0,3,0,3,-15,0
Pakistan,1991,South Asian Games,3,0,2,0,1,3,3,1
Pakistan,1992,AFC Asian Cup qualification,0,7,0,1,0,1,-7,0
Pakistan,1992,Jordan International Tournament,0,11,0,3,0,3,-11,0
Pakistan,1993,FIFA World Cup qualification,2,36,0,8,0,8,-34,0
Pakistan,1993,Friendly,0,9,0,2,0,2,-9,0
Pakistan,1993,South Asian Games,3,4,0,1,1,2,-1,0
Pakistan,1995,SAFF Cup,1,2,1,1,0,2,-1,0
Pakistan,1996,AFC Asian Cup qualification,0,7,0,2,0,2,-7,0
Pakistan,1997,FIFA World Cup qualification,3,22,0,4,0,4,-19,0
Pakistan,1997,SAFF Cup,3,4,2,2,0,4,-1,0
Pakistan,1999,SAFF Cup,0,6,0,2,0,2,-6,0
Pakistan,1999,South Asian Games,5,9,1,2,0,3,-4,0
Pakistan,2000,AFC Asian Cup qualification,0,16,0,4,0,4,-16,0
Pakistan,2001,FIFA World Cup qualification,5,29,0,5,1,6,-24,0
Pakistan,2002,Friendly,2,4,0,2,2,4,-2,0
Pakistan,2003,AFC Asian Cup qualification,3,3,1,1,0,2,0,0
Pakistan,2003,FIFA World Cup qualification,0,6,0,2,0,2,-6,0
Pakistan,2003,SAFF Cup,5,4,3,2,0,5,1,0
Pakistan,2005,AFC Asian Cup qualification,0,1,0,1,1,2,-1,0
Pakistan,2005,Friendly,4,2,1,1,1,3,2,0
Pakistan,2005,SAFF Cup,2,1,2,1,1,4,1,0
Pakistan,2006,AFC Asian Cup qualification,4,22,0,6,0,6,-18,0
Pakistan,2006,AFC Challenge Cup,3,4,1,1,1,3,-1,0
Pakistan,2006,Friendly,0,3,0,1,0,1,-3,0
Pakistan,2007,FIFA World Cup qualification,0,7,0,1,1,2,-7,0
Pakistan,2008,AFC Challenge Cup qualification,10,9,1,1,0,2,1,0
Pakistan,2008,Friendly,4,6,1,2,0,3,-2,0
Pakistan,2008,SAFF Cup,2,9,0,3,0,3,-7,0
Pakistan,2009,AFC Challenge Cup qualification,9,3,1,0,2,3,6,0
Pakistan,2009,Friendly,0,1,0,1,0,1,-1,0
Pakistan,2009,SAFF Cup,7,1,1,1,1,3,6,0
Pakistan,2011,AFC Challenge Cup qualification,1,6,0,2,0,2,-5,0
Pakistan,2011,FIFA World Cup qualification,0,3,0,1,1,2,-3,0
Pakistan,2011,SAFF Cup,1,1,0,0,3,3,0,0
Pakistan,2012,Friendly,0,4,0,1,0,1,-4,0
Pakistan,2013,AFC Challenge Cup qualification,2,2,1,2,0,3,0,0
Pakistan,2013,Friendly,4,10,2,3,1,6,-6,0
Pakistan,2013,SAFF Cup,3,3,1,1,1,3,0,0
Pakistan,2014,Friendly,1,9,0,3,0,3,-8,0
Pakistan,2015,FIFA World Cup qualification,1,3,0,1,1,2,-2,0
Pakistan,2015,Friendly,2,1,1,0,0,1,1,0
Pakistan,2018,Friendly,1,4,0,2,0,2,-3,0
Pakistan,2018,SAFF Cup,6,5,2,2,0,4,1,0
Pakistan,2019,FIFA World Cup qualification,1,4,0,2,0,2,-3,0
Pakistan,2022,Friendly,0,1,0,1,0,1,-1,0
Pakistan,2023,FIFA World Cup qualification,2,10,1,2,1,4,-8,0
Pakistan,2023,Friendly,0,1,0,1,0,1,-1,0
Pakistan,2023,Mauritius Four Nations Cup,1,7,0,3,0,3,-6,0
Pakistan,2023,SAFF Cup,0,9,0,3,0,3,-9,0
Pakistan,2024,FIFA World Cup qualification,0,16,0,4,0,4,-16,0
Pakistan,2025,AFC Asian Cup qualification,0,2,0,1,0,1,-2,0
Palau,1987,Friendly,2,6,0,1,0,1,-4,0
Palau,1998,Friendly,2,15,0,1,0,1,-13,0
Palestine,1966,Arab Cup,8,3,1,1,1,3,5,0
Palestine,1966,GaNEFo,6,19,1,3,0,4,-13,0
Palestine,1969,Friendly,1,3,0,1,1,2,-2,0
Palestine,1971,Friendly,1,1,0,0,1,1,0,0
Palestine,1972,Palestine Cup,9,9,1,3,0,4,0,0
Palestine,1973,Palestine Cup,4,9,1,2,1,4,-5,0
Palestine,1974,Kuneitra Cup,8,6,1,2,1,4,2,0
Palestine,1975,Palestine Cup,0,1,0,1,1,2,-1,0
Palestine,1979,Friendly,0,0,0,0,1,1,0,0
Palestine,1992,Arab Cup,1,2,0,1,1,2,-1,0
Palestine,1997,Friendly,0,0,0,0,1,1,0,0
Palestine,1998,Arab Cup qualification,3,6,0,2,1,3,-3,0
Palestine,2000,AFC Asian Cup qualification,3,8,1,3,0,4,-5,0
Palestine,2000,WAFF Championship,3,5,0,2,1,3,-2,0
Palestine,2001,FIFA World Cup qualification,8,9,2,3,1,6,-1,0
Palestine,2002,Arab Cup,6,6,0,0,3,3,0,0
Palestine,2002,Friendly,1,3,0,1,0,1,-2,0
Palestine,2002,WAFF Championship,1,4,0,2,0,2,-3,0
Palestine,2003,AFC Asian Cup qualification,3,11,0,4,2,6,-8,0
Palestine,2004,FIFA World Cup qualification,11,11,2,3,1,6,0,0
Palestine,2004,Friendly,1,2,0,1,1,2,-1,0
Palestine,2004,WAFF Championship,2,3,0,1,1,2,-1,0
Palestine,2005,Friendly,0,6,0,2,0,2,-6,0
Palestine,2006,AFC Asian Cup qualification,3,9,1,3,1,5,-6,0
Palestine,2006,AFC Challenge Cup,16,2,2,1,1,4,14,0
Palestine,2006,Friendly,5,3,2,1,0,3,2,0
Palestine,2007,FIFA World Cup qualification,0,4,0,1,0,1,-4,0
Palestine,2007,WAFF Championship,0,3,0,2,0,2,-3,0
Palestine,2008,Friendly,1,1,0,0,1,1,0,0
Palestine,2008,WAFF Championship,0,4,0,2,0,2,-4,0
Palestine,2009,AFC Challenge Cup qualification,1,1,0,0,2,2,0,0
Palestine,2009,Friendly,2,11,0,3,1,4,-9,0
Palestine,2010,Friendly,1,1,0,0,2,2,0,0
Palestine,2010,WAFF Championship,1,6,0,2,0,2,-5,0
Palestine,2011,AFC Challenge Cup qualification,5,1,2,0,1,3,4,0
Palestine,2011,FIFA World Cup qualification,5,4,1,1,2,4,1,0
Palestine,2011,Friendly,11,13,2,3,0,5,-2,0
Palestine,2012,AFC Challenge Cup,7,6,2,2,1,5,1,0
Palestine,2012,Arab Cup,2,4,0,1,1,2,-2,0
Palestine,2012,Friendly,7,8,3,2,2,7,-1,0
Palestine,2012,WAFF Championship,3,4,1,2,0,3,-1,0
Palestine,2013,AFC Challenge Cup qualification,10,0,2,0,1,3,10,0
Palestine,2013,Friendly,7,6,2,2,0,4,1,0
Palestine,2013,WAFF Championship,0,1,0,1,1,2,-1,0
Palestine,2014,AFC Challenge Cup,6,0,4,0,1,5,6,1
Palestine,2014,Friendly,16,13,4,3,1,8,3,0
Palestine,2015,AFC Asian Cup,1,11,0,3,0,3,-10,0
Palestine,2015,FIFA World Cup qualification,17,3,3,1,2,6,14,0
Palestine,2015,Friendly,0,0,0,0,1,1,0,0
Palestine,2016,FIFA World Cup qualification,7,2,1,1,0,2,5,0
Palestine,2016,Friendly,5,5,0,0,3,3,0,0
Palestine,2017,AFC Asian Cup qualification,25,2,5,0,0,5,23,0
Palestine,2017,Friendly,3,0,2,0,0,2,3,0
Palestine,2018,AFC Asian Cup qualification,0,1,0,1,0,1,-1,0
Palestine,2018,Friendly,8,15,2,5,5,12,-7,0
Palestine,2019,AFC Asian Cup,0,3,0,1,2,3,-3,0
Palestine,2019,FIFA World Cup qualification,3,5,1,3,1,5,-2,0
Palestine,2019,Friendly,2,2,0,0,1,1,0,0
Palestine,2019,WAFF Championship,6,5,2,1,1,4,1,0
Palestine,2021,Arab Cup,2,10,0,2,1,3,-8,0
Palestine,2021,Arab Cup qualification,5,1,1,0,0,1,4,0
Palestine,2021,FIFA World Cup qualification,7,5,2,1,0,3,2,0
Palestine,2021,Friendly,1,0,1,0,0,1,1,0
Palestine,2021,Three Nations Cup,2,1,1,1,0,2,1,0
Palestine,2022,AFC Asian Cup qualification,10,0,3,0,0,3,10,0
Palestine,2023,FIFA World Cup qualification,0,1,0,1,1,2,-1,0
Palestine,2023,Friendly,3,7,1,3,1,5,-4,0
Palestine,2024,AFC Asian Cup,6,7,1,2,1,4,-1,0
Palestine,2024,FIFA World Cup qualification,10,13,2,4,4,10,-3,0
Palestine,2024,Friendly,0,1,0,1,1,2,-1,0
Palestine,2025,FIFA World Cup qualification,3,4,1,1,0,2,-1,0
Panama,1938,Central American and Caribbean Games,7,20,1,3,1,5,-13,0
Panama,1939,Friendly,1,9,0,3,1,4,-8,0
Panama,1941,CCCF Championship,11,16,1,2,1,4,-5,1
Panama,1946,CCCF Championship,5,16,1,3,1,5,-11,0
Panama,1946,Central American and Caribbean Games,23,8,4,1,1,6,15,1
Panama,1946,Friendly,6,5,1,0,1,2,1,0
Panama,1948,CCCF Championship,19,17,4,3,0,7,2,1
Panama,1949,Friendly,4,5,1,1,0,2,-1,0
Panama,1951,CCCF Championship,13,3,3,0,1,4,10,1
Panama,1951,Friendly,1,4,0,1,0,1,-3,0
Panama,1952,Pan American Championship,5,28,0,5,0,5,-23,0
Panama,1953,CCCF Championship,6,16,0,5,1,6,-10,0
Panama,1956,Friendly,5,10,0,4,0,4,-5,0
Panama,1957,CCCF Championship,1,3,1,1,0,2,-2,0
Panama,1957,Friendly,2,2,0,0,1,1,0,0
Panama,1961,CCCF Championship,2,3,1,1,0,2,-1,0
Panama,1961,Friendly,2,14,0,4,1,5,-12,0
Panama,1963,CONCACAF Championship,8,4,1,1,2,4,4,0
Panama,1966,Friendly,4,2,2,1,0,3,2,0
Panama,1967,CONCACAF Championship qualification,2,6,0,2,0,2,-4,0
Panama,1969,CONCACAF Championship qualification,2,3,0,1,1,2,-1,0
Panama,1970,Friendly,0,1,0,1,0,1,-1,0
Panama,1972,Friendly,5,1,1,1,1,3,4,0
Panama,1973,Friendly,2,4,1,1,0,2,-2,0
Panama,1974,Friendly,2,0,2,0,0,2,2,0
Panama,1975,Friendly,11,10,2,3,3,8,1,0
Panama,1976,CONCACAF Championship qualification,7,21,1,4,1,6,-14,0
Panama,1976,Friendly,0,5,0,1,0,1,-5,0
Panama,1977,Friendly,0,5,0,2,0,2,-5,0
Panama,1980,CONCACAF Championship qualification,3,24,0,7,1,8,-21,0
Panama,1980,Friendly,0,2,0,1,2,3,-2,0
Panama,1983,Friendly,1,0,1,0,1,2,1,0
Panama,1984,CONCACAF Championship qualification,0,4,0,2,0,2,-4,0
Panama,1984,Friendly,5,5,1,2,2,5,0,0
Panama,1985,Friendly,1,1,0,0,3,3,0,0
Panama,1986,Friendly,3,3,1,1,1,3,0,0
Panama,1987,Friendly,8,5,4,1,2,7,3,0
Panama,1988,CONCACAF Championship qualification,1,3,0,1,1,2,-2,0
Panama,1989,Friendly,0,2,0,1,0,1,-2,0
Panama,1991,UNCAF Cup,2,3,1,1,0,2,-1,0
Panama,1992,FIFA World Cup qualification,2,5,1,1,0,2,-3,0
Panama,1992,Friendly,0,8,0,2,0,2,-8,0
Panama,1993,Friendly,1,3,0,1,0,1,-2,0
Panama,1993,Gold Cup,3,8,0,2,1,3,-5,0
Panama,1993,UNCAF Cup,1,5,0,2,1,3,-4,0
Panama,1995,UNCAF Cup,7,3,2,2,0,4,4,0
Panama,1996,FIFA World Cup qualification,14,13,3,3,2,8,1,0
Panama,1996,Friendly,7,7,4,3,2,9,0,0
Panama,1997,UNCAF Cup,2,8,1,2,1,4,-6,0
Panama,1999,Friendly,3,2,1,0,1,2,1,0
Panama,2000,FIFA World Cup qualification,9,19,3,6,1,10,-10,0
Panama,2000,Friendly,11,18,3,4,2,9,-7,0
Panama,2001,Friendly,6,8,2,1,4,7,-2,0
Panama,2001,Gold Cup qualification,0,1,0,1,1,2,-1,0
Panama,2001,UNCAF Cup,12,9,2,3,1,6,3,0
Panama,2003,Friendly,4,5,2,2,0,4,-1,0
Panama,2003,UNCAF Cup,4,5,1,3,1,5,-1,0
Panama,2004,FIFA World Cup qualification,15,11,4,2,2,8,4,0
Panama,2004,Friendly,9,9,2,2,5,9,0,0
Panama,2005,FIFA World Cup qualification,4,21,0,8,2,10,-17,0
Panama,2005,Friendly,1,10,0,3,1,4,-9,0
Panama,2005,Gold Cup,7,6,2,1,3,6,1,0
Panama,2005,UNCAF Cup,1,5,1,3,0,4,-4,0
Panama,2006,Friendly,7,5,3,2,1,6,2,0
Panama,2007,Friendly,8,15,2,4,4,10,-7,0
Panama,2007,Gold Cup,6,7,1,2,1,4,-1,0
Panama,2007,UNCAF Cup,5,2,2,0,2,4,3,0
Panama,2008,FIFA World Cup qualification,2,3,1,1,0,2,-1,0
Panama,2008,Friendly,3,3,1,1,2,4,0,0
Panama,2009,Friendly,8,10,1,4,1,6,-2,0
Panama,2009,Gold Cup,7,5,1,2,1,4,2,0
Panama,2009,UNCAF Cup,2,3,2,1,1,4,-1,0
Panama,2010,Friendly,16,11,6,3,1,10,5,0
Panama,2011,FIFA World Cup qualification,15,2,4,0,0,4,13,0
Panama,2011,Friendly,11,4,5,2,0,7,7,0
Panama,2011,Gold Cup,7,6,2,1,2,5,1,0
Panama,2011,UNCAF Cup,7,1,3,0,2,5,6,0
Panama,2012,FIFA World Cup qualification,6,2,3,1,2,6,4,0
Panama,2012,Friendly,6,10,3,4,0,7,-4,0
Panama,2013,FIFA World Cup qualification,10,14,1,4,5,10,-4,0
Panama,2013,Friendly,6,2,2,1,0,3,4,0
Panama,2013,Gold Cup,11,4,4,1,1,6,7,0
Panama,2013,UNCAF Cup,4,2,1,0,2,3,2,0
Panama,2014,Friendly,4,8,1,3,1,5,-4,0
Panama,2014,UNCAF Cup,2,2,0,0,1,1,0,0
Panama,2015,FIFA World Cup qualification,3,2,1,1,0,2,1,0
Panama,2015,Friendly,5,9,2,2,2,6,-4,0
Panama,2015,Gold Cup,6,7,0,1,5,6,-1,0
Panama,2016,Copa América,4,10,1,2,0,3,-6,0
Panama,2016,Copa América qualification,4,0,1,0,0,1,4,1
Panama,2016,FIFA World Cup qualification,5,3,3,1,2,6,2,0
Panama,2016,Friendly,2,1,1,1,0,2,1,0
Panama,2017,FIFA World Cup qualification,8,10,2,3,3,8,-2,0
Panama,2017,Friendly,7,3,1,1,1,3,4,0
Panama,2017,Gold Cup,6,3,2,1,1,4,3,0
Panama,2017,UNCAF Cup,1,0,1,0,0,1,1,0
Panama,2018,FIFA World Cup,2,11,0,3,0,3,-9,0
Panama,2018,Friendly,4,15,1,6,2,9,-11,0
Panama,2018,Kirin Challenge Cup,0,3,0,1,0,1,-3,0
Panama,2019,CONCACAF Nations League,5,9,1,3,0,4,-4,0
Panama,2019,Friendly,1,10,0,3,2,5,-9,0
Panama,2019,Gold Cup,6,4,2,2,0,4,2,0
Panama,2020,Friendly,4,7,2,2,0,4,-3,0
Panama,2021,FIFA World Cup qualification,32,11,9,2,3,14,21,0
Panama,2021,Friendly,0,3,0,1,1,2,-3,0
Panama,2021,Gold Cup,8,7,1,1,1,3,1,0
Panama,2022,CONCACAF Nations League,7,0,2,0,1,3,7,0
Panama,2022,FIFA World Cup qualification,6,10,2,3,1,6,-4,0
Panama,2022,Friendly,8,12,1,2,4,7,-4,0
Panama,2023,CONCACAF Nations League,16,6,6,2,1,9,10,0
Panama,2023,Friendly,6,6,2,1,1,4,0,0
Panama,2023,Gold Cup,11,6,3,1,2,6,5,0
Panama,2024,CONCACAF Nations League,3,6,1,2,1,4,-3,0
Panama,2024,Copa América,6,10,2,2,0,4,-4,0
Panama,2024,FIFA World Cup qualification,5,1,2,0,0,2,4,0
Panama,2024,Friendly,1,5,0,3,0,3,-4,0
Panama,2025,CONCACAF Nations League,2,2,1,1,0,2,0,0
Panama,2025,Friendly,1,6,0,1,0,1,-5,0
Panjab,2015,Friendly,13,2,2,0,0,2,11,0
Panjab,2015,Niamh Challenge Cup,1,8,0,1,0,1,-7,0
Panjab,2016,CONIFA World Football Cup,10,4,3,1,1,5,6,0
Panjab,2016,Friendly,0,2,0,1,0,1,-2,0
Panjab,2017,Friendly,2,0,1,0,0,1,2,0
Panjab,2018,CONIFA World Football Cup,17,7,2,2,2,6,10,0
Panjab,2018,Friendly,5,7,0,2,0,2,-2,0
Panjab,2019,Friendly,6,0,1,0,0,1,6,1
Papua New Guinea,1963,South Pacific Games,1,3,0,1,0,1,-2,0
Papua New Guinea,1966,South Pacific Games,14,14,1,3,0,4,0,0
Papua New Guinea,1969,South Pacific Games,11,10,3,2,1,6,1,1
Papua New Guinea,1971,South Pacific Games,19,15,1,2,1,4,4,0
Papua New Guinea,1975,South Pacific Games,3,12,0,3,0,3,-9,0
Papua New Guinea,1979,South Pacific Games,15,5,1,2,1,4,10,0
Papua New Guinea,1980,Oceania Nations Cup,6,22,1,2,0,3,-16,0
Papua New Guinea,1981,South Pacific Mini Games,14,16,5,2,0,7,-2,0
Papua New Guinea,1983,South Pacific Games,22,12,1,4,0,5,10,0
Papua New Guinea,1984,Merdeka Tournament,4,6,2,1,0,3,-2,0
Papua New Guinea,1985,Friendly,2,5,0,1,1,2,-3,0
Papua New Guinea,1987,South Pacific Games,26,4,3,1,2,6,22,0
Papua New Guinea,1989,Friendly,5,4,1,2,1,4,1,0
Papua New Guinea,1990,Friendly,1,5,0,4,0,4,-4,0
Papua New Guinea,1991,South Pacific Games,5,1,1,1,1,3,4,0
Papua New Guinea,1993,South Pacific Mini Games,6,2,1,1,1,3,4,0
Papua New Guinea,1994,Oceania Nations Cup qualification,2,4,1,2,1,4,-2,0
Papua New Guinea,1995,South Pacific Games,11,5,1,1,1,3,6,0
Papua New Guinea,1996,FIFA World Cup qualification,3,2,1,0,1,2,1,0
Papua New Guinea,1997,FIFA World Cup qualification,2,11,1,3,0,4,-9,0
Papua New Guinea,1998,Friendly,1,2,0,1,0,1,-1,0
Papua New Guinea,1998,Oceania Nations Cup qualification,3,6,1,2,1,4,-3,0
Papua New Guinea,2000,Oceania Nations Cup qualification,4,19,0,4,0,4,-15,0
Papua New Guinea,2002,Oceania Nations Cup,2,12,0,2,1,3,-10,0
Papua New Guinea,2002,Oceania Nations Cup qualification,20,2,4,0,0,4,18,0
Papua New Guinea,2003,Friendly,3,5,0,1,0,1,-2,0
Papua New Guinea,2003,South Pacific Games,12,7,1,2,1,4,5,0
Papua New Guinea,2004,FIFA World Cup qualification,17,6,2,1,1,4,11,0
Papua New Guinea,2007,Friendly,1,2,0,1,0,1,-1,0
Papua New Guinea,2011,Pacific Games,22,4,2,1,1,4,18,0
Papua New Guinea,2012,Oceania Nations Cup,2,4,0,2,1,3,-2,0
Papua New Guinea,2014,Friendly,1,7,0,2,0,2,-6,0
Papua New Guinea,2016,Friendly,2,12,0,3,0,3,-10,0
Papua New Guinea,2016,Oceania Nations Cup,13,4,2,0,3,5,9,0
Papua New Guinea,2017,FIFA World Cup qualification,6,9,1,3,0,4,-3,0
Papua New Guinea,2019,Pacific Games,17,1,3,0,1,4,16,0
Papua New Guinea,2022,FIFA World Cup qualification,5,5,2,2,0,4,0,0
Papua New Guinea,2022,MSG Prime Minister's Cup,2,0,2,0,0,2,2,0
Papua New Guinea,2023,Friendly,2,12,0,1,1,2,-10,0
Papua New Guinea,2023,MSG Prime Minister's Cup,2,7,0,3,0,3,-5,0
Papua New Guinea,2023,Pacific Games,7,3,2,1,1,4,4,0
Papua New Guinea,2024,FIFA Series,0,4,0,1,1,2,-4,0
Papua New Guinea,2024,FIFA World Cup qualification,5,8,0,2,1,3,-3,0
Papua New Guinea,2024,Oceania Nations Cup,4,7,1,1,1,3,-3,0
Paraguay,1919,Friendly,3,12,0,4,0,4,-9,0
Paraguay,1921,Copa América,2,7,1,2,0,3,-5,0
Paraguay,1921,Friendly,7,7,1,1,1,3,0,0
Paraguay,1922,Copa América,5,6,2,2,1,5,-1,0
Paraguay,1922,Friendly,1,3,0,1,0,1,-2,0
Paraguay,1923,Copa América,4,6,1,2,0,3,-2,0
Paraguay,1923,Copa Chevallier Boutell,2,1,1,1,0,2,1,0
Paraguay,1923,Friendly,0,2,0,1,0,1,-2,0
Paraguay,1924,Copa América,4,4,1,1,1,3,0,0
Paraguay,1924,Copa Chevallier Boutell,3,4,1,1,0,2,-1,1
Paraguay,1925,Copa América,4,13,0,4,0,4,-9,0
Paraguay,1925,Copa Chevallier Boutell,2,2,0,0,2,2,0,0
Paraguay,1925,Friendly,3,1,3,1,1,5,2,0
Paraguay,1926,Copa América,8,20,1,3,0,4,-12,0
Paraguay,1926,Copa Chevallier Boutell,2,4,0,2,0,2,-2,0
Paraguay,1928,Friendly,4,2,1,0,1,2,2,0
Paraguay,1929,Copa América,9,4,2,1,0,3,5,0
Paraguay,1930,FIFA World Cup,1,3,1,1,0,2,-2,0
Paraguay,1931,Copa Chevallier Boutell,2,4,0,1,1,2,-2,0
Paraguay,1931,Friendly,1,2,0,1,1,2,-1,0
Paraguay,1937,Copa América,8,16,2,3,0,5,-8,0
Paraguay,1939,Copa América,9,8,2,2,0,4,1,0
Paraguay,1939,Copa Chevallier Boutell,2,3,0,1,1,2,-1,0
Paraguay,1939,Friendly,1,4,0,1,0,1,-3,0
Paraguay,1940,Copa Chevallier Boutell,1,7,0,2,0,2,-6,0
Paraguay,1942,Copa América,11,10,2,2,2,6,1,0
Paraguay,1943,Copa Chevallier Boutell,4,6,1,1,0,2,-2,1
Paraguay,1945,Copa Chevallier Boutell,11,14,1,3,0,4,-3,0
Paraguay,1946,Copa América,8,8,2,2,1,5,0,0
Paraguay,1947,Copa América,16,11,5,1,1,7,5,0
Paraguay,1949,Copa América,21,13,6,2,0,8,8,0
Paraguay,1950,Copa Chevallier Boutell,2,6,0,1,1,2,-4,0
Paraguay,1950,Copa Oswaldo Cruz,3,5,0,1,1,2,-2,0
Paraguay,1950,FIFA World Cup,2,4,0,1,1,2,-2,0
Paraguay,1950,Friendly,3,2,1,0,0,1,1,0
Paraguay,1953,Copa América,14,8,4,0,3,7,6,1
Paraguay,1954,FIFA World Cup qualification,8,6,2,2,0,4,2,0
Paraguay,1954,Friendly,5,2,1,0,1,2,3,0
Paraguay,1955,Copa América,7,14,1,3,1,5,-7,0
Paraguay,1955,Copa Oswaldo Cruz,3,6,0,1,1,2,-3,0
Paraguay,1956,Copa América,3,8,0,3,2,5,-5,0
Paraguay,1956,Copa Chevallier Boutell,0,1,0,1,0,1,-1,0
Paraguay,1956,Copa Oswaldo Cruz,2,7,0,2,0,2,-5,0
Paraguay,1956,Friendly,2,2,0,0,1,1,0,0
Paraguay,1957,Copa Paz del Chaco,9,8,1,2,1,4,1,0
Paraguay,1957,FIFA World Cup qualification,11,4,3,1,0,4,7,0
Paraguay,1957,Friendly,2,1,1,0,0,1,1,0
Paraguay,1958,Copa Oswaldo Cruz,1,5,0,1,1,2,-4,0
Paraguay,1958,FIFA World Cup,9,12,1,1,1,3,-3,0
Paraguay,1958,Friendly,1,2,1,1,0,2,-1,0
Paraguay,1959,Copa América,18,23,3,6,1,10,-5,0
Paraguay,1959,Friendly,3,1,1,0,0,1,2,0
Paraguay,1960,Atlantic Cup,2,5,0,3,0,3,-3,0
Paraguay,1960,Friendly,2,7,0,2,0,2,-5,0
Paraguay,1961,Copa Oswaldo Cruz,2,5,0,2,0,2,-3,0
Paraguay,1961,FIFA World Cup qualification,0,1,0,1,1,2,-1,0
Paraguay,1961,Friendly,3,8,0,2,2,4,-5,0
Paraguay,1962,Copa Oswaldo Cruz,0,10,0,2,0,2,-10,0
Paraguay,1962,Copa Paz del Chaco,3,6,0,2,0,2,-3,0
Paraguay,1963,Copa América,13,7,4,1,1,6,6,0
Paraguay,1963,Copa Chevallier Boutell,3,6,1,1,0,2,-3,1
Paraguay,1963,Copa Paz del Chaco,8,1,2,0,0,2,7,1
Paraguay,1963,Friendly,2,2,0,0,1,1,0,0
Paraguay,1964,Copa Chevallier Boutell,4,8,1,1,0,2,-4,0
Paraguay,1965,Copa Artigas,2,5,1,1,0,2,-3,0
Paraguay,1965,FIFA World Cup qualification,3,5,1,2,1,4,-2,0
Paraguay,1965,Friendly,8,2,3,1,1,5,6,0
Paraguay,1966,Copa América qualification,5,3,1,0,1,2,2,1
Paraguay,1966,Copa Artigas,3,5,0,1,1,2,-2,0
Paraguay,1966,Friendly,0,7,0,1,0,1,-7,0
Paraguay,1967,Copa América,9,13,2,3,0,5,-4,0
Paraguay,1967,Friendly,1,1,0,0,1,1,0,0
Paraguay,1968,Copa Artigas,0,0,0,0,1,1,0,0
Paraguay,1968,Copa Oswaldo Cruz,1,4,1,1,0,2,-3,1
Paraguay,1968,Friendly,2,0,1,0,0,1,2,0
Paraguay,1969,FIFA World Cup qualification,6,5,4,2,0,6,1,0
Paraguay,1969,Friendly,3,6,0,3,3,6,-3,0
Paraguay,1970,Friendly,1,1,0,0,2,2,0,0
Paraguay,1971,Copa Chevallier Boutell,1,2,0,1,1,2,-1,0
Paraguay,1971,Friendly,6,4,2,2,1,5,2,0
Paraguay,1972,Brazil Independence Cup,12,4,3,1,0,4,8,0
Paraguay,1972,Friendly,2,3,0,1,1,2,-1,0
Paraguay,1973,FIFA World Cup qualification,8,5,2,1,1,4,3,0
Paraguay,1973,Friendly,2,3,0,1,2,3,-1,0
Paraguay,1974,Friendly,0,3,0,2,0,2,-3,0
Paraguay,1975,Copa América,5,5,1,2,1,4,0,0
Paraguay,1975,Copa Artigas,1,1,1,1,0,2,0,1
Paraguay,1975,Friendly,2,3,1,1,0,2,-1,0
Paraguay,1976,Atlantic Cup,3,2,1,0,1,2,1,1
Paraguay,1976,Copa Félix Bogado,4,5,0,1,1,2,-1,0
Paraguay,1976,Copa Oswaldo Cruz,2,4,0,1,1,2,-2,0
Paraguay,1977,Copa Artigas,2,3,0,1,1,2,-1,0
Paraguay,1977,Copa Félix Bogado,3,2,1,1,0,2,1,1
Paraguay,1977,Copa Paz del Chaco,3,2,1,0,1,2,1,0
Paraguay,1977,FIFA World Cup qualification,3,3,1,1,2,4,0,0
Paraguay,1977,Friendly,9,6,3,2,0,5,3,0
Paraguay,1979,Copa América,13,7,4,1,4,9,6,0
Paraguay,1979,Copa Paz del Chaco,3,3,1,1,0,2,0,1
Paraguay,1979,Friendly,4,9,1,1,1,3,-5,0
Paraguay,1980,Copa Paz del Chaco,3,2,1,0,1,2,1,1
Paraguay,1980,Friendly,4,9,1,2,0,3,-5,0
Paraguay,1981,FIFA World Cup qualification,3,6,1,3,0,4,-3,0
Paraguay,1981,Friendly,0,2,0,1,0,1,-2,0
Paraguay,1983,Copa América,1,1,0,0,2,2,0,0
Paraguay,1983,Copa Artigas,0,3,0,1,1,2,-3,0
Paraguay,1983,Copa Félix Bogado,1,0,1,0,1,2,1,0
Paraguay,1983,Friendly,13,7,4,2,1,7,6,0
Paraguay,1985,Copa Artigas,1,4,0,2,0,2,-3,0
Paraguay,1985,FIFA World Cup qualification,14,8,3,2,3,8,6,0
Paraguay,1985,Friendly,5,9,2,3,3,8,-4,0
Paraguay,1986,FIFA World Cup,4,6,1,1,2,4,-2,0
Paraguay,1986,Friendly,9,4,3,0,3,6,5,0
Paraguay,1986,Lunar New Year Cup,3,1,1,0,0,1,2,1
Paraguay,1986,Miami Cup,4,1,1,0,0,1,3,1
Paraguay,1987,Copa América,0,3,0,1,1,2,-3,0
Paraguay,1987,Friendly,3,0,2,0,0,2,3,0
Paraguay,1988,Friendly,13,4,5,1,1,7,9,0
Paraguay,1989,Copa América,9,10,3,3,1,7,-1,0
Paraguay,1989,FIFA World Cup qualification,6,7,2,2,0,4,-1,0
Paraguay,1989,Friendly,21,12,7,2,4,13,9,0
Paraguay,1991,Copa América,7,8,2,2,0,4,-1,0
Paraguay,1991,Copa Paz del Chaco,1,0,1,0,1,2,1,0
Paraguay,1991,Friendly,1,1,0,0,1,1,0,0
Paraguay,1993,Copa América,2,7,1,2,1,4,-5,0
Paraguay,1993,Copa Paz del Chaco,2,2,1,1,0,2,0,0
Paraguay,1993,FIFA World Cup qualification,6,7,1,1,4,6,-1,0
Paraguay,1993,Friendly,1,5,0,2,0,2,-4,0
Paraguay,1995,Copa América,6,5,2,1,1,4,1,0
Paraguay,1995,Copa Paz del Chaco,1,1,0,0,2,2,0,0
Paraguay,1995,Friendly,9,6,4,1,1,6,3,0
Paraguay,1996,FIFA World Cup qualification,6,3,3,1,2,6,3,0
Paraguay,1996,Friendly,9,6,3,2,0,5,3,0
Paraguay,1997,Copa América,2,5,1,2,1,4,-3,0
Paraguay,1997,FIFA World Cup qualification,15,11,6,4,0,10,4,0
Paraguay,1997,Friendly,2,0,1,0,1,2,2,0
Paraguay,1998,FIFA World Cup,3,2,1,1,2,4,1,0
Paraguay,1998,Friendly,12,16,1,4,3,8,-4,0
Paraguay,1998,Kirin Cup,1,2,0,1,1,2,-1,0
Paraguay,1999,Copa América,6,1,2,0,2,4,5,0
Paraguay,1999,Copa Paz del Chaco,0,0,0,0,1,1,0,0
Paraguay,1999,Friendly,17,15,7,4,1,12,2,0
Paraguay,2000,FIFA World Cup qualification,18,9,6,2,2,10,9,0
Paraguay,2000,Friendly,2,2,1,1,2,4,0,0
Paraguay,2001,Copa América,4,6,0,1,2,3,-2,0
Paraguay,2001,FIFA World Cup qualification,11,14,3,4,1,8,-3,0
Paraguay,2001,Kirin Cup,2,2,1,1,0,2,0,0
Paraguay,2001,Lunar New Year Cup,1,1,0,0,1,1,0,0
Paraguay,2002,FIFA World Cup,6,7,1,2,1,4,-1,0
Paraguay,2002,Friendly,7,9,2,1,4,7,-2,0
Paraguay,2003,FIFA World Cup qualification,8,6,3,1,0,4,2,0
Paraguay,2003,Friendly,7,9,3,3,3,9,-2,0
Paraguay,2003,Kirin Cup,0,0,0,0,1,1,0,0
Paraguay,2004,Copa América,5,5,2,1,1,4,0,0
Paraguay,2004,FIFA World Cup qualification,4,5,1,2,4,7,-1,0
Paraguay,2004,Friendly,0,0,0,0,1,1,0,0
Paraguay,2005,FIFA World Cup qualification,11,12,4,3,0,7,-1,0
Paraguay,2005,Friendly,11,6,3,1,2,6,5,0
Paraguay,2006,FIFA World Cup,2,2,1,2,0,3,0,0
Paraguay,2006,Friendly,8,9,1,2,4,7,-1,0
Paraguay,2007,Copa América,8,8,2,2,0,4,0,0
Paraguay,2007,FIFA World Cup qualification,9,1,3,0,1,4,8,0
Paraguay,2007,Friendly,5,9,1,4,3,8,-4,0
Paraguay,2008,FIFA World Cup qualification,9,5,4,1,1,6,4,0
Paraguay,2008,Friendly,2,6,1,2,2,5,-4,0
Paraguay,2008,Kirin Cup,1,1,0,0,2,2,0,0
Paraguay,2009,FIFA World Cup qualification,6,10,3,4,1,8,-4,0
Paraguay,2009,Friendly,2,5,1,3,1,5,-3,0
Paraguay,2010,FIFA World Cup,3,2,1,1,3,5,1,0
Paraguay,2010,Friendly,19,8,5,3,3,11,11,0
Paraguay,2011,Copa América,5,8,0,1,5,6,-3,0
Paraguay,2011,Copa Paz del Chaco,2,0,1,0,1,2,2,0
Paraguay,2011,FIFA World Cup qualification,3,6,1,2,1,4,-3,0
Paraguay,2011,Friendly,13,10,4,3,1,8,3,0
Paraguay,2012,FIFA World Cup qualification,3,10,1,4,0,5,-7,0
Paraguay,2012,Friendly,12,5,5,0,1,6,7,0
Paraguay,2013,FIFA World Cup qualification,11,15,1,4,2,7,-4,0
Paraguay,2013,Friendly,3,3,0,0,1,1,0,0
Paraguay,2014,Friendly,7,9,2,3,2,7,-2,0
Paraguay,2015,Copa América,6,12,1,2,3,6,-6,0
Paraguay,2015,FIFA World Cup qualification,3,2,2,1,1,4,1,0
Paraguay,2015,Friendly,4,5,0,1,1,2,-1,0
Paraguay,2016,Copa América,1,3,0,2,1,3,-2,0
Paraguay,2016,FIFA World Cup qualification,8,15,2,4,2,8,-7,0
Paraguay,2016,Friendly,0,1,0,1,0,1,-1,0
Paraguay,2017,FIFA World Cup qualification,8,8,3,3,0,6,0,0
Paraguay,2017,Friendly,1,8,0,3,0,3,-7,0
Paraguay,2018,Friendly,3,6,0,2,1,3,-3,0
Paraguay,2019,Copa América,3,4,0,1,3,4,-1,0
Paraguay,2019,Friendly,11,10,3,3,3,9,1,0
Paraguay,2019,Kirin Challenge Cup,0,2,0,1,0,1,-2,0
Paraguay,2020,FIFA World Cup qualification,6,5,1,0,3,4,1,0
Paraguay,2021,Copa América,8,6,2,2,1,5,2,0
Paraguay,2021,FIFA World Cup qualification,3,13,1,5,4,10,-10,0
Paraguay,2022,FIFA World Cup qualification,3,8,1,3,0,4,-5,0
Paraguay,2022,Friendly,5,9,2,3,2,7,-4,0
Paraguay,2023,FIFA World Cup qualification,1,3,1,3,2,6,-2,0
Paraguay,2023,Friendly,4,3,1,1,0,2,1,0
Paraguay,2024,Copa América,3,8,0,3,0,3,-5,0
Paraguay,2024,FIFA World Cup qualification,7,4,3,0,3,6,3,0
Paraguay,2024,Friendly,1,3,1,1,1,3,-2,0
Paraguay,2025,FIFA World Cup qualification,3,2,1,0,1,2,1,0
Parishes of Jersey,2018,Friendly,2,1,1,0,0,1,1,0
Parishes of Jersey,2019,Atlantic Heritage Cup,9,3,1,1,0,2,6,1
Peru,1927,Copa América,4,11,1,2,0,3,-7,0
Peru,1929,Copa América,1,12,0,3,0,3,-11,0
Peru,1930,FIFA World Cup,1,4,0,2,0,2,-3,0
Peru,1935,Copa América,2,5,1,2,0,3,-3,0
Peru,1936,Copa América,2,3,0,1,0,1,-1,0
Peru,1937,Copa América,5,7,1,2,1,4,-2,0
Peru,1938,Bolivarian Games,18,4,4,0,0,4,14,0
Peru,1939,Copa América,13,4,4,0,0,4,9,1
Peru,1941,Copa América,5,5,1,3,0,4,0,0
Peru,1941,Friendly,2,5,0,1,2,3,-3,0
Peru,1942,Copa América,5,10,1,3,2,6,-5,0
Peru,1947,Copa América,12,9,2,3,2,7,3,0
Peru,1949,Copa América,20,13,5,2,0,7,7,0
Peru,1952,Pan American Championship,14,9,2,2,1,5,5,0
Peru,1953,Copa América,4,6,2,2,2,6,-2,0
Peru,1953,Copa del Pacífico,6,2,1,1,0,2,4,1
Peru,1954,Copa del Pacífico,5,4,1,1,0,2,1,1
Peru,1955,Copa América,13,11,2,1,2,5,2,1
Peru,1956,Copa América,6,11,0,4,1,5,-5,0
Peru,1956,Pan American Championship,6,7,1,2,2,5,-1,0
Peru,1957,Copa América,12,9,4,2,0,6,3,1
Peru,1957,FIFA World Cup qualification,1,2,0,1,1,2,-1,0
Peru,1957,Friendly,1,4,0,1,0,1,-3,0
Peru,1959,Copa América,10,11,1,2,3,6,-1,0
Peru,1959,Friendly,4,1,1,0,0,1,3,0
Peru,1960,Friendly,1,3,0,1,0,1,-2,0
Peru,1961,FIFA World Cup qualification,1,2,0,1,1,2,-1,0
Peru,1961,Friendly,2,5,0,1,0,1,-3,0
Peru,1962,Friendly,0,4,0,1,0,1,-4,0
Peru,1963,Copa América,8,11,2,3,1,6,-3,0
Peru,1965,Copa del Pacífico,1,5,0,2,0,2,-4,0
Peru,1965,FIFA World Cup qualification,8,6,2,2,0,4,2,0
Peru,1965,Friendly,0,1,0,1,0,1,-1,0
Peru,1966,Friendly,1,7,0,2,0,2,-6,0
Peru,1967,Friendly,2,3,1,2,1,4,-1,0
Peru,1968,Copa del Pacífico,1,2,0,1,1,2,-1,0
Peru,1968,Friendly,9,14,0,2,3,5,-5,0
Peru,1969,FIFA World Cup qualification,7,4,2,1,1,4,3,0
Peru,1969,Friendly,17,13,6,3,1,10,4,0
Peru,1970,FIFA World Cup,9,9,2,2,0,4,0,0
Peru,1970,Friendly,17,21,4,6,3,13,-4,0
Peru,1971,Copa del Pacífico,1,1,1,1,0,2,0,0
Peru,1971,Friendly,0,2,0,1,1,2,-2,0
Peru,1972,Brazil Independence Cup,5,3,2,2,0,4,2,0
Peru,1972,Copa Ramón Castilla,0,2,0,1,0,1,-2,0
Peru,1972,Friendly,7,14,1,4,3,8,-7,0
Peru,1973,Copa Ramón Castilla,1,3,0,1,0,1,-2,0
Peru,1973,FIFA World Cup qualification,3,4,1,2,0,3,-1,0
Peru,1973,Friendly,16,5,5,1,1,7,11,0
Peru,1975,Copa América,14,7,6,2,1,9,7,1
Peru,1975,Friendly,4,7,2,2,0,4,-3,0
Peru,1976,Copa Ramón Castilla,1,4,0,2,0,2,-3,0
Peru,1976,Friendly,0,0,0,0,2,2,0,0
Peru,1977,FIFA World Cup qualification,13,3,3,1,2,6,10,0
Peru,1977,Friendly,10,11,2,2,2,6,-1,0
Peru,1978,Copa Ramón Castilla,2,5,0,2,0,2,-3,0
Peru,1978,FIFA World Cup,7,12,2,3,1,6,-5,0
Peru,1978,Friendly,4,5,2,1,1,4,-1,0
Peru,1979,Copa América,1,2,0,1,1,2,-1,0
Peru,1979,Friendly,10,10,3,4,1,8,0,0
Peru,1980,Friendly,1,1,0,0,2,2,0,0
Peru,1981,FIFA World Cup qualification,5,2,2,0,2,4,3,0
Peru,1981,Friendly,3,10,0,4,0,4,-7,0
Peru,1982,Copa del Pacífico,1,0,1,0,0,1,1,1
Peru,1982,FIFA World Cup,2,6,0,1,2,3,-4,0
Peru,1982,Friendly,7,4,3,1,1,5,3,0
Peru,1983,Copa América,7,6,2,1,3,6,1,0
Peru,1983,Copa del Pacífico,0,3,0,2,0,2,-3,0
Peru,1983,Friendly,3,8,0,2,2,4,-5,0
Peru,1984,Friendly,3,9,0,3,2,5,-6,0
Peru,1985,FIFA World Cup qualification,10,9,3,3,2,8,1,0
Peru,1985,Friendly,12,7,5,2,4,11,5,0
Peru,1986,Friendly,0,4,0,1,0,1,-4,0
Peru,1986,Nehru Cup,2,3,1,1,0,2,-1,1
Peru,1987,Copa América,2,2,0,0,2,2,0,0
Peru,1987,Friendly,3,4,1,2,0,3,-1,0
Peru,1988,Copa del Pacífico,1,3,0,1,1,2,-2,0
Peru,1988,Friendly,1,7,0,3,0,3,-6,0
Peru,1989,Copa América,4,7,0,1,3,4,-3,0
Peru,1989,FIFA World Cup qualification,2,8,0,4,0,4,-6,0
Peru,1989,Friendly,10,16,2,5,3,10,-6,0
Peru,1989,Marlboro Cup,0,3,0,1,0,1,-3,0
Peru,1991,Copa América,9,9,1,3,0,4,0,0
Peru,1991,Friendly,3,3,1,1,2,4,0,0
Peru,1992,Friendly,1,1,0,0,1,1,0,0
Peru,1993,Copa América,4,5,1,1,2,4,-1,0
Peru,1993,FIFA World Cup qualification,4,12,0,5,1,6,-8,0
Peru,1993,Friendly,7,11,2,4,4,10,-4,0
Peru,1994,Friendly,3,3,1,2,2,5,0,0
Peru,1994,Miami Cup,1,3,0,2,0,2,-2,0
Peru,1995,Copa América,2,5,0,2,1,3,-3,0
Peru,1995,Friendly,11,3,3,2,0,5,8,0
Peru,1996,FIFA World Cup qualification,6,8,1,2,3,6,-2,0
Peru,1996,Friendly,12,10,3,3,0,6,2,0
Peru,1997,Copa América,5,11,3,3,0,6,-6,0
Peru,1997,FIFA World Cup qualification,13,12,6,3,1,10,1,0
Peru,1997,Friendly,2,1,1,0,0,1,1,0
Peru,1997,USA Cup,1,0,1,0,1,2,1,0
Peru,1998,Friendly,0,3,0,2,0,2,-3,0
Peru,1999,Copa América,7,6,2,1,1,4,1,0
Peru,1999,Friendly,11,10,3,2,2,7,1,0
Peru,1999,Kirin Cup,1,1,0,0,2,2,0,0
Peru,2000,FIFA World Cup qualification,7,13,2,6,2,10,-6,0
Peru,2000,Gold Cup,7,7,1,2,1,4,0,0
Peru,2001,Copa América,4,8,1,2,1,4,-4,0
Peru,2001,FIFA World Cup qualification,7,12,2,4,2,8,-5,0
Peru,2001,Friendly,0,0,0,0,1,1,0,0
Peru,2003,FIFA World Cup qualification,6,4,1,1,2,4,2,0
Peru,2003,Friendly,19,13,5,4,2,11,6,0
Peru,2004,Copa América,7,6,1,1,2,4,1,0
Peru,2004,FIFA World Cup qualification,7,9,2,3,2,7,-2,0
Peru,2004,Friendly,3,5,0,2,1,3,-2,0
Peru,2005,FIFA World Cup qualification,7,15,1,4,2,7,-8,0
Peru,2005,Friendly,3,1,1,0,0,1,2,0
Peru,2005,Kirin Cup,1,0,1,0,1,2,1,0
Peru,2006,Copa del Pacífico,2,4,0,2,0,2,-2,0
Peru,2006,Friendly,5,6,1,1,3,5,-1,0
Peru,2007,Copa América,5,8,1,2,1,4,-3,0
Peru,2007,FIFA World Cup qualification,2,8,0,2,2,4,-6,0
Peru,2007,Friendly,7,8,2,2,2,6,-1,0
Peru,2008,FIFA World Cup qualification,3,12,1,3,2,6,-9,0
Peru,2008,Friendly,5,9,1,3,0,4,-4,0
Peru,2009,FIFA World Cup qualification,6,14,2,6,0,8,-8,0
Peru,2009,Friendly,2,3,1,2,0,3,-1,0
Peru,2010,Friendly,7,3,3,1,1,5,4,0
Peru,2011,Copa América,8,5,3,2,1,6,3,0
Peru,2011,FIFA World Cup qualification,4,6,1,2,0,3,-2,0
Peru,2011,Friendly,4,2,2,0,3,5,2,0
Peru,2011,Kirin Cup,0,0,0,0,2,2,0,0
Peru,2012,Copa del Pacífico,1,6,0,2,0,2,-5,0
Peru,2012,FIFA World Cup qualification,6,9,1,3,2,6,-3,0
Peru,2012,Friendly,3,1,2,0,2,4,2,0
Peru,2013,FIFA World Cup qualification,7,11,2,4,1,7,-4,0
Peru,2013,Friendly,7,7,3,1,2,6,0,0
Peru,2014,Friendly,11,11,5,4,0,9,0,0
Peru,2015,Copa América,8,5,3,2,1,6,3,0
Peru,2015,FIFA World Cup qualification,4,9,1,3,0,4,-5,0
Peru,2015,Friendly,3,5,0,2,2,4,-2,0
Peru,2016,Copa América,4,2,2,0,2,4,2,0
Peru,2016,FIFA World Cup qualification,14,11,3,3,2,8,3,0
Peru,2016,Friendly,7,1,2,0,0,2,6,0
Peru,2017,FIFA World Cup qualification,11,6,4,0,4,8,5,0
Peru,2017,Friendly,4,1,2,0,0,2,3,0
Peru,2018,FIFA World Cup,2,2,1,2,0,3,0,0
Peru,2018,Friendly,18,11,5,4,2,11,7,0
Peru,2019,Copa América,7,9,2,2,2,6,-2,0
Peru,2019,Friendly,4,9,3,5,1,9,-5,0
Peru,2020,FIFA World Cup qualification,4,10,0,3,1,4,-6,0
Peru,2021,Copa América,10,14,2,3,2,7,-4,0
Peru,2021,FIFA World Cup qualification,11,10,5,4,1,10,1,0
Peru,2022,FIFA World Cup qualification,4,2,2,1,2,5,2,0
Peru,2022,Friendly,11,3,5,1,1,7,8,0
Peru,2023,FIFA World Cup qualification,1,8,0,4,2,6,-7,0
Peru,2023,Friendly,2,6,1,2,1,4,-4,0
Peru,2024,Copa América,0,3,0,2,1,3,-3,0
Peru,2024,FIFA World Cup qualification,2,7,1,3,2,6,-5,0
Peru,2024,Friendly,7,1,3,0,1,4,6,0
Peru,2025,FIFA World Cup qualification,3,2,1,1,0,2,1,0
Philippines,1913,Far Eastern Championship Games,2,1,1,0,0,1,1,1
Philippines,1915,Far Eastern Championship Games,0,1,0,1,1,2,-1,0
Philippines,1917,Far Eastern Championship Games,15,5,1,1,0,2,10,0
Philippines,1917,Friendly,15,2,1,0,0,1,13,0
Philippines,1919,Far Eastern Championship Games,3,5,1,2,0,3,-2,0
Philippines,1921,Far Eastern Championship Games,3,2,1,1,0,2,1,0
Philippines,1921,Friendly,3,0,1,0,0,1,3,0
Philippines,1923,Far Eastern Championship Games,2,4,1,1,0,2,-2,0
Philippines,1923,Friendly,0,3,0,1,0,1,-3,0
Philippines,1925,Far Eastern Championship Games,5,5,1,1,0,2,0,0
Philippines,1925,Friendly,1,5,0,1,0,1,-4,0
Philippines,1927,Far Eastern Championship Games,2,5,0,2,0,2,-3,0
Philippines,1927,Friendly,2,5,0,2,0,2,-3,0
Philippines,1930,Far Eastern Championship Games,2,12,0,2,0,2,-10,0
Philippines,1930,Friendly,0,5,0,1,0,1,-5,0
Philippines,1934,Far Eastern Championship Games,6,8,1,2,0,3,-2,0
Philippines,1934,Friendly,3,4,1,1,0,2,-1,0
Philippines,1940,Friendly,0,1,0,1,0,1,-1,0
Philippines,1953,Friendly,1,3,0,1,0,1,-2,0
Philippines,1954,Asian Games,2,7,0,2,0,2,-5,0
Philippines,1956,AFC Asian Cup qualification,0,5,0,2,0,2,-5,0
Philippines,1956,Friendly,0,4,0,1,0,1,-4,0
Philippines,1958,Asian Games,4,9,1,2,0,3,-5,0
Philippines,1958,Friendly,1,5,0,2,0,2,-4,0
Philippines,1959,AFC Asian Cup qualification,4,14,0,2,0,2,-10,0
Philippines,1962,Asian Games,1,27,0,3,0,3,-26,0
Philippines,1962,Merdeka Tournament,0,20,0,3,0,3,-20,0
Philippines,1963,Friendly,0,7,0,1,0,1,-7,0
Philippines,1967,AFC Asian Cup qualification,0,15,0,3,0,3,-15,0
Philippines,1971,Friendly,0,1,0,1,0,1,-1,0
Philippines,1971,Merdeka Tournament,10,17,1,4,1,6,-7,0
Philippines,1972,Friendly,1,13,0,3,0,3,-12,0
Philippines,1972,Indonesia Tournament,3,0,2,0,0,2,3,0
Philippines,1972,Korea Cup,0,10,0,3,0,3,-10,0
Philippines,1972,Merdeka Tournament,7,13,1,3,1,5,-6,0
Philippines,1974,Asian Games,0,21,0,3,0,3,-21,0
Philippines,1977,Southeast Asian Games,5,7,1,1,1,3,-2,0
Philippines,1978,AFC Asian Cup qualification,0,8,0,2,0,2,-8,0
Philippines,1981,Indonesia Tournament,0,3,0,1,0,1,-3,0
Philippines,1981,Southeast Asian Games,0,6,0,2,0,2,-6,0
Philippines,1982,King's Cup,0,1,0,1,0,1,-1,0
Philippines,1983,Southeast Asian Games,0,5,0,1,1,2,-5,0
Philippines,1984,AFC Asian Cup qualification,3,16,0,5,0,5,-13,0
Philippines,1985,Friendly,1,4,0,1,0,1,-3,0
Philippines,1985,Southeast Asian Games,0,13,0,2,0,2,-13,0
Philippines,1989,Southeast Asian Games,1,10,0,3,0,3,-9,0
Philippines,1991,Friendly,2,1,1,0,0,1,1,0
Philippines,1991,Southeast Asian Games,6,12,1,3,1,5,-6,0
Philippines,1993,Southeast Asian Games,1,11,0,3,0,3,-10,0
Philippines,1995,Southeast Asian Games,2,9,1,3,0,4,-7,0
Philippines,1996,AFC Asian Cup qualification,1,20,0,3,0,3,-19,0
Philippines,1996,AFF Championship,0,16,0,4,0,4,-16,0
Philippines,1996,FIFA World Cup qualification,0,10,0,3,0,3,-10,0
Philippines,1997,Friendly,0,1,0,1,0,1,-1,0
Philippines,1997,Southeast Asian Games,1,13,0,4,0,4,-12,0
Philippines,1998,AFF Championship,3,11,0,3,0,3,-8,0
Philippines,1998,AFF Championship qualification,1,2,0,1,1,2,-1,0
Philippines,1999,Southeast Asian Games,3,18,0,4,0,4,-15,0
Philippines,2000,AFC Asian Cup qualification,2,11,1,2,0,3,-9,0
Philippines,2000,AFF Championship,0,8,0,3,0,3,-8,0
Philippines,2001,FIFA World Cup qualification,2,29,0,5,1,6,-27,0
Philippines,2001,Friendly,0,3,0,1,0,1,-3,0
Philippines,2002,AFF Championship,3,24,0,4,0,4,-21,0
Philippines,2002,Friendly,0,2,0,1,0,1,-2,0
Philippines,2004,AFF Championship,4,9,1,3,0,4,-5,0
Philippines,2006,AFC Challenge Cup,1,1,0,0,1,1,0,0
Philippines,2006,AFF Championship qualification,13,3,3,1,0,4,10,0
Philippines,2006,Friendly,0,5,0,1,0,1,-5,0
Philippines,2007,AFF Championship,0,8,0,2,1,3,-8,0
Philippines,2007,Friendly,1,4,0,1,0,1,-3,0
Philippines,2008,AFC Challenge Cup qualification,4,0,2,0,1,3,4,0
Philippines,2008,AFF Championship qualification,6,5,2,1,1,4,1,0
Philippines,2009,AFC Challenge Cup qualification,3,8,1,2,0,3,-5,0
Philippines,2010,AFF Championship,3,3,1,2,2,5,0,0
Philippines,2010,AFF Championship qualification,7,2,1,0,2,3,5,0
Philippines,2010,Dragon Cup,5,0,1,0,0,1,5,1
Philippines,2011,AFC Challenge Cup qualification,7,3,2,1,2,5,4,0
Philippines,2011,Dragon Cup,5,3,1,0,1,2,2,1
Philippines,2011,FIFA World Cup qualification,6,6,1,2,1,4,0,0
Philippines,2011,Friendly,4,2,1,1,0,2,2,0
Philippines,2012,AFC Challenge Cup,9,8,3,2,0,5,1,0
Philippines,2012,AFF Championship,4,3,2,2,1,5,1,0
Philippines,2012,Friendly,20,8,6,2,5,13,12,0
Philippines,2013,AFC Challenge Cup qualification,9,0,2,0,0,2,9,1
Philippines,2013,Friendly,7,10,3,3,1,7,-3,0
Philippines,2014,AFC Challenge Cup,7,3,3,1,1,5,4,0
Philippines,2014,AFF Championship,9,7,2,2,1,5,2,0
Philippines,2014,Friendly,18,8,4,3,2,9,10,0
Philippines,2015,FIFA World Cup qualification,5,9,2,3,1,6,-4,0
Philippines,2015,Friendly,3,2,1,1,0,2,1,0
Philippines,2016,AFF Championship,2,3,0,1,2,3,-1,0
Philippines,2016,FIFA World Cup qualification,3,3,1,1,0,2,0,0
Philippines,2016,Friendly,5,7,2,2,0,4,-2,0
Philippines,2017,AFC Asian Cup qualification,11,7,2,0,3,5,4,0
Philippines,2017,Friendly,4,13,1,3,1,5,-9,0
Philippines,2018,AFC Asian Cup qualification,2,1,1,0,0,1,1,0
Philippines,2018,AFF Championship,7,7,2,2,2,6,0,0
Philippines,2018,Friendly,7,8,1,1,2,4,-1,0
Philippines,2019,AFC Asian Cup,1,7,0,3,0,3,-6,0
Philippines,2019,FIFA World Cup qualification,8,8,2,2,1,5,0,0
Philippines,2019,Friendly,0,2,0,1,0,1,-2,0
Philippines,2021,AFF Championship,12,6,2,2,0,4,6,0
Philippines,2021,FIFA World Cup qualification,4,3,1,1,1,3,1,0
Philippines,2022,AFC Asian Cup qualification,1,4,1,1,1,3,-3,0
Philippines,2022,AFF Championship,7,8,1,2,0,3,-1,0
Philippines,2022,Friendly,0,5,0,3,0,3,-5,0
Philippines,2023,AFF Championship,1,2,0,1,0,1,-1,0
Philippines,2023,FIFA World Cup qualification,1,3,0,1,1,2,-2,0
Philippines,2023,Friendly,7,12,3,4,1,8,-5,0
Philippines,2024,ASEAN Championship,7,7,2,1,3,6,0,0
Philippines,2024,FIFA World Cup qualification,2,11,0,4,0,4,-9,0
Philippines,2024,Friendly,1,3,0,1,0,1,-2,0
Philippines,2024,Merdeka Tournament,1,2,0,1,1,2,-1,0
Philippines,2025,AFC Asian Cup qualification,4,1,1,0,0,1,3,0
Poland,1921,Friendly,0,1,0,1,0,1,-1,0
Poland,1922,Friendly,6,6,2,1,1,4,0,0
Poland,1923,Friendly,11,11,1,2,2,5,0,0
Poland,1924,Friendly,6,12,2,3,0,5,-6,0
Poland,1924,Olympic Games,0,5,0,1,0,1,-5,0
Poland,1925,Friendly,6,11,1,2,2,5,-5,0
Poland,1926,Friendly,21,12,4,2,0,6,9,0
Poland,1927,Friendly,3,3,0,0,1,1,0,0
Poland,1928,Friendly,7,7,1,1,1,3,0,0
Poland,1930,Friendly,9,0,2,0,0,2,9,0
Poland,1931,Friendly,14,12,2,3,0,5,2,0
Poland,1932,Friendly,12,1,4,0,0,4,11,0
Poland,1933,FIFA World Cup qualification,1,2,0,1,0,1,-1,0
Poland,1933,Friendly,6,6,2,2,0,4,0,0
Poland,1934,Friendly,16,22,1,4,1,6,-6,0
Poland,1935,Friendly,9,16,1,4,1,6,-7,0
Poland,1936,Friendly,10,15,1,2,2,5,-5,0
Poland,1937,FIFA World Cup qualification,4,0,1,0,0,1,4,0
Poland,1937,Friendly,13,10,3,1,1,5,3,0
Poland,1938,FIFA World Cup,5,6,0,1,0,1,-1,0
Poland,1938,FIFA World Cup qualification,0,1,0,1,0,1,-1,0
Poland,1938,Friendly,19,18,1,3,3,7,1,0
Poland,1939,Friendly,8,10,1,1,2,4,-2,0
Poland,1947,Friendly,14,24,1,5,1,7,-10,0
Poland,1948,Balkan Cup,6,9,1,2,2,5,-3,0
Poland,1948,Friendly,1,8,1,1,0,2,-7,0
Poland,1949,Friendly,9,17,2,4,0,6,-8,0
Poland,1950,Friendly,7,12,1,2,2,5,-5,0
Poland,1951,Friendly,0,6,0,1,0,1,-6,0
Poland,1952,Friendly,6,9,1,3,1,5,-3,0
Poland,1953,Friendly,9,10,1,1,3,5,-1,0
Poland,1954,Friendly,3,2,1,0,1,2,1,0
Poland,1955,Friendly,6,4,1,0,2,3,2,0
Poland,1956,Friendly,13,12,2,3,2,7,1,0
Poland,1957,FIFA World Cup qualification,9,7,3,2,0,5,2,0
Poland,1957,Friendly,1,2,0,1,1,2,-1,0
Poland,1958,Friendly,9,13,0,3,3,6,-4,0
Poland,1959,Friendly,11,7,1,1,2,4,4,0
Poland,1959,UEFA Euro qualification,2,7,0,2,0,2,-5,0
Poland,1960,Friendly,11,15,2,2,1,5,-4,0
Poland,1961,FIFA World Cup qualification,2,3,0,1,1,2,-1,0
Poland,1961,Friendly,9,3,3,1,0,4,6,0
Poland,1962,Friendly,11,9,3,3,1,7,2,0
Poland,1962,UEFA Euro qualification,0,4,0,2,0,2,-4,0
Poland,1963,Friendly,20,6,3,1,2,6,14,0
Poland,1964,Friendly,13,10,3,1,1,5,3,0
Poland,1965,FIFA World Cup qualification,11,10,2,2,2,6,1,0
Poland,1965,Friendly,1,1,0,0,2,2,0,0
Poland,1966,Friendly,9,17,0,5,5,10,-8,0
Poland,1966,UEFA Euro qualification,5,2,1,1,0,2,3,0
Poland,1967,Friendly,0,0,0,0,1,1,0,0
Poland,1967,UEFA Euro qualification,8,7,2,1,1,4,1,0
Poland,1968,Friendly,21,11,3,2,3,8,10,0
Poland,1969,FIFA World Cup qualification,19,8,4,2,0,6,11,0
Poland,1969,Friendly,10,3,2,0,1,3,7,0
Poland,1970,Friendly,16,11,5,2,2,9,5,0
Poland,1970,UEFA Euro qualification,3,0,1,0,0,1,3,0
Poland,1971,Friendly,4,2,1,0,0,1,2,0
Poland,1971,UEFA Euro qualification,7,6,1,2,2,5,1,0
Poland,1972,Friendly,5,1,2,0,1,3,4,0
Poland,1973,FIFA World Cup qualification,6,3,2,1,1,4,3,0
Poland,1973,Friendly,22,7,8,2,2,12,15,0
Poland,1974,FIFA World Cup,16,5,6,1,0,7,11,0
Poland,1974,Friendly,12,11,3,3,2,8,1,0
Poland,1974,UEFA Euro qualification,5,1,2,0,0,2,4,0
Poland,1975,Friendly,29,5,6,0,0,6,24,0
Poland,1975,UEFA Euro qualification,4,4,1,1,2,4,0,0
Poland,1976,FIFA World Cup qualification,7,0,2,0,0,2,7,0
Poland,1976,Friendly,2,9,0,5,0,5,-7,0
Poland,1977,FIFA World Cup qualification,10,4,3,0,1,4,6,0
Poland,1977,Friendly,12,17,3,5,1,9,-5,0
Poland,1978,FIFA World Cup,6,6,3,2,1,6,0,0
Poland,1978,Friendly,13,4,5,1,0,6,9,0
Poland,1978,UEFA Euro qualification,4,0,2,0,0,2,4,0
Poland,1979,Friendly,12,2,4,1,1,6,10,0
Poland,1979,UEFA Euro qualification,9,4,3,1,2,6,5,0
Poland,1980,FIFA World Cup qualification,2,0,1,0,0,1,2,0
Poland,1980,Friendly,26,21,6,7,4,17,5,0
Poland,1981,FIFA World Cup qualification,10,2,3,0,0,3,8,0
Poland,1981,Friendly,7,10,2,4,0,6,-3,0
Poland,1982,FIFA World Cup,11,5,3,1,3,7,6,0
Poland,1982,Friendly,4,0,1,0,0,1,4,0
Poland,1982,UEFA Euro qualification,4,4,1,1,0,2,0,0
Poland,1983,Friendly,5,3,1,0,1,2,2,0
Poland,1983,UEFA Euro qualification,2,5,0,2,2,4,-3,0
Poland,1984,FIFA World Cup qualification,5,3,1,0,1,2,2,0
Poland,1984,Friendly,6,5,2,2,3,7,1,0
Poland,1984,Nehru Cup,5,2,3,0,1,4,3,1
Poland,1985,FIFA World Cup qualification,5,3,2,1,1,4,2,0
Poland,1985,Friendly,9,16,3,5,3,11,-7,0
Poland,1986,FIFA World Cup,1,7,1,2,1,4,-6,0
Poland,1986,Friendly,5,8,1,2,2,5,-3,0
Poland,1986,UEFA Euro qualification,2,1,1,0,1,2,1,0
Poland,1987,Friendly,13,6,4,1,0,5,7,0
Poland,1987,UEFA Euro qualification,7,10,2,3,1,6,-3,0
Poland,1988,FIFA World Cup qualification,1,0,1,0,0,1,1,0
Poland,1988,Friendly,17,13,5,2,2,9,4,0
Poland,1989,FIFA World Cup qualification,3,8,1,3,1,5,-5,0
Poland,1989,Friendly,15,8,5,2,1,8,7,0
Poland,1990,Friendly,16,12,4,3,5,12,4,0
Poland,1990,Marlboro Cup,3,2,1,1,0,2,1,1
Poland,1990,UEFA Euro qualification,1,2,1,1,0,2,-1,0
Poland,1991,Friendly,8,18,2,4,4,10,-10,0
Poland,1991,UEFA Euro qualification,7,4,1,0,3,4,3,0
Poland,1992,FIFA World Cup qualification,3,2,1,0,1,2,1,0
Poland,1992,Friendly,10,12,4,2,3,9,-2,0
Poland,1993,FIFA World Cup qualification,7,13,2,5,1,8,-6,0
Poland,1993,Friendly,5,4,1,0,5,6,1,0
Poland,1994,Friendly,13,9,4,1,3,8,4,0
Poland,1994,UEFA Euro qualification,2,2,1,1,1,3,0,0
Poland,1995,Friendly,5,3,1,1,0,2,2,0
Poland,1995,UEFA Euro qualification,12,10,2,2,3,7,2,0
Poland,1996,FIFA World Cup qualification,3,3,1,1,0,2,0,0
Poland,1996,Friendly,5,9,1,3,3,7,-4,0
Poland,1996,Lunar New Year Cup,0,5,0,1,0,1,-5,0
Poland,1997,Cyprus International Tournament,6,4,2,0,1,3,2,1
Poland,1997,FIFA World Cup qualification,7,9,2,3,1,6,-2,0
Poland,1997,Friendly,8,8,2,2,1,5,0,0
Poland,1998,Friendly,13,13,5,3,0,8,0,0
Poland,1998,UEFA Euro qualification,6,0,2,0,0,2,6,0
Poland,1999,Four Nations' Cup,0,0,0,0,1,1,0,0
Poland,1999,Friendly,6,4,3,1,1,5,2,0
Poland,1999,UEFA Euro qualification,6,8,2,3,1,6,-2,0
Poland,2000,FIFA World Cup qualification,6,2,2,0,1,3,4,0
Poland,2000,Friendly,3,8,1,3,3,7,-5,0
Poland,2001,FIFA World Cup qualification,15,9,4,1,2,7,6,0
Poland,2001,Friendly,6,2,1,0,3,4,4,0
Poland,2002,FIFA World Cup,3,7,1,2,0,3,-4,0
Poland,2002,Friendly,11,9,4,3,1,8,2,0
Poland,2002,UEFA Euro qualification,2,1,1,1,0,2,1,0
Poland,2003,Friendly,23,9,7,1,1,9,14,0
Poland,2003,UEFA Euro qualification,9,6,3,2,1,6,3,0
Poland,2004,FIFA World Cup qualification,10,5,3,1,0,4,5,0
Poland,2004,Friendly,12,10,3,3,3,9,2,0
Poland,2005,FIFA World Cup qualification,17,4,5,1,0,6,13,0
Poland,2005,Friendly,18,11,6,1,1,8,7,0
Poland,2006,FIFA World Cup,2,4,1,2,0,3,-2,0
Poland,2006,Friendly,14,10,4,4,1,9,4,0
Poland,2006,UEFA Euro qualification,6,5,3,1,1,5,1,0
Poland,2007,Friendly,8,5,1,1,2,4,3,0
Poland,2007,UEFA Euro qualification,18,7,5,1,3,9,11,0
Poland,2008,FIFA World Cup qualification,6,4,2,1,1,4,2,0
Poland,2008,Friendly,11,8,5,2,2,9,3,0
Poland,2008,UEFA Euro,1,4,0,2,1,3,-3,0
Poland,2009,FIFA World Cup qualification,13,10,1,4,1,6,3,0
Poland,2009,Friendly,6,4,3,2,2,7,2,0
Poland,2010,Friendly,13,19,2,3,6,11,-6,0
Poland,2010,King's Cup,9,2,2,0,0,2,7,1
Poland,2011,Friendly,14,12,6,3,4,13,2,0
Poland,2012,FIFA World Cup qualification,5,3,1,0,2,3,2,0
Poland,2012,Friendly,12,5,5,2,1,8,7,0
Poland,2012,UEFA Euro,2,3,0,1,2,3,-1,0
Poland,2013,FIFA World Cup qualification,13,9,2,3,2,7,4,0
Poland,2013,Friendly,5,6,2,2,1,5,-1,0
Poland,2014,Friendly,8,4,3,1,2,6,4,0
Poland,2014,UEFA Euro qualification,15,2,3,0,1,4,13,0
Poland,2015,Friendly,7,3,2,0,1,3,4,0
Poland,2015,UEFA Euro qualification,18,8,3,1,2,6,10,0
Poland,2016,FIFA World Cup qualification,10,5,3,0,1,4,5,0
Poland,2016,Friendly,8,3,2,1,2,5,5,0
Poland,2016,UEFA Euro,4,2,2,0,3,5,2,0
Poland,2017,FIFA World Cup qualification,18,9,5,1,0,6,9,0
Poland,2017,Friendly,0,1,0,1,1,2,-1,0
Poland,2018,FIFA World Cup,2,5,1,2,0,3,-3,0
Poland,2018,Friendly,10,7,2,2,2,6,3,0
Poland,2018,UEFA Nations League,4,6,0,2,2,4,-2,0
Poland,2019,UEFA Euro qualification,18,5,8,1,1,10,13,0
Poland,2020,Friendly,7,1,2,0,0,2,6,0
Poland,2020,UEFA Nations League,6,6,2,3,1,6,0,0
Poland,2021,FIFA World Cup qualification,30,11,6,2,2,10,19,0
Poland,2021,Friendly,3,3,0,0,2,2,0,0
Poland,2021,UEFA Euro,4,6,0,2,1,3,-2,0
Poland,2022,FIFA World Cup,3,5,1,2,1,4,-2,0
Poland,2022,FIFA World Cup qualification,2,0,1,0,0,1,2,0
Poland,2022,Friendly,2,1,1,0,1,2,1,0
Poland,2022,UEFA Nations League,6,12,2,3,1,6,-6,0
Poland,2023,Friendly,3,0,2,0,0,2,3,0
Poland,2023,UEFA Euro qualification,10,10,3,3,2,8,0,0
Poland,2024,Friendly,5,2,2,0,0,2,3,0
Poland,2024,UEFA Euro,3,6,0,2,1,3,-3,0
Poland,2024,UEFA Euro qualification,5,1,1,0,1,2,4,0
Poland,2024,UEFA Nations League,9,16,1,4,1,6,-7,0
Poland,2025,FIFA World Cup qualification,3,0,2,0,0,2,3,0
Portugal,1921,Friendly,1,3,0,1,0,1,-2,0
Portugal,1922,Friendly,1,2,0,1,0,1,-1,0
Portugal,1923,Friendly,0,3,0,1,0,1,-3,0
Portugal,1925,Friendly,1,0,1,0,0,1,1,0
Portugal,1926,Friendly,5,7,0,1,1,2,-2,0
Portugal,1927,Friendly,5,3,1,1,0,2,2,0
Portugal,1928,Friendly,7,4,1,0,3,4,3,0
Portugal,1928,Olympic Games,7,5,2,1,0,3,2,0
Portugal,1929,Friendly,1,13,0,3,0,3,-12,0
Portugal,1930,Friendly,4,3,2,2,0,4,1,0
Portugal,1931,Friendly,3,4,1,1,0,2,-1,0
Portugal,1932,Friendly,3,2,1,0,0,1,1,0
Portugal,1933,Friendly,1,3,1,1,0,2,-2,0
Portugal,1934,FIFA World Cup qualification,1,11,0,2,0,2,-10,0
Portugal,1935,Friendly,3,3,0,0,1,1,0,0
Portugal,1936,Friendly,3,6,0,2,0,2,-3,0
Portugal,1937,Friendly,2,1,1,0,0,1,1,0
Portugal,1938,FIFA World Cup qualification,1,2,0,1,0,1,-1,0
Portugal,1938,Friendly,6,2,2,1,1,4,4,0
Portugal,1939,Friendly,2,4,0,1,0,1,-2,0
Portugal,1940,Friendly,2,3,0,1,0,1,-1,0
Portugal,1941,Friendly,3,7,0,1,1,2,-4,0
Portugal,1942,Friendly,3,0,1,0,0,1,3,0
Portugal,1945,Friendly,4,7,0,2,1,3,-3,0
Portugal,1946,Friendly,5,2,2,0,0,2,3,0
Portugal,1947,Friendly,10,18,2,3,1,6,-8,0
Portugal,1948,Friendly,2,2,1,1,0,2,0,0
Portugal,1949,Friendly,5,8,1,2,1,4,-3,0
Portugal,1950,FIFA World Cup qualification,3,7,0,1,1,2,-4,0
Portugal,1950,Friendly,5,7,0,1,1,2,-2,0
Portugal,1951,Friendly,5,12,0,3,1,4,-7,0
Portugal,1952,Friendly,2,7,0,2,1,3,-5,0
Portugal,1953,FIFA World Cup qualification,1,9,0,1,1,2,-8,0
Portugal,1953,Friendly,3,1,1,0,0,1,2,0
Portugal,1954,Friendly,1,6,0,2,1,3,-5,0
Portugal,1955,Friendly,10,13,2,3,0,5,-3,0
Portugal,1956,Friendly,8,5,2,1,1,4,3,0
Portugal,1957,FIFA World Cup qualification,4,7,1,2,1,4,-3,0
Portugal,1957,Friendly,1,5,0,2,0,2,-4,0
Portugal,1958,Friendly,1,3,0,2,0,2,-2,0
Portugal,1959,Friendly,7,11,1,3,0,4,-4,0
Portugal,1959,UEFA Euro qualification,5,2,2,0,0,2,3,0
Portugal,1960,Friendly,1,2,0,1,0,1,-1,0
Portugal,1960,UEFA Euro qualification,3,6,1,1,0,2,-3,0
Portugal,1961,FIFA World Cup qualification,9,7,1,2,1,4,2,0
Portugal,1961,Friendly,0,2,0,1,0,1,-2,0
Portugal,1962,Friendly,2,5,0,3,0,3,-3,0
Portugal,1962,UEFA Euro qualification,4,4,1,1,0,2,0,1
Portugal,1963,Friendly,1,0,1,0,0,1,1,0
Portugal,1963,UEFA Euro qualification,0,1,0,1,0,1,-1,0
Portugal,1964,Friendly,12,15,3,3,1,7,-3,0
Portugal,1965,FIFA World Cup qualification,9,4,4,1,1,6,5,0
Portugal,1965,Friendly,0,0,0,0,1,1,0,0
Portugal,1966,FIFA World Cup,17,8,5,1,0,6,9,0
Portugal,1966,Friendly,12,1,5,0,0,5,11,0
Portugal,1966,UEFA Euro qualification,1,2,0,1,0,1,-1,0
Portugal,1967,Friendly,1,1,0,0,1,1,0,0
Portugal,1967,UEFA Euro qualification,5,4,2,1,2,5,1,0
Portugal,1968,FIFA World Cup qualification,5,4,1,1,0,2,1,0
Portugal,1968,Friendly,0,2,0,1,0,1,-2,0
Portugal,1969,FIFA World Cup qualification,3,6,0,2,2,4,-3,0
Portugal,1969,Friendly,0,1,0,1,1,2,-1,0
Portugal,1970,Friendly,1,2,0,1,0,1,-1,0
Portugal,1970,UEFA Euro qualification,1,0,1,0,0,1,1,0
Portugal,1971,UEFA Euro qualification,9,6,2,2,1,5,3,0
Portugal,1972,Brazil Independence Cup,17,5,6,1,1,8,12,0
Portugal,1972,FIFA World Cup qualification,5,0,2,0,0,2,5,0
Portugal,1973,FIFA World Cup qualification,5,6,0,1,3,4,-1,0
Portugal,1973,Friendly,2,1,1,0,0,1,1,0
Portugal,1974,Friendly,0,3,0,1,1,2,-3,0
Portugal,1974,UEFA Euro qualification,0,0,0,0,1,1,0,0
Portugal,1975,Friendly,3,3,1,2,0,3,0,0
Portugal,1975,UEFA Euro qualification,5,7,2,1,2,5,-2,0
Portugal,1976,FIFA World Cup qualification,3,3,2,1,0,3,0,0
Portugal,1976,Friendly,3,4,1,1,0,2,-1,0
Portugal,1977,FIFA World Cup qualification,9,3,2,0,1,3,6,0
Portugal,1977,Friendly,1,0,1,0,0,1,1,0
Portugal,1978,Friendly,1,2,1,1,0,2,-1,0
Portugal,1978,UEFA Euro qualification,4,2,2,0,1,3,2,0
Portugal,1979,Friendly,1,1,0,0,1,1,0,0
Portugal,1979,UEFA Euro qualification,5,5,2,2,0,4,0,0
Portugal,1980,FIFA World Cup qualification,4,0,2,0,1,3,4,0
Portugal,1980,Friendly,2,4,0,1,1,2,-2,0
Portugal,1980,UEFA Euro qualification,1,4,0,1,0,1,-3,0
Portugal,1981,FIFA World Cup qualification,4,11,1,4,0,5,-7,0
Portugal,1981,Friendly,7,6,2,1,1,4,1,0
Portugal,1982,Friendly,5,9,1,3,0,4,-4,0
Portugal,1982,UEFA Euro qualification,4,1,2,0,0,2,3,0
Portugal,1983,Friendly,1,7,1,2,1,4,-6,0
Portugal,1983,UEFA Euro qualification,7,5,3,1,0,4,2,0
Portugal,1984,FIFA World Cup qualification,4,4,2,1,0,3,0,0
Portugal,1984,Friendly,4,4,1,1,0,2,0,0
Portugal,1984,UEFA Euro,4,4,1,1,2,4,0,0
Portugal,1985,FIFA World Cup qualification,8,6,3,2,0,5,2,0
Portugal,1985,Friendly,2,5,0,2,0,2,-3,0
Portugal,1986,FIFA World Cup,2,4,1,2,0,3,-2,0
Portugal,1986,Friendly,4,4,1,1,1,3,0,0
Portugal,1986,UEFA Euro qualification,2,2,0,0,2,2,0,0
Portugal,1987,Friendly,2,1,1,0,1,2,1,0
Portugal,1987,UEFA Euro qualification,4,6,2,2,2,6,-2,1
Portugal,1988,FIFA World Cup qualification,1,0,1,0,0,1,1,0
Portugal,1988,Friendly,0,0,0,0,1,1,0,0
Portugal,1989,FIFA World Cup qualification,10,8,3,2,2,7,2,0
Portugal,1989,Friendly,8,5,2,1,1,4,3,0
Portugal,1990,Friendly,2,1,1,0,1,2,1,0
Portugal,1990,UEFA Euro qualification,1,0,1,0,1,2,1,0
Portugal,1991,Friendly,3,3,0,0,3,3,0,0
Portugal,1991,UEFA Euro qualification,10,4,4,2,0,6,6,0
Portugal,1992,FIFA World Cup qualification,0,0,0,0,1,1,0,0
Portugal,1992,Friendly,5,2,2,0,2,4,3,0
Portugal,1992,USA Cup,0,3,0,2,1,3,-3,0
Portugal,1993,FIFA World Cup qualification,18,5,6,2,1,9,13,0
Portugal,1993,Friendly,1,1,0,0,1,1,0,0
Portugal,1994,Friendly,2,2,0,0,2,2,0,0
Portugal,1994,UEFA Euro qualification,14,2,4,0,0,4,12,0
Portugal,1995,Friendly,3,2,1,0,2,3,1,0
Portugal,1995,UEFA Euro qualification,15,5,3,1,2,6,10,0
Portugal,1996,FIFA World Cup qualification,5,2,2,1,2,5,3,0
Portugal,1996,Friendly,3,2,2,1,0,3,1,0
Portugal,1996,UEFA Euro,5,2,2,1,1,4,3,0
Portugal,1997,FIFA World Cup qualification,7,2,3,0,2,5,5,0
Portugal,1997,Friendly,0,2,0,1,1,2,-2,0
Portugal,1998,Friendly,4,4,2,1,0,3,0,0
Portugal,1998,UEFA Euro qualification,6,2,2,1,0,3,4,0
Portugal,1999,Friendly,4,0,1,0,1,2,4,0
Portugal,1999,UEFA Euro qualification,26,2,5,0,2,7,24,0
Portugal,2000,FIFA World Cup qualification,6,2,2,0,1,3,4,0
Portugal,2000,Friendly,13,6,4,1,1,6,7,0
Portugal,2000,UEFA Euro,10,4,4,1,0,5,6,0
Portugal,2001,FIFA World Cup qualification,27,5,5,0,2,7,22,0
Portugal,2001,Friendly,8,5,2,1,0,3,3,0
Portugal,2002,FIFA World Cup,6,4,1,2,0,3,2,0
Portugal,2002,Friendly,12,10,3,1,4,8,2,0
Portugal,2003,Friendly,24,10,7,2,3,12,14,0
Portugal,2004,FIFA World Cup qualification,20,3,4,0,1,5,17,0
Portugal,2004,Friendly,11,6,2,1,2,5,5,0
Portugal,2004,UEFA Euro,8,6,3,2,1,6,2,0
Portugal,2005,FIFA World Cup qualification,15,2,5,0,2,7,13,0
Portugal,2005,Friendly,9,3,3,1,1,5,6,0
Portugal,2006,FIFA World Cup,7,5,4,2,1,7,2,0
Portugal,2006,Friendly,12,5,3,1,0,4,7,0
Portugal,2006,UEFA Euro qualification,8,3,2,1,1,4,5,0
Portugal,2007,Friendly,3,1,1,0,1,2,2,0
Portugal,2007,UEFA Euro qualification,16,7,5,0,5,10,9,0
Portugal,2008,FIFA World Cup qualification,6,3,1,1,2,4,3,0
Portugal,2008,Friendly,11,11,2,3,0,5,0,0
Portugal,2008,UEFA Euro,7,6,2,2,0,4,1,0
Portugal,2009,FIFA World Cup qualification,13,2,6,0,2,8,11,1
Portugal,2009,Friendly,6,0,3,0,1,4,6,0
Portugal,2010,FIFA World Cup,7,1,1,1,2,4,6,0
Portugal,2010,Friendly,12,1,4,0,1,5,11,0
Portugal,2010,UEFA Euro qualification,10,7,2,1,1,4,3,0
Portugal,2011,Friendly,9,3,2,1,1,4,6,0
Portugal,2011,UEFA Euro qualification,17,7,4,1,1,6,10,0
Portugal,2012,FIFA World Cup qualification,6,3,2,1,1,4,3,0
Portugal,2012,Friendly,5,5,1,1,3,5,0,0
Portugal,2012,UEFA Euro,6,4,3,1,1,5,2,0
Portugal,2013,FIFA World Cup qualification,18,8,6,0,2,8,10,0
Portugal,2013,Friendly,5,7,1,2,1,4,-2,0
Portugal,2014,FIFA World Cup,4,7,1,1,1,3,-3,0
Portugal,2014,Friendly,13,4,4,1,1,6,9,0
Portugal,2014,UEFA Euro qualification,2,1,2,1,0,3,1,0
Portugal,2015,Friendly,3,4,2,3,0,5,-1,0
Portugal,2015,UEFA Euro qualification,9,4,5,0,0,5,5,0
Portugal,2016,FIFA World Cup qualification,16,3,3,1,0,4,13,0
Portugal,2016,Friendly,17,3,4,2,0,6,14,0
Portugal,2016,UEFA Euro,9,5,3,0,4,7,4,1
Portugal,2017,Confederations Cup,9,3,3,0,2,5,6,1
Portugal,2017,FIFA World Cup qualification,16,1,6,0,0,6,15,0
Portugal,2017,Friendly,10,4,2,1,1,4,6,0
Portugal,2018,FIFA World Cup,6,6,1,1,2,4,0,0
Portugal,2018,Friendly,11,8,3,1,3,7,3,0
Portugal,2018,UEFA Nations League,5,3,2,0,2,4,2,0
Portugal,2019,UEFA Euro qualification,22,6,5,1,2,8,16,0
Portugal,2019,UEFA Nations League,4,1,2,0,0,2,3,0
Portugal,2020,Friendly,7,0,1,0,1,2,7,0
Portugal,2020,UEFA Nations League,12,4,4,1,1,6,8,0
Portugal,2021,FIFA World Cup qualification,17,6,5,1,2,8,11,0
Portugal,2021,Friendly,10,1,3,0,1,4,9,0
Portugal,2021,UEFA Euro,7,7,1,2,1,4,0,0
Portugal,2022,FIFA World Cup,12,6,3,2,0,5,6,0
Portugal,2022,FIFA World Cup qualification,5,1,2,0,0,2,4,0
Portugal,2022,Friendly,4,0,1,0,0,1,4,0
Portugal,2022,UEFA Nations League,11,3,3,2,1,6,8,0
Portugal,2023,UEFA Euro qualification,36,2,10,0,0,10,34,0
Portugal,2024,Friendly,13,8,3,2,0,5,5,0
Portugal,2024,UEFA Euro,5,3,2,1,2,5,2,0
Portugal,2024,UEFA Nations League,13,5,4,0,2,6,8,0
Portugal,2025,UEFA Nations League,5,3,1,1,0,2,2,0
Provence,1921,Friendly,0,5,0,2,0,2,-5,0
Provence,2008,Friendly,3,2,1,0,0,1,1,0
Provence,2008,Viva World Cup,3,18,0,4,0,4,-15,0
Provence,2009,Viva World Cup,9,12,2,1,1,4,-3,0
Provence,2010,Viva World Cup,3,6,0,3,0,3,-3,0
Provence,2012,Viva World Cup,23,10,2,2,0,4,13,0
Provence,2013,Friendly,6,1,1,0,0,1,5,0
Puerto Rico,1940,Friendly,1,1,0,0,1,1,0,0
Puerto Rico,1942,Friendly,0,2,0,2,0,2,-2,0
Puerto Rico,1946,Central American and Caribbean Games,3,52,0,6,0,6,-49,0
Puerto Rico,1947,Friendly,0,4,0,1,1,2,-4,0
Puerto Rico,1949,Friendly,2,15,0,2,0,2,-13,0
Puerto Rico,1962,Friendly,1,9,0,2,0,2,-8,0
Puerto Rico,1963,Friendly,0,9,0,2,0,2,-9,0
Puerto Rico,1964,Friendly,0,8,0,2,0,2,-8,0
Puerto Rico,1967,Friendly,5,10,0,2,0,2,-5,0
Puerto Rico,1968,Friendly,0,9,0,2,0,2,-9,0
Puerto Rico,1972,CONCACAF Championship qualification,0,12,0,2,0,2,-12,0
Puerto Rico,1972,Friendly,1,5,1,1,1,3,-4,0
Puerto Rico,1974,Friendly,0,1,0,1,0,1,-1,0
Puerto Rico,1975,Friendly,1,2,0,1,0,1,-1,0
Puerto Rico,1977,Friendly,0,2,0,1,0,1,-2,0
Puerto Rico,1978,CFU Caribbean Cup qualification,1,2,0,1,1,2,-1,0
Puerto Rico,1978,Friendly,5,4,1,1,0,2,1,0
Puerto Rico,1981,CFU Caribbean Cup,1,3,0,1,1,2,-2,0
Puerto Rico,1984,CONCACAF Championship qualification,0,8,0,2,0,2,-8,0
Puerto Rico,1988,CONCACAF Championship qualification,1,3,0,2,0,2,-2,0
Puerto Rico,1991,CFU Caribbean Cup qualification,3,6,0,2,0,2,-3,0
Puerto Rico,1992,FIFA World Cup qualification,4,5,1,2,1,4,-1,0
Puerto Rico,1993,CFU Caribbean Cup,3,2,1,2,0,3,1,0
Puerto Rico,1993,CFU Caribbean Cup qualification,7,0,3,0,0,3,7,0
Puerto Rico,1994,CFU Caribbean Cup qualification,1,1,1,1,0,2,0,0
Puerto Rico,1995,CFU Caribbean Cup qualification,3,14,0,2,1,3,-11,0
Puerto Rico,1996,FIFA World Cup qualification,1,9,0,2,0,2,-8,0
Puerto Rico,1998,CFU Caribbean Cup qualification,1,7,0,2,0,2,-6,0
Puerto Rico,1999,CFU Caribbean Cup qualification,0,9,0,3,0,3,-9,0
Puerto Rico,2000,FIFA World Cup qualification,4,6,0,1,1,2,-2,0
Puerto Rico,2001,CFU Caribbean Cup qualification,1,2,0,1,1,2,-1,0
Puerto Rico,2001,Friendly,0,2,0,1,0,1,-2,0
Puerto Rico,2002,Gold Cup qualification,0,6,0,2,0,2,-6,0
Puerto Rico,2004,CFU Caribbean Cup qualification,3,11,0,2,1,3,-8,0
Puerto Rico,2005,Friendly,1,3,0,1,0,1,-2,0
Puerto Rico,2008,FIFA World Cup qualification,3,6,1,1,1,3,-3,0
Puerto Rico,2008,Friendly,5,2,2,0,1,3,3,0
Puerto Rico,2010,CFU Caribbean Cup qualification,10,8,3,3,0,6,2,0
Puerto Rico,2011,FIFA World Cup qualification,8,4,2,1,3,6,4,0
Puerto Rico,2012,CFU Caribbean Cup qualification,15,12,2,4,0,6,3,0
Puerto Rico,2012,Friendly,6,9,1,3,1,5,-3,0
Puerto Rico,2014,CFU Caribbean Cup qualification,5,6,0,1,2,3,-1,0
Puerto Rico,2015,FIFA World Cup qualification,1,2,1,1,0,2,-1,0
Puerto Rico,2016,CFU Caribbean Cup qualification,9,7,1,1,1,3,2,0
Puerto Rico,2016,Friendly,2,12,0,3,0,3,-10,0
Puerto Rico,2017,Friendly,0,0,0,0,1,1,0,0
Puerto Rico,2018,CONCACAF Nations League qualification,0,3,0,3,0,3,-3,0
Puerto Rico,2019,CONCACAF Nations League,6,12,2,2,0,4,-6,0
Puerto Rico,2019,CONCACAF Nations League qualification,0,2,0,1,0,1,-2,0
Puerto Rico,2019,Friendly,0,4,0,1,0,1,-4,0
Puerto Rico,2021,FIFA World Cup qualification,10,2,2,1,1,4,8,0
Puerto Rico,2021,Friendly,1,1,1,1,0,2,0,0
Puerto Rico,2022,CONCACAF Nations League,9,0,2,0,0,2,9,0
Puerto Rico,2023,CONCACAF Nations League,30,12,6,2,0,8,18,0
Puerto Rico,2023,Gold Cup qualification,0,2,0,1,1,2,-2,0
Puerto Rico,2024,CONCACAF Nations League,11,12,3,3,0,6,-1,0
Puerto Rico,2024,FIFA World Cup qualification,8,0,1,0,1,2,8,0
Puerto Rico,2024,Friendly,1,4,0,1,1,2,-3,0
Puerto Rico,2025,Friendly,2,4,0,1,1,2,-2,0
Qatar,1970,Gulf Cup,4,7,0,2,1,3,-3,0
Qatar,1972,Gulf Cup,2,16,0,4,0,4,-14,0
Qatar,1972,Palestine Cup,5,15,0,4,0,4,-10,0
Qatar,1973,Friendly,1,13,0,2,0,2,-12,0
Qatar,1974,Friendly,0,1,0,1,0,1,-1,0
Qatar,1974,Gulf Cup,6,7,1,3,1,5,-1,0
Qatar,1975,AFC Asian Cup qualification,5,8,2,3,1,6,-3,0
Qatar,1976,Gulf Cup,11,6,4,1,1,6,5,0
Qatar,1977,FIFA World Cup qualification,3,9,1,3,0,4,-6,0
Qatar,1977,Friendly,1,0,1,0,0,1,1,0
Qatar,1978,Asian Games,3,7,0,2,1,3,-4,0
Qatar,1979,AFC Asian Cup qualification,3,1,1,0,0,1,2,0
Qatar,1979,Gulf Cup,4,13,2,3,1,6,-9,0
Qatar,1980,AFC Asian Cup,3,8,1,2,1,4,-5,0
Qatar,1981,FIFA World Cup qualification,5,3,2,2,0,4,2,0
Qatar,1981,Friendly,0,4,0,1,0,1,-4,0
Qatar,1982,Friendly,1,2,0,1,0,1,-1,0
Qatar,1982,Gulf Cup,5,4,2,3,0,5,1,1
Qatar,1983,Friendly,5,1,2,0,0,2,4,0
Qatar,1984,AFC Asian Cup,3,3,1,1,2,4,0,0
Qatar,1984,AFC Asian Cup qualification,11,1,3,1,0,4,10,0
Qatar,1984,Friendly,4,3,1,0,2,3,1,0
Qatar,1984,Gulf Cup,10,6,4,1,2,7,4,0
Qatar,1985,Arab Cup,3,2,1,1,2,4,1,0
Qatar,1985,FIFA World Cup qualification,6,3,2,2,0,4,3,0
Qatar,1986,Asian Games,2,3,0,1,2,3,-1,0
Qatar,1986,Friendly,4,10,1,3,2,6,-6,0
Qatar,1986,Gulf Cup,7,8,2,2,2,6,-1,1
Qatar,1988,AFC Asian Cup,7,6,2,2,0,4,1,0
Qatar,1988,Friendly,9,4,4,1,0,5,5,0
Qatar,1988,Gulf Cup,4,8,1,3,2,6,-4,0
Qatar,1989,FIFA World Cup qualification,12,8,4,1,6,11,4,0
Qatar,1989,Friendly,2,4,1,2,1,4,-2,0
Qatar,1990,Gulf Cup,4,4,1,1,2,4,0,0
Qatar,1992,AFC Asian Cup,3,4,0,1,2,3,-1,0
Qatar,1992,AFC Asian Cup qualification,8,2,2,0,0,2,6,0
Qatar,1992,Friendly,2,6,0,2,2,4,-4,0
Qatar,1992,Gulf Cup,8,1,4,1,0,5,7,0
Qatar,1993,FIFA World Cup qualification,22,8,5,2,1,8,14,0
Qatar,1993,Friendly,2,8,0,2,0,2,-6,0
Qatar,1994,Asian Games,5,5,0,0,3,3,0,0
Qatar,1994,Friendly,3,2,2,1,1,4,1,0
Qatar,1994,Gulf Cup,6,8,1,3,1,5,-2,0
Qatar,1996,AFC Asian Cup qualification,5,4,2,2,0,4,1,0
Qatar,1996,FIFA World Cup qualification,14,0,3,0,0,3,14,0
Qatar,1996,Friendly,10,14,2,4,1,7,-4,0
Qatar,1996,Gulf Cup,9,5,3,1,1,5,4,0
Qatar,1997,FIFA World Cup qualification,7,10,3,4,1,8,-3,0
Qatar,1998,Arab Cup,7,5,3,1,0,4,2,0
Qatar,1998,Asian Games,9,4,4,1,1,6,5,0
Qatar,1998,Friendly,3,3,0,0,2,2,0,0
Qatar,1998,Gulf Cup,3,8,0,2,3,5,-5,0
Qatar,2000,AFC Asian Cup,3,5,0,1,3,4,-2,0
Qatar,2000,AFC Asian Cup qualification,11,3,3,0,1,4,8,0
Qatar,2000,Friendly,18,12,5,5,2,12,6,0
Qatar,2001,FIFA World Cup qualification,24,13,7,3,4,14,11,0
Qatar,2001,Friendly,10,6,5,1,3,9,4,0
Qatar,2001,King's Cup,4,4,1,1,2,4,0,0
Qatar,2002,Friendly,3,6,1,2,0,3,-3,0
Qatar,2002,Gulf Cup,7,4,4,1,0,5,3,0
Qatar,2002,King's Cup,6,2,2,1,1,4,4,0
Qatar,2003,AFC Asian Cup qualification,8,6,2,1,2,5,2,0
Qatar,2003,Friendly,2,7,1,2,1,4,-5,0
Qatar,2003,Gulf Cup,0,0,0,0,2,2,0,0
Qatar,2003,King's Cup,6,9,0,2,2,4,-3,0
Qatar,2004,AFC Asian Cup,2,4,0,2,1,3,-2,0
Qatar,2004,FIFA World Cup qualification,16,8,3,3,0,6,8,0
Qatar,2004,Friendly,15,4,4,2,1,7,11,0
Qatar,2004,Gulf Cup,15,10,4,1,4,9,5,0
Qatar,2005,Friendly,0,3,0,1,1,2,-3,0
Qatar,2006,AFC Asian Cup qualification,14,4,5,1,0,6,10,0
Qatar,2006,Friendly,4,0,2,0,0,2,4,0
Qatar,2007,AFC Asian Cup,3,4,0,1,2,3,-1,0
Qatar,2007,FIFA World Cup qualification,6,0,2,0,0,2,6,0
Qatar,2007,Friendly,9,16,2,4,3,9,-7,0
Qatar,2007,Gulf Cup,2,4,0,2,1,3,-2,0
Qatar,2008,FIFA World Cup qualification,9,14,4,4,2,10,-5,0
Qatar,2008,Friendly,14,9,4,3,3,10,5,0
Qatar,2008,WAFF Championship,2,9,1,2,0,3,-7,0
Qatar,2009,FIFA World Cup qualification,1,6,0,2,2,4,-5,0
Qatar,2009,Friendly,17,15,6,4,2,12,2,0
Qatar,2009,Gulf Cup,2,2,1,1,2,4,0,0
Qatar,2010,Friendly,9,12,2,4,4,10,-3,0
Qatar,2010,Gulf Cup,3,3,1,1,1,3,0,0
Qatar,2011,AFC Asian Cup,7,5,2,2,0,4,2,0
Qatar,2011,FIFA World Cup qualification,12,5,3,1,3,7,7,0
Qatar,2011,Friendly,3,7,0,3,2,5,-4,0
Qatar,2012,FIFA World Cup qualification,5,7,2,2,2,6,-2,0
Qatar,2012,Friendly,2,6,0,3,1,4,-4,0
Qatar,2013,AFC Asian Cup qualification,13,2,4,1,0,5,11,0
Qatar,2013,FIFA World Cup qualification,2,8,0,3,0,3,-6,0
Qatar,2013,Friendly,17,7,6,1,4,11,10,0
Qatar,2013,Gulf Cup,3,5,1,2,0,3,-2,0
Qatar,2013,WAFF Championship,5,1,2,0,0,2,4,1
Qatar,2014,AFC Asian Cup qualification,0,0,0,0,1,1,0,0
Qatar,2014,Friendly,19,7,5,1,4,10,12,0
Qatar,2014,Gulf Cup,6,3,2,0,3,5,3,1
Qatar,2014,WAFF Championship,5,0,2,0,0,2,5,1
Qatar,2015,AFC Asian Cup,2,7,0,3,0,3,-5,0
Qatar,2015,FIFA World Cup qualification,27,2,6,0,0,6,25,0
Qatar,2015,Friendly,8,4,3,2,1,6,4,0
Qatar,2016,FIFA World Cup qualification,5,8,2,4,1,7,-3,0
Qatar,2016,Friendly,11,7,4,1,0,5,4,0
Qatar,2017,FIFA World Cup qualification,5,9,1,4,0,5,-4,0
Qatar,2017,Friendly,13,13,3,4,3,10,0,0
Qatar,2017,Gulf Cup,6,3,1,1,1,3,3,0
Qatar,2018,Friendly,20,14,7,3,2,12,6,0
Qatar,2019,AFC Asian Cup,19,1,7,0,0,7,18,1
Qatar,2019,Copa América,2,5,0,2,1,3,-3,0
Qatar,2019,FIFA World Cup qualification,11,1,4,0,1,5,10,0
Qatar,2019,Friendly,2,2,1,1,0,2,0,0
Qatar,2019,Gulf Cup,11,5,2,2,0,4,6,0
Qatar,2020,FIFA World Cup qualification,5,0,1,0,0,1,5,1
Qatar,2020,Friendly,3,8,0,2,1,3,-5,0
Qatar,2021,Arab Cup,12,3,4,1,1,6,9,0
Qatar,2021,FIFA World Cup qualification,2,0,2,0,0,2,2,0
Qatar,2021,Friendly,9,23,3,5,3,11,-14,0
Qatar,2021,Gold Cup,12,6,3,1,1,5,6,0
Qatar,2022,FIFA World Cup,1,7,0,3,0,3,-6,0
Qatar,2022,Friendly,10,6,5,1,2,8,4,0
Qatar,2023,FIFA World Cup qualification,11,1,2,0,0,2,10,0
Qatar,2023,Friendly,4,4,1,1,2,4,0,0
Qatar,2023,Gold Cup,3,7,1,2,1,4,-4,0
Qatar,2023,Gulf Cup,5,5,1,2,1,4,0,0
Qatar,2024,AFC Asian Cup,14,5,6,0,1,7,9,1
Qatar,2024,FIFA World Cup qualification,17,19,5,3,2,10,-2,0
Qatar,2024,Friendly,1,2,0,1,0,1,-1,0
Qatar,2024,Gulf Cup,3,4,0,1,2,3,-1,0
Qatar,2025,FIFA World Cup qualification,6,4,1,1,0,2,2,0
Raetia,2011,Friendly,1,6,0,1,0,1,-5,0
Raetia,2012,Friendly,3,18,1,1,0,2,-15,0
Raetia,2012,Viva World Cup,1,13,1,3,0,4,-12,0
Raetia,2013,Friendly,1,1,0,0,1,1,0,0
Raetia,2013,Tynwald Hill Tournament,3,7,1,1,0,2,-4,0
Raetia,2014,Friendly,3,13,0,3,0,3,-10,0
Raetia,2015,Benedikt Fontana Cup,6,0,1,0,0,1,6,1
Raetia,2016,CONIFA World Football Cup,3,23,0,3,1,4,-20,0
Raetia,2017,Friendly,0,5,0,1,0,1,-5,0
Raetia,2019,Friendly,5,6,0,1,1,2,-1,0
Raetia,2022,Friendly,4,9,0,1,2,3,-5,0
Raetia,2023,CONIFA World Football Cup qualification,8,1,1,0,0,1,7,0
Raetia,2023,Friendly,5,1,1,0,0,1,4,0
Republic of Ireland,1924,Olympic Games,2,2,1,1,0,2,0,0
Republic of Ireland,1926,Friendly,0,3,0,1,0,1,-3,0
Republic of Ireland,1928,Friendly,4,2,1,0,0,1,2,0
Republic of Ireland,1929,Friendly,4,0,1,0,0,1,4,0
Republic of Ireland,1930,Friendly,3,1,1,0,0,1,2,0
Republic of Ireland,1931,Friendly,1,6,0,1,1,2,-5,0
Republic of Ireland,1932,Friendly,2,0,1,0,0,1,2,0
Republic of Ireland,1934,FIFA World Cup qualification,6,9,0,1,1,2,-3,0
Republic of Ireland,1934,Friendly,2,4,0,1,0,1,-2,0
Republic of Ireland,1935,Friendly,4,9,0,3,0,3,-5,0
Republic of Ireland,1936,Friendly,16,9,3,1,1,5,7,0
Republic of Ireland,1937,FIFA World Cup qualification,5,6,0,1,1,2,-1,0
Republic of Ireland,1937,Friendly,3,0,2,0,0,2,3,0
Republic of Ireland,1938,Friendly,9,10,2,1,1,4,-1,0
Republic of Ireland,1939,Friendly,5,5,0,0,3,3,0,0
Republic of Ireland,1946,Friendly,2,4,1,2,0,3,-2,0
Republic of Ireland,1947,Friendly,3,4,1,1,0,2,-1,0
Republic of Ireland,1948,Friendly,1,5,0,3,0,3,-4,0
Republic of Ireland,1949,FIFA World Cup qualification,6,7,1,2,1,4,-1,0
Republic of Ireland,1949,Friendly,4,6,2,2,0,4,-2,0
Republic of Ireland,1950,Friendly,3,7,0,1,1,2,-4,0
Republic of Ireland,1951,Friendly,6,5,2,1,0,3,1,0
Republic of Ireland,1952,Friendly,1,16,0,3,1,4,-15,0
Republic of Ireland,1953,FIFA World Cup qualification,7,6,1,2,0,3,1,0
Republic of Ireland,1953,Friendly,4,0,1,0,0,1,4,0
Republic of Ireland,1954,FIFA World Cup qualification,1,0,1,0,0,1,1,0
Republic of Ireland,1954,Friendly,2,1,1,0,0,1,1,0
Republic of Ireland,1955,Friendly,8,9,2,2,1,5,-1,0
Republic of Ireland,1956,FIFA World Cup qualification,2,1,1,0,0,1,1,0
Republic of Ireland,1956,Friendly,7,1,2,0,0,2,6,0
Republic of Ireland,1957,FIFA World Cup qualification,4,6,1,1,1,3,-2,0
Republic of Ireland,1958,Friendly,5,7,0,1,2,3,-2,0
Republic of Ireland,1959,Friendly,3,2,1,0,0,1,1,0
Republic of Ireland,1959,UEFA Euro qualification,2,4,1,1,0,2,-2,0
Republic of Ireland,1960,Friendly,9,8,3,2,0,5,1,0
Republic of Ireland,1961,FIFA World Cup qualification,3,17,0,4,0,4,-14,0
Republic of Ireland,1962,Friendly,2,3,0,1,0,1,-1,0
Republic of Ireland,1962,UEFA Euro qualification,5,3,1,0,1,2,2,0
Republic of Ireland,1963,Friendly,1,0,1,0,0,1,1,0
Republic of Ireland,1963,UEFA Euro qualification,3,2,1,0,1,2,1,0
Republic of Ireland,1964,Friendly,9,9,2,2,0,4,0,0
Republic of Ireland,1964,UEFA Euro qualification,1,7,0,2,0,2,-6,0
Republic of Ireland,1965,FIFA World Cup qualification,2,5,1,2,0,3,-3,0
Republic of Ireland,1965,Friendly,0,2,0,1,0,1,-2,0
Republic of Ireland,1966,Friendly,3,7,1,2,0,3,-4,0
Republic of Ireland,1966,UEFA Euro qualification,2,3,1,1,1,3,-1,0
Republic of Ireland,1967,UEFA Euro qualification,3,5,1,2,0,3,-2,0
Republic of Ireland,1968,Friendly,5,6,0,1,3,4,-1,0
Republic of Ireland,1969,FIFA World Cup qualification,3,14,0,5,1,6,-11,0
Republic of Ireland,1969,Friendly,1,1,0,0,1,1,0,0
Republic of Ireland,1970,Friendly,2,6,0,3,0,3,-4,0
Republic of Ireland,1970,UEFA Euro qualification,1,5,0,2,1,3,-4,0
Republic of Ireland,1971,UEFA Euro qualification,2,12,0,3,0,3,-10,0
Republic of Ireland,1972,Brazil Independence Cup,7,7,2,2,0,4,0,0
Republic of Ireland,1972,FIFA World Cup qualification,3,3,1,1,0,2,0,0
Republic of Ireland,1973,FIFA World Cup qualification,1,2,0,1,1,2,-1,0
Republic of Ireland,1973,Friendly,5,7,1,2,1,4,-2,0
Republic of Ireland,1974,Friendly,3,5,1,2,0,3,-2,0
Republic of Ireland,1974,UEFA Euro qualification,4,1,1,0,1,2,3,0
Republic of Ireland,1975,UEFA Euro qualification,7,4,2,2,0,4,3,0
Republic of Ireland,1976,FIFA World Cup qualification,0,2,0,1,0,1,-2,0
Republic of Ireland,1976,Friendly,9,4,2,0,2,4,5,0
Republic of Ireland,1977,FIFA World Cup qualification,2,2,1,1,1,3,0,0
Republic of Ireland,1977,Friendly,0,1,0,1,1,2,-1,0
Republic of Ireland,1978,Friendly,4,5,1,1,1,3,-1,0
Republic of Ireland,1978,UEFA Euro qualification,4,4,0,0,3,3,0,0
Republic of Ireland,1979,Friendly,6,11,1,3,1,5,-5,0
Republic of Ireland,1979,UEFA Euro qualification,5,2,2,2,0,4,3,0
Republic of Ireland,1980,FIFA World Cup qualification,12,6,3,1,1,5,6,0
Republic of Ireland,1980,Friendly,2,1,1,1,0,2,1,0
Republic of Ireland,1980,UEFA Euro qualification,0,2,0,1,0,1,-2,0
Republic of Ireland,1981,FIFA World Cup qualification,5,5,1,1,1,3,0,0
Republic of Ireland,1981,Friendly,4,7,1,2,0,3,-3,0
Republic of Ireland,1982,Friendly,1,12,0,4,0,4,-11,0
Republic of Ireland,1982,UEFA Euro qualification,6,5,1,1,1,3,1,0
Republic of Ireland,1983,UEFA Euro qualification,14,5,3,2,0,5,9,0
Republic of Ireland,1984,FIFA World Cup qualification,1,4,1,2,0,3,-3,0
Republic of Ireland,1984,Friendly,0,3,0,1,2,3,-3,0
Republic of Ireland,1984,Kirin Cup,1,0,1,0,0,1,1,1
Republic of Ireland,1985,FIFA World Cup qualification,4,6,1,2,2,5,-2,0
Republic of Ireland,1985,Friendly,2,4,0,2,2,4,-2,0
Republic of Ireland,1986,Friendly,4,4,2,2,1,5,0,0
Republic of Ireland,1986,UEFA Euro qualification,2,2,0,0,2,2,0,0
Republic of Ireland,1987,Friendly,6,0,2,0,0,2,6,0
Republic of Ireland,1987,UEFA Euro qualification,8,3,4,1,1,6,5,0
Republic of Ireland,1988,FIFA World Cup qualification,0,2,0,1,1,2,-2,0
Republic of Ireland,1988,Friendly,11,1,4,0,1,5,10,0
Republic of Ireland,1988,UEFA Euro,2,2,1,1,1,3,0,0
Republic of Ireland,1989,FIFA World Cup qualification,10,0,5,0,1,6,10,0
Republic of Ireland,1989,Friendly,1,1,0,0,2,2,0,0
Republic of Ireland,1990,FIFA World Cup,2,3,0,1,4,5,-1,0
Republic of Ireland,1990,Friendly,7,1,4,0,2,6,6,0
Republic of Ireland,1990,UEFA Euro qualification,6,1,1,0,1,2,5,0
Republic of Ireland,1991,Friendly,7,3,2,0,2,4,4,0
Republic of Ireland,1991,UEFA Euro qualification,7,5,1,0,3,4,2,0
Republic of Ireland,1992,FIFA World Cup qualification,6,0,2,0,2,4,6,0
Republic of Ireland,1992,Friendly,6,3,2,1,0,3,3,0
Republic of Ireland,1992,USA Cup,3,5,1,2,0,3,-2,1
Republic of Ireland,1993,FIFA World Cup qualification,13,6,5,1,2,8,7,0
Republic of Ireland,1993,Friendly,4,5,1,1,0,2,-1,0
Republic of Ireland,1994,FIFA World Cup,2,4,1,2,1,4,-2,0
Republic of Ireland,1994,Friendly,5,3,3,1,1,5,2,0
Republic of Ireland,1994,UEFA Euro qualification,11,0,3,0,0,3,11,0
Republic of Ireland,1995,Friendly,1,0,1,0,0,1,1,0
Republic of Ireland,1995,UEFA Euro qualification,6,13,2,4,2,8,-7,0
Republic of Ireland,1996,FIFA World Cup qualification,8,0,2,0,1,3,8,0
Republic of Ireland,1996,Friendly,3,10,0,4,1,5,-7,0
Republic of Ireland,1996,USA Cup,6,4,1,1,1,3,2,0
Republic of Ireland,1997,FIFA World Cup qualification,16,11,3,3,3,9,5,0
Republic of Ireland,1997,Friendly,0,0,0,0,1,1,0,0
Republic of Ireland,1998,Friendly,1,4,0,2,1,3,-3,0
Republic of Ireland,1998,UEFA Euro qualification,7,1,2,1,0,3,6,0
Republic of Ireland,1999,Friendly,4,1,2,1,0,3,3,0
Republic of Ireland,1999,UEFA Euro qualification,8,6,3,1,3,7,2,0
Republic of Ireland,2000,FIFA World Cup qualification,5,3,1,0,2,3,2,0
Republic of Ireland,2000,Friendly,7,5,2,2,0,4,2,0
Republic of Ireland,2000,USA Cup,5,4,1,0,2,3,1,1
Republic of Ireland,2001,FIFA World Cup qualification,20,3,7,1,1,9,17,0
Republic of Ireland,2001,Friendly,2,2,0,0,1,1,0,0
Republic of Ireland,2002,FIFA World Cup,6,3,1,0,3,4,3,0
Republic of Ireland,2002,Friendly,11,3,4,1,1,6,8,0
Republic of Ireland,2002,UEFA Euro qualification,3,6,0,2,0,2,-3,0
Republic of Ireland,2003,Friendly,10,3,4,0,1,5,7,0
Republic of Ireland,2003,UEFA Euro qualification,7,5,3,1,2,6,2,0
Republic of Ireland,2004,FIFA World Cup qualification,6,1,2,0,2,4,5,0
Republic of Ireland,2004,Friendly,7,5,5,1,3,9,2,0
Republic of Ireland,2005,FIFA World Cup qualification,6,4,2,1,3,6,2,0
Republic of Ireland,2005,Friendly,3,2,2,1,0,3,1,0
Republic of Ireland,2006,Friendly,3,5,1,2,0,3,-2,0
Republic of Ireland,2006,UEFA Euro qualification,8,7,1,2,1,4,1,0
Republic of Ireland,2007,Friendly,6,2,1,0,2,3,4,0
Republic of Ireland,2007,UEFA Euro qualification,9,7,3,1,4,8,2,0
Republic of Ireland,2008,FIFA World Cup qualification,3,1,2,0,1,3,2,0
Republic of Ireland,2008,Friendly,5,6,1,2,2,5,-1,0
Republic of Ireland,2009,FIFA World Cup qualification,10,9,2,1,6,9,1,0
Republic of Ireland,2009,Friendly,2,4,1,1,1,3,-2,0
Republic of Ireland,2010,Friendly,6,6,2,3,0,5,0,0
Republic of Ireland,2010,UEFA Euro qualification,7,5,2,1,1,4,2,0
Republic of Ireland,2011,Friendly,4,3,1,1,1,3,1,0
Republic of Ireland,2011,Nations Cup,9,0,3,0,0,3,9,1
Republic of Ireland,2011,UEFA Euro qualification,13,3,5,0,3,8,10,0
Republic of Ireland,2012,FIFA World Cup qualification,7,8,2,1,0,3,-1,0
Republic of Ireland,2012,Friendly,6,3,2,1,3,6,3,0
Republic of Ireland,2012,UEFA Euro,1,9,0,3,0,3,-8,0
Republic of Ireland,2013,FIFA World Cup qualification,9,9,2,3,2,7,0,0
Republic of Ireland,2013,Friendly,10,3,3,1,3,7,7,0
Republic of Ireland,2014,Friendly,10,11,2,3,2,7,-1,0
Republic of Ireland,2014,UEFA Euro qualification,10,3,2,1,1,4,7,0
Republic of Ireland,2015,Friendly,0,0,0,0,1,1,0,0
Republic of Ireland,2015,UEFA Euro qualification,12,5,4,1,3,8,7,0
Republic of Ireland,2016,FIFA World Cup qualification,7,3,3,0,1,4,4,0
Republic of Ireland,2016,Friendly,9,5,2,1,2,5,4,0
Republic of Ireland,2016,UEFA Euro,3,6,1,2,1,4,-3,0
Republic of Ireland,2017,FIFA World Cup qualification,6,8,2,2,4,8,-2,0
Republic of Ireland,2017,Friendly,4,5,1,2,0,3,-1,0
Republic of Ireland,2018,Friendly,3,5,1,2,2,5,-2,0
Republic of Ireland,2018,UEFA Nations League,1,5,0,2,2,4,-4,0
Republic of Ireland,2019,Friendly,6,2,2,0,0,2,4,0
Republic of Ireland,2019,UEFA Euro qualification,7,5,3,1,4,8,2,0
Republic of Ireland,2020,Friendly,0,3,0,1,0,1,-3,0
Republic of Ireland,2020,UEFA Euro qualification,0,0,0,0,1,1,0,0
Republic of Ireland,2020,UEFA Nations League,1,4,0,3,3,6,-3,0
Republic of Ireland,2021,FIFA World Cup qualification,11,8,2,3,3,8,3,0
Republic of Ireland,2021,Friendly,9,2,2,0,2,4,7,0
Republic of Ireland,2022,Friendly,5,4,2,1,1,4,1,0
Republic of Ireland,2022,UEFA Nations League,8,7,2,3,1,6,1,0
Republic of Ireland,2023,Friendly,4,3,1,0,1,2,1,0
Republic of Ireland,2023,UEFA Euro qualification,9,10,2,6,0,8,-1,0
Republic of Ireland,2024,Friendly,2,5,1,2,1,4,-3,0
Republic of Ireland,2024,UEFA Nations League,3,12,2,4,0,6,-9,0
Republic of Ireland,2025,UEFA Nations League,4,2,2,0,0,2,2,0
Republic of St. Pauli,2006,FIFI Wild Cup,10,5,1,2,1,4,5,0
Rhodes,1999,Island Games,6,3,2,0,2,4,3,0
Rhodes,2001,Island Games,6,7,2,2,0,4,-1,0
Rhodes,2007,Island Games,6,5,3,1,0,4,1,0
Rhodes,2009,Island Games,9,1,3,1,0,4,8,0
Rhodes,2011,Island Games,2,3,1,1,0,2,-1,0
Romani people,2007,Friendly,3,1,1,0,0,1,2,0
Romani people,2011,Friendly,2,11,0,1,0,1,-9,0
Romani people,2015,CONIFA European Football Cup,7,8,1,2,0,3,-1,0
Romani people,2016,ConIFA Challenger Cup,1,4,0,1,0,1,-3,0
Romani people,2016,Friendly,0,2,0,1,0,1,-2,0
Romania,1919,Inter-Allied Games,3,14,0,3,0,3,-11,0
Romania,1922,Friendly,3,2,1,0,1,2,1,0
Romania,1923,Friendly,4,11,0,2,2,4,-7,0
Romania,1924,Friendly,2,8,0,2,0,2,-6,0
Romania,1924,Olympic Games,0,6,0,1,0,1,-6,0
Romania,1925,Friendly,5,4,1,1,0,2,1,0
Romania,1926,Friendly,12,4,3,0,0,3,8,0
Romania,1927,Friendly,3,6,0,1,1,2,-3,0
Romania,1928,Friendly,5,5,1,1,0,2,0,0
Romania,1929,Balkan Cup,2,1,1,0,0,1,1,1
Romania,1929,Friendly,8,5,2,1,0,3,3,0
Romania,1930,Balkan Cup,11,6,1,1,0,2,5,0
Romania,1930,FIFA World Cup,3,5,1,1,0,2,-2,0
Romania,1930,Friendly,1,2,0,1,0,1,-1,0
Romania,1931,Balkan Cup,13,6,3,0,0,3,7,1
Romania,1931,Friendly,7,4,2,0,0,2,3,0
Romania,1932,Balkan Cup,4,5,1,2,0,3,-1,0
Romania,1932,Friendly,6,8,1,1,0,2,-2,0
Romania,1933,Balkan Cup,12,0,2,0,0,2,12,1
Romania,1933,FIFA World Cup qualification,2,2,0,0,1,1,0,0
Romania,1934,Balkan Cup,5,4,1,0,1,2,1,1
Romania,1934,FIFA World Cup,1,2,0,1,0,1,-1,0
Romania,1934,FIFA World Cup qualification,2,1,1,0,0,1,1,0
Romania,1934,Friendly,3,3,0,0,1,1,0,0
Romania,1935,Balkan Cup,2,12,0,3,1,4,-10,0
Romania,1935,Friendly,7,12,1,2,0,3,-5,0
Romania,1936,Balkan Cup,9,3,2,0,0,2,6,1
Romania,1936,Friendly,4,4,1,1,0,2,0,0
Romania,1937,Friendly,10,8,2,1,2,5,2,0
Romania,1938,FIFA World Cup,4,5,0,1,1,2,-1,0
Romania,1938,Friendly,4,12,0,3,1,4,-8,0
Romania,1939,Friendly,5,3,2,2,0,4,2,0
Romania,1940,Friendly,9,17,1,3,1,5,-8,0
Romania,1941,Friendly,4,6,1,1,0,2,-2,0
Romania,1942,Friendly,2,10,0,2,1,3,-8,0
Romania,1943,Friendly,2,2,0,0,1,1,0,0
Romania,1945,Friendly,2,7,0,1,0,1,-5,0
Romania,1946,Balkan Cup,4,4,1,1,1,3,0,0
Romania,1947,Balkan Cup,8,8,2,2,0,4,0,0
Romania,1947,Friendly,4,7,1,1,1,3,-3,0
Romania,1948,Balkan Cup,6,18,2,3,1,6,-12,0
Romania,1949,Friendly,9,6,2,1,1,4,3,0
Romania,1950,Friendly,10,4,1,0,2,3,6,0
Romania,1951,Friendly,2,2,0,0,1,1,0,0
Romania,1952,Friendly,7,2,3,0,0,3,5,0
Romania,1953,FIFA World Cup qualification,5,5,2,2,0,4,0,0
Romania,1954,Friendly,2,5,1,1,0,2,-3,0
Romania,1955,Friendly,8,10,2,2,2,6,-2,0
Romania,1956,Friendly,3,4,2,2,0,4,-1,0
Romania,1957,FIFA World Cup qualification,6,4,2,1,1,4,2,0
Romania,1957,Friendly,1,2,0,1,1,2,-1,0
Romania,1958,Friendly,3,5,0,2,0,2,-2,0
Romania,1958,UEFA Euro qualification,3,0,1,0,0,1,3,0
Romania,1959,Friendly,3,2,1,0,0,1,1,0
Romania,1959,UEFA Euro qualification,0,2,0,1,0,1,-2,0
Romania,1960,UEFA Euro qualification,0,5,0,2,0,2,-5,0
Romania,1961,Friendly,5,0,2,0,0,2,5,0
Romania,1962,Friendly,7,6,1,2,0,3,1,0
Romania,1962,UEFA Euro qualification,3,7,1,1,0,2,-4,0
Romania,1963,Friendly,6,4,2,0,2,4,2,0
Romania,1964,Friendly,2,1,1,0,0,1,1,0
Romania,1965,FIFA World Cup qualification,9,7,3,3,0,6,2,0
Romania,1966,Friendly,7,8,3,3,0,6,-1,0
Romania,1966,UEFA Euro qualification,10,6,2,1,0,3,4,0
Romania,1967,Friendly,7,4,3,0,3,6,3,0
Romania,1967,UEFA Euro qualification,8,8,1,2,0,3,0,0
Romania,1968,FIFA World Cup qualification,2,3,1,1,0,2,-1,0
Romania,1968,Friendly,1,1,0,0,3,3,0,0
Romania,1969,FIFA World Cup qualification,5,3,2,0,2,4,2,0
Romania,1969,Friendly,2,3,0,1,2,3,-1,0
Romania,1970,FIFA World Cup,4,5,1,2,0,3,-1,0
Romania,1970,Friendly,2,6,0,2,3,5,-4,0
Romania,1970,UEFA Euro qualification,3,0,1,0,1,2,3,0
Romania,1971,Friendly,1,0,1,0,0,1,1,0
Romania,1971,UEFA Euro qualification,8,2,3,1,0,4,6,0
Romania,1972,FIFA World Cup qualification,3,1,1,0,1,2,2,0
Romania,1972,Friendly,8,6,1,0,3,4,2,0
Romania,1972,UEFA Euro qualification,4,5,0,1,2,3,-1,0
Romania,1973,FIFA World Cup qualification,14,3,3,1,0,4,11,0
Romania,1973,Friendly,0,2,0,1,0,1,-2,0
Romania,1974,Balkan Cup,3,1,1,0,0,1,2,1
Romania,1974,Friendly,2,5,1,3,2,6,-3,0
Romania,1974,UEFA Euro qualification,0,0,0,0,1,1,0,0
Romania,1975,Balkan Cup,1,1,0,0,1,1,0,0
Romania,1975,Friendly,6,6,0,0,4,4,0,0
Romania,1975,UEFA Euro qualification,11,6,1,0,4,5,5,0
Romania,1976,Balkan Cup,3,3,1,1,0,2,0,1
Romania,1976,Friendly,7,10,0,2,2,4,-3,0
Romania,1977,Balkan Cup,4,0,1,0,0,1,4,0
Romania,1977,FIFA World Cup qualification,7,8,2,2,0,4,-1,0
Romania,1977,Friendly,10,5,2,1,2,5,5,0
Romania,1978,Balkan Cup,4,2,1,0,2,3,2,0
Romania,1978,Friendly,3,6,1,3,1,5,-3,0
Romania,1978,UEFA Euro qualification,3,3,1,1,0,2,0,0
Romania,1979,Friendly,4,7,1,3,0,4,-3,0
Romania,1979,UEFA Euro qualification,6,5,1,1,2,4,1,0
Romania,1980,Balkan Cup,4,3,1,1,0,2,1,1
Romania,1980,FIFA World Cup qualification,3,2,1,0,1,2,1,0
Romania,1980,Friendly,6,7,1,2,1,4,-1,0
Romania,1981,FIFA World Cup qualification,2,3,1,2,3,6,-1,0
Romania,1981,Friendly,5,6,1,3,0,4,-1,0
Romania,1982,Friendly,5,12,2,4,0,6,-7,0
Romania,1982,UEFA Euro qualification,5,1,2,0,1,3,4,0
Romania,1983,Friendly,11,14,3,3,4,10,-3,0
Romania,1983,UEFA Euro qualification,4,2,3,1,1,5,2,0
Romania,1984,FIFA World Cup qualification,2,3,0,1,0,1,-1,0
Romania,1984,Friendly,11,8,3,2,3,8,3,0
Romania,1984,UEFA Euro,2,4,0,2,1,3,-2,0
Romania,1985,FIFA World Cup qualification,10,4,3,1,3,7,6,0
Romania,1985,Friendly,3,4,1,1,1,3,-1,0
Romania,1986,Friendly,15,12,4,1,3,8,3,0
Romania,1986,UEFA Euro qualification,4,1,1,1,0,2,3,0
Romania,1987,Friendly,10,9,2,1,2,5,1,0
Romania,1987,UEFA Euro qualification,9,2,3,0,1,4,7,0
Romania,1988,FIFA World Cup qualification,6,1,2,0,0,2,5,0
Romania,1988,Friendly,13,9,3,2,2,7,4,0
Romania,1989,FIFA World Cup qualification,4,4,2,1,1,4,0,0
Romania,1989,Friendly,2,4,1,2,1,4,-2,0
Romania,1990,FIFA World Cup,4,3,1,1,2,4,1,0
Romania,1990,Friendly,17,12,5,2,3,10,5,0
Romania,1990,UEFA Euro qualification,7,5,1,2,0,3,2,0
Romania,1991,Friendly,4,7,1,3,1,5,-3,0
Romania,1991,UEFA Euro qualification,6,2,3,0,2,5,4,0
Romania,1992,FIFA World Cup qualification,17,4,3,1,1,5,13,0
Romania,1992,Friendly,4,1,2,1,0,3,3,0
Romania,1993,FIFA World Cup qualification,12,8,4,1,0,5,4,0
Romania,1993,Friendly,6,4,3,1,1,5,2,0
Romania,1994,FIFA World Cup,10,9,3,1,1,5,1,0
Romania,1994,Friendly,7,5,2,1,3,6,2,0
Romania,1994,Lunar New Year Cup,2,1,1,0,0,1,1,1
Romania,1994,UEFA Euro qualification,7,3,2,0,2,4,4,0
Romania,1995,Friendly,1,2,0,1,1,2,-1,0
Romania,1995,UEFA Euro qualification,11,6,4,1,1,6,5,0
Romania,1996,FIFA World Cup qualification,10,0,3,0,0,3,10,0
Romania,1996,Friendly,11,4,3,2,0,5,7,0
Romania,1996,UEFA Euro,1,4,0,3,0,3,-3,0
Romania,1997,FIFA World Cup qualification,27,4,6,0,1,7,23,0
Romania,1997,Friendly,1,1,0,0,1,1,0,0
Romania,1998,FIFA World Cup,4,3,2,1,1,4,1,0
Romania,1998,Friendly,12,7,3,1,3,7,5,0
Romania,1998,UEFA Euro qualification,9,1,2,0,1,3,8,0
Romania,1999,Friendly,5,4,2,1,1,4,1,0
Romania,1999,UEFA Euro qualification,16,2,5,0,2,7,14,0
Romania,2000,Cyprus International Tournament,5,4,1,1,1,3,1,0
Romania,2000,FIFA World Cup qualification,1,3,1,1,0,2,-2,0
Romania,2000,Friendly,13,12,4,3,1,8,1,0
Romania,2000,UEFA Euro,4,6,1,2,1,4,-2,0
Romania,2001,Cyprus International Tournament,4,0,2,0,0,2,4,0
Romania,2001,FIFA World Cup qualification,11,7,4,2,2,8,4,0
Romania,2001,Friendly,2,2,0,0,2,2,0,0
Romania,2001,Millennium Cup,4,5,1,2,0,3,-1,0
Romania,2002,Friendly,7,6,2,3,0,5,1,0
Romania,2002,UEFA Euro qualification,10,1,2,1,0,3,9,0
Romania,2003,Cyprus International Tournament,2,1,1,0,0,1,1,0
Romania,2003,Friendly,4,2,2,1,1,4,2,0
Romania,2003,UEFA Euro qualification,11,8,2,1,2,5,3,0
Romania,2004,Cyprus International Tournament,3,0,1,0,0,1,3,0
Romania,2004,FIFA World Cup qualification,10,5,3,1,1,5,5,0
Romania,2004,Friendly,7,3,2,1,0,3,4,0
Romania,2005,FIFA World Cup qualification,10,5,5,2,0,7,5,0
Romania,2005,Friendly,6,4,1,1,1,3,2,0
Romania,2006,Cyprus International Tournament,4,0,2,0,0,2,4,0
Romania,2006,Friendly,5,2,3,1,1,5,3,0
Romania,2006,UEFA Euro qualification,7,3,2,0,1,3,4,0
Romania,2007,Friendly,5,3,2,1,0,3,2,0
Romania,2007,UEFA Euro qualification,19,4,7,1,1,9,15,0
Romania,2008,FIFA World Cup qualification,3,5,1,1,1,3,-2,0
Romania,2008,Friendly,10,2,4,1,0,5,8,0
Romania,2008,UEFA Euro,1,3,0,1,2,3,-2,0
Romania,2009,FIFA World Cup qualification,9,13,2,3,2,7,-4,0
Romania,2009,Friendly,3,2,2,1,0,3,1,0
Romania,2010,Friendly,6,9,1,4,1,6,-3,0
Romania,2010,UEFA Euro qualification,1,3,0,1,2,3,-2,0
Romania,2011,Cyprus International Tournament,3,3,0,0,2,2,0,0
Romania,2011,Friendly,5,6,2,3,0,5,-1,0
Romania,2011,UEFA Euro qualification,12,6,3,1,3,7,6,0
Romania,2012,FIFA World Cup qualification,8,4,3,1,0,4,4,0
Romania,2012,Friendly,11,6,3,1,2,6,5,0
Romania,2013,FIFA World Cup qualification,13,12,3,3,2,8,1,0
Romania,2013,Friendly,8,3,2,0,1,3,5,0
Romania,2014,Friendly,4,2,2,1,1,4,2,0
Romania,2014,UEFA Euro qualification,6,1,3,0,1,4,5,0
Romania,2015,Friendly,2,2,0,0,1,1,0,0
Romania,2015,UEFA Euro qualification,5,1,2,0,4,6,4,0
Romania,2016,FIFA World Cup qualification,6,4,1,1,2,4,2,0
Romania,2016,Friendly,10,7,2,2,2,6,3,0
Romania,2016,UEFA Euro,2,4,0,2,1,3,-2,0
Romania,2017,FIFA World Cup qualification,6,6,2,2,2,6,0,0
Romania,2017,Friendly,5,5,2,1,0,3,0,0
Romania,2018,Friendly,8,3,4,0,0,4,5,0
Romania,2018,UEFA Nations League,8,3,3,0,3,6,5,0
Romania,2019,UEFA Euro qualification,17,15,4,4,2,10,2,0
Romania,2020,Friendly,5,3,1,0,0,1,2,0
Romania,2020,UEFA Euro qualification,1,2,0,1,0,1,-1,0
Romania,2020,UEFA Nations League,8,9,2,2,2,6,-1,0
Romania,2021,FIFA World Cup qualification,13,8,5,3,2,10,5,0
Romania,2021,Friendly,1,3,0,2,0,2,-2,0
Romania,2022,Friendly,8,5,1,2,1,4,3,0
Romania,2022,UEFA Nations League,6,8,2,3,1,6,-2,0
Romania,2023,UEFA Euro qualification,16,5,6,0,4,10,11,1
Romania,2024,Friendly,3,4,0,1,3,4,-1,0
Romania,2024,UEFA Euro,4,6,1,2,1,4,-2,0
Romania,2024,UEFA Nations League,15,3,5,0,1,6,12,0
Romania,2025,FIFA World Cup qualification,5,2,1,1,0,2,3,0
Russia,1910,Friendly,6,4,2,0,0,2,2,0
Russia,1912,Friendly,2,24,0,3,1,4,-22,0
Russia,1912,Olympic Games,1,18,0,2,0,2,-17,0
Russia,1913,Friendly,2,5,0,1,1,2,-3,0
Russia,1914,Friendly,3,3,0,0,2,2,0,0
Russia,1923,Friendly,4,2,1,0,0,1,2,0
Russia,1924,Friendly,3,0,1,0,0,1,3,0
Russia,1925,Friendly,2,1,1,0,0,1,1,0
Russia,1952,Friendly,3,2,1,0,1,2,1,0
Russia,1954,Friendly,8,1,1,0,1,2,7,0
Russia,1955,Friendly,23,6,3,0,2,5,17,0
Russia,1956,Friendly,24,10,6,2,0,8,14,0
Russia,1957,FIFA World Cup qualification,18,3,4,1,0,5,15,0
Russia,1957,Friendly,7,2,2,0,1,3,5,0
Russia,1958,FIFA World Cup,5,6,2,2,1,5,-1,0
Russia,1958,Friendly,3,7,1,1,1,3,-4,0
Russia,1958,UEFA Euro qualification,3,1,1,0,0,1,2,0
Russia,1959,Friendly,4,1,2,0,0,2,3,0
Russia,1959,UEFA Euro qualification,1,0,1,0,0,1,1,0
Russia,1960,Friendly,9,4,2,1,0,3,5,0
Russia,1960,UEFA Euro,5,1,2,0,0,2,4,1
Russia,1961,FIFA World Cup qualification,11,3,4,0,0,4,8,0
Russia,1961,Friendly,5,4,3,2,1,6,1,0
Russia,1962,FIFA World Cup,9,7,2,1,1,4,2,0
Russia,1962,Friendly,12,2,4,0,0,4,10,0
Russia,1963,Friendly,2,3,0,1,2,3,-1,0
Russia,1963,UEFA Euro qualification,3,1,1,0,1,2,2,0
Russia,1964,Friendly,4,4,1,1,3,5,0,0
Russia,1964,UEFA Euro,4,2,1,1,0,2,2,0
Russia,1964,UEFA Euro qualification,4,2,1,0,1,2,2,1
Russia,1965,FIFA World Cup qualification,19,6,5,1,0,6,13,0
Russia,1965,Friendly,6,7,1,1,4,6,-1,0
Russia,1966,FIFA World Cup,10,6,4,2,0,6,4,0
Russia,1966,Friendly,16,12,6,2,3,11,4,0
Russia,1967,Friendly,19,12,5,2,2,9,7,0
Russia,1967,UEFA Euro qualification,16,6,5,1,0,6,10,0
Russia,1968,Friendly,7,4,2,0,4,6,3,0
Russia,1968,UEFA Euro,0,2,0,1,1,2,-2,0
Russia,1968,UEFA Euro qualification,3,2,1,1,0,2,1,1
Russia,1969,FIFA World Cup qualification,8,1,3,0,1,4,7,0
Russia,1969,Friendly,8,5,2,1,1,4,3,0
Russia,1970,FIFA World Cup,6,2,2,1,1,4,4,0
Russia,1970,Friendly,11,3,3,0,4,7,8,0
Russia,1970,UEFA Euro qualification,3,1,1,0,0,1,2,0
Russia,1971,Friendly,8,1,3,0,3,6,7,0
Russia,1971,UEFA Euro qualification,10,3,3,0,2,5,7,0
Russia,1972,Brazil Independence Cup,1,2,1,2,0,3,-1,0
Russia,1972,FIFA World Cup qualification,2,2,1,1,0,2,0,0
Russia,1972,Friendly,10,10,2,1,3,6,0,0
Russia,1972,UEFA Euro,1,3,1,1,0,2,-2,0
Russia,1972,UEFA Euro qualification,3,0,1,0,1,2,3,0
Russia,1973,FIFA World Cup qualification,3,0,2,0,1,3,3,0
Russia,1973,Friendly,3,6,1,5,1,7,-3,0
Russia,1974,Friendly,1,1,1,1,0,2,0,0
Russia,1974,UEFA Euro qualification,0,3,0,1,0,1,-3,0
Russia,1975,Friendly,3,2,1,0,1,2,1,0
Russia,1975,UEFA Euro qualification,10,3,4,1,0,5,7,0
Russia,1976,Friendly,10,10,2,3,4,9,0,0
Russia,1976,UEFA Euro qualification,2,4,0,1,1,2,-2,0
Russia,1977,FIFA World Cup qualification,5,3,2,2,0,4,2,0
Russia,1977,Friendly,12,5,3,1,2,6,7,0
Russia,1978,Friendly,28,7,8,1,1,10,21,0
Russia,1978,UEFA Euro qualification,2,2,1,1,0,2,0,0
Russia,1979,Friendly,22,9,9,1,1,11,13,0
Russia,1979,UEFA Euro qualification,5,6,0,1,3,4,-1,0
Russia,1980,FIFA World Cup qualification,7,1,2,0,0,2,6,0
Russia,1980,Friendly,18,5,6,0,1,7,13,0
Russia,1981,FIFA World Cup qualification,13,1,4,0,2,6,12,0
Russia,1982,FIFA World Cup,7,4,2,1,2,5,3,0
Russia,1982,Friendly,5,2,2,0,2,4,3,0
Russia,1982,UEFA Euro qualification,2,0,1,0,0,1,2,0
Russia,1983,Friendly,7,4,2,0,2,4,3,0
Russia,1983,UEFA Euro qualification,9,2,3,1,1,5,7,0
Russia,1984,FIFA World Cup qualification,1,2,0,1,1,2,-1,0
Russia,1984,Friendly,9,3,3,1,0,4,6,0
Russia,1985,FIFA World Cup qualification,12,6,4,1,1,6,6,0
Russia,1985,Friendly,5,0,3,0,0,3,5,0
Russia,1985,Nehru Cup,9,5,4,1,0,5,4,1
Russia,1986,FIFA World Cup,12,5,2,1,1,4,7,0
Russia,1986,Friendly,1,6,0,4,2,6,-5,0
Russia,1986,UEFA Euro qualification,7,1,2,0,1,3,6,0
Russia,1987,Friendly,5,3,2,1,1,4,2,0
Russia,1987,King's Cup,0,1,0,1,0,1,-1,0
Russia,1987,UEFA Euro qualification,7,2,3,0,2,5,5,0
Russia,1988,FIFA World Cup qualification,3,1,1,0,1,2,2,0
Russia,1988,Four Nations Tournament,4,4,1,1,0,2,0,0
Russia,1988,Friendly,13,7,5,2,2,9,6,0
Russia,1988,UEFA Euro,7,4,3,1,1,5,3,0
Russia,1989,FIFA World Cup qualification,8,3,3,1,2,6,5,0
Russia,1989,Friendly,3,4,1,1,1,3,-1,0
Russia,1990,FIFA World Cup,4,4,1,2,0,3,0,0
Russia,1990,Friendly,13,8,4,3,1,8,5,0
Russia,1990,Marlboro Cup,2,1,1,0,1,2,1,0
Russia,1990,UEFA Euro qualification,2,0,1,0,1,2,2,0
Russia,1991,Friendly,4,6,1,2,1,4,-2,0
Russia,1991,Nehru Cup,8,2,2,0,1,3,6,1
Russia,1991,Scania 100 Tournament,4,3,1,0,1,2,1,0
Russia,1991,UEFA Euro qualification,11,2,4,0,2,6,9,0
Russia,1992,FIFA World Cup qualification,3,0,2,0,0,2,3,0
Russia,1992,Friendly,12,12,3,2,4,9,0,0
Russia,1992,UEFA Euro,1,4,0,1,2,3,-3,0
Russia,1993,FIFA World Cup qualification,12,4,3,1,2,6,8,0
Russia,1993,Friendly,8,10,2,2,2,6,-2,0
Russia,1993,Nehru Cup,2,1,1,0,0,1,1,0
Russia,1994,FIFA World Cup,7,6,1,2,0,3,1,0
Russia,1994,Friendly,11,5,4,2,2,8,6,0
Russia,1994,UEFA Euro qualification,5,1,1,0,1,2,4,0
Russia,1995,Friendly,3,3,1,1,0,2,0,0
Russia,1995,UEFA Euro qualification,29,4,7,0,1,8,25,0
Russia,1996,FIFA World Cup qualification,9,1,2,0,1,3,8,0
Russia,1996,Friendly,12,4,4,0,2,6,8,0
Russia,1996,Malta International Tournament,8,1,3,0,0,3,7,0
Russia,1996,UEFA Euro,4,8,0,2,1,3,-4,0
Russia,1997,FIFA World Cup qualification,11,6,3,2,2,7,5,0
Russia,1997,Friendly,0,1,0,1,1,2,-1,0
Russia,1997,Lunar New Year Cup,3,2,1,0,1,2,1,1
Russia,1998,Friendly,6,12,2,4,2,8,-6,0
Russia,1998,UEFA Euro qualification,4,7,0,3,0,3,-3,0
Russia,1999,Friendly,3,1,1,0,1,2,2,0
Russia,1999,UEFA Euro qualification,18,5,6,0,1,7,13,0
Russia,2000,FIFA World Cup qualification,4,0,2,0,0,2,4,0
Russia,2000,Friendly,6,5,3,1,1,5,1,0
Russia,2001,FIFA World Cup qualification,14,5,5,1,2,8,9,0
Russia,2001,Friendly,6,4,1,0,2,3,2,0
Russia,2002,FIFA World Cup,4,4,1,2,0,3,0,0
Russia,2002,Friendly,4,7,0,2,4,6,-3,0
Russia,2002,UEFA Euro qualification,8,3,2,0,0,2,5,0
Russia,2003,Cyprus International Tournament,1,0,1,0,0,1,1,0
Russia,2003,Friendly,1,2,0,1,0,1,-1,0
Russia,2003,UEFA Euro qualification,12,9,3,2,3,8,3,0
Russia,2004,FIFA World Cup qualification,10,8,2,1,1,4,2,0
Russia,2004,Friendly,8,8,1,1,2,4,0,0
Russia,2004,UEFA Euro,2,4,1,2,0,3,-2,0
Russia,2005,FIFA World Cup qualification,13,4,4,0,4,8,9,0
Russia,2005,Friendly,2,4,0,1,1,2,-2,0
Russia,2006,Friendly,1,1,1,1,1,3,0,0
Russia,2006,UEFA Euro qualification,5,1,2,0,2,4,4,0
Russia,2007,Friendly,3,6,0,1,1,2,-3,0
Russia,2007,UEFA Euro qualification,13,6,5,2,1,8,7,0
Russia,2008,FIFA World Cup qualification,6,3,2,1,0,3,3,0
Russia,2008,Friendly,13,6,3,1,1,5,7,0
Russia,2008,UEFA Euro,7,8,3,2,0,5,-1,0
Russia,2009,FIFA World Cup qualification,15,5,6,2,1,9,10,0
Russia,2009,Friendly,2,3,0,1,0,1,-1,0
Russia,2010,Friendly,2,3,1,1,1,3,-1,0
Russia,2010,UEFA Euro qualification,6,3,3,1,0,4,3,0
Russia,2011,Friendly,3,3,1,1,3,5,0,0
Russia,2011,UEFA Euro qualification,11,1,4,0,2,6,10,0
Russia,2012,FIFA World Cup qualification,8,0,4,0,0,4,8,0
Russia,2012,Friendly,9,4,2,0,4,6,5,0
Russia,2012,UEFA Euro,5,3,1,1,1,3,2,0
Russia,2013,FIFA World Cup qualification,12,5,3,2,1,6,7,0
Russia,2013,Friendly,6,3,2,0,2,4,3,0
Russia,2014,FIFA World Cup,2,3,0,1,2,3,-1,0
Russia,2014,Friendly,12,2,5,0,1,6,10,0
Russia,2014,UEFA Euro qualification,6,3,1,1,2,4,3,0
Russia,2015,Friendly,6,5,2,1,1,4,1,0
Russia,2015,UEFA Euro qualification,12,2,4,1,0,5,10,0
Russia,2016,Friendly,13,13,3,4,2,9,0,0
Russia,2016,UEFA Euro,2,6,0,2,1,3,-4,0
Russia,2017,Confederations Cup,3,3,1,2,0,3,0,0
Russia,2017,Friendly,15,13,2,2,4,8,2,0
Russia,2018,FIFA World Cup,11,7,2,1,2,5,4,0
Russia,2018,Friendly,7,12,1,4,1,6,-5,0
Russia,2018,UEFA Nations League,4,3,2,1,1,4,1,0
Russia,2019,UEFA Euro qualification,33,8,8,2,0,10,25,1
Russia,2020,Friendly,1,2,0,1,1,2,-1,0
Russia,2020,UEFA Nations League,9,12,2,2,2,6,-3,0
Russia,2021,FIFA World Cup qualification,19,6,7,2,1,10,13,0
Russia,2021,Friendly,2,1,1,0,1,2,1,0
Russia,2021,UEFA Euro,2,7,1,2,0,3,-5,0
Russia,2022,Friendly,2,1,1,0,2,3,1,0
Russia,2023,Friendly,15,4,3,0,3,6,11,0
Russia,2024,Friendly,13,1,4,0,0,4,12,0
Russia,2025,Friendly,10,0,2,0,0,2,10,0
Rwanda,1976,Friendly,1,6,0,1,0,1,-5,0
Rwanda,1979,Friendly,2,2,0,0,1,1,0,0
Rwanda,1981,African Cup of Nations qualification,1,1,1,1,0,2,0,0
Rwanda,1982,African Cup of Nations qualification,1,0,1,0,0,1,1,0
Rwanda,1982,Friendly,0,1,0,1,0,1,-1,0
Rwanda,1983,African Cup of Nations qualification,0,6,0,2,0,2,-6,0
Rwanda,1986,Friendly,3,3,1,1,0,2,0,0
Rwanda,1995,CECAFA Cup,1,3,0,2,1,3,-2,0
Rwanda,1996,CECAFA Cup,2,3,0,1,1,2,-1,0
Rwanda,1996,FIFA World Cup qualification,1,5,0,2,0,2,-4,0
Rwanda,1996,Friendly,3,4,0,1,2,3,-1,0
Rwanda,1998,African Cup of Nations qualification,0,5,0,1,1,2,-5,0
Rwanda,1998,Friendly,4,2,1,0,1,2,2,0
Rwanda,1999,CECAFA Cup,5,1,2,0,1,3,4,0
Rwanda,1999,Friendly,4,3,1,0,4,5,1,0
Rwanda,2000,African Cup of Nations qualification,3,6,1,1,0,2,-3,0
Rwanda,2000,CECAFA Cup,4,5,1,1,1,3,-1,0
Rwanda,2000,FIFA World Cup qualification,2,4,0,1,1,2,-2,0
Rwanda,2000,Friendly,8,3,4,1,1,6,5,0
Rwanda,2001,CECAFA Cup,7,3,3,1,1,5,4,0
Rwanda,2002,African Cup of Nations qualification,2,4,0,1,0,1,-2,0
Rwanda,2002,CECAFA Cup,6,6,4,2,0,6,0,1
Rwanda,2002,Friendly,0,0,0,0,1,1,0,0
Rwanda,2003,African Cup of Nations qualification,2,0,2,0,1,3,2,0
Rwanda,2003,Afro-Asian Games,3,5,0,1,1,2,-2,0
Rwanda,2003,CECAFA Cup,3,8,0,2,2,4,-5,0
Rwanda,2003,FIFA World Cup qualification,4,1,1,0,1,2,3,0
Rwanda,2003,Friendly,5,7,1,2,1,4,-2,0
Rwanda,2004,African Cup of Nations,3,3,1,1,1,3,0,0
Rwanda,2004,CECAFA Cup,10,6,2,1,1,4,4,0
Rwanda,2004,FIFA World Cup qualification,4,7,1,3,1,5,-3,0
Rwanda,2004,Friendly,5,9,1,2,1,4,-4,0
Rwanda,2005,CECAFA Cup,9,5,4,2,0,6,4,0
Rwanda,2005,FIFA World Cup qualification,2,9,0,4,1,5,-7,0
Rwanda,2005,Friendly,1,1,0,0,1,1,0,0
Rwanda,2006,African Cup of Nations qualification,2,6,0,2,0,2,-4,0
Rwanda,2006,CECAFA Cup,5,3,2,2,2,6,2,0
Rwanda,2006,Friendly,1,2,0,1,1,2,-1,0
Rwanda,2007,African Cup of Nations qualification,8,5,2,2,0,4,3,0
Rwanda,2007,CECAFA Cup,14,5,3,1,2,6,9,0
Rwanda,2007,Friendly,1,2,1,1,0,2,-1,0
Rwanda,2008,FIFA World Cup qualification,7,3,3,1,0,4,4,0
Rwanda,2008,Friendly,0,1,0,1,1,2,-1,0
Rwanda,2009,CECAFA Cup,11,10,5,3,0,8,1,0
Rwanda,2009,FIFA World Cup qualification,1,8,0,4,2,6,-7,0
Rwanda,2009,Friendly,1,4,0,2,0,2,-3,0
Rwanda,2010,African Cup of Nations qualification,0,6,0,2,0,2,-6,0
Rwanda,2010,CECAFA Cup,0,1,0,1,2,3,-1,0
Rwanda,2010,Friendly,1,4,0,2,0,2,-3,0
Rwanda,2011,African Cup of Nations qualification,5,9,2,2,0,4,-4,1
Rwanda,2011,CECAFA Cup,14,6,5,0,1,6,8,0
Rwanda,2011,FIFA World Cup qualification,4,2,1,0,1,2,2,0
Rwanda,2012,African Cup of Nations qualification,0,2,0,1,1,2,-2,0
Rwanda,2012,CECAFA Cup,5,4,2,2,0,4,1,0
Rwanda,2012,FIFA World Cup qualification,1,5,0,1,1,2,-4,0
Rwanda,2012,Friendly,4,11,0,3,3,6,-7,0
Rwanda,2013,CECAFA Cup,1,3,1,3,0,4,-2,0
Rwanda,2013,FIFA World Cup qualification,2,6,0,3,1,4,-4,0
Rwanda,2013,Friendly,2,4,0,2,2,4,-2,0
Rwanda,2014,African Cup of Nations qualification,5,2,2,1,1,4,3,0
Rwanda,2014,Friendly,3,1,2,0,1,3,2,0
Rwanda,2015,African Cup of Nations qualification,1,1,1,1,0,2,0,0
Rwanda,2015,CECAFA Cup,6,4,2,2,2,6,2,0
Rwanda,2015,FIFA World Cup qualification,1,4,0,2,0,2,-3,0
Rwanda,2015,Friendly,5,4,2,2,1,5,1,0
Rwanda,2016,African Cup of Nations qualification,8,5,1,2,1,4,3,0
Rwanda,2016,Friendly,2,3,1,1,1,3,-1,0
Rwanda,2017,African Cup of Nations qualification,1,2,0,1,0,1,-1,0
Rwanda,2017,CECAFA Cup,3,6,1,2,1,4,-3,0
Rwanda,2017,Friendly,2,1,1,0,0,1,1,0
Rwanda,2018,African Cup of Nations qualification,4,7,0,2,2,4,-3,0
Rwanda,2019,African Cup of Nations qualification,0,6,0,3,0,3,-6,0
Rwanda,2019,FIFA World Cup qualification,10,0,2,0,0,2,10,0
Rwanda,2019,Friendly,3,2,1,0,1,2,1,0
Rwanda,2020,African Cup of Nations qualification,0,0,0,0,2,2,0,0
Rwanda,2021,African Cup of Nations qualification,1,0,1,0,1,2,1,0
Rwanda,2021,FIFA World Cup qualification,2,9,0,5,1,6,-7,0
Rwanda,2021,Friendly,7,0,2,0,0,2,7,0
Rwanda,2022,African Cup of Nations qualification,1,2,0,1,1,2,-1,0
Rwanda,2022,Friendly,4,2,2,1,2,5,2,0
Rwanda,2023,African Cup of Nations qualification,3,5,0,1,3,4,-2,0
Rwanda,2023,FIFA World Cup qualification,2,0,1,0,1,2,2,0
Rwanda,2023,Friendly,0,1,0,1,0,1,-1,0
Rwanda,2024,African Cup of Nations qualification,3,5,1,1,2,4,-2,0
Rwanda,2024,FIFA World Cup qualification,1,1,1,1,0,2,0,0
Rwanda,2025,FIFA World Cup qualification,1,3,0,1,1,2,-2,0
Ryūkyū,2016,Friendly,0,9,0,1,0,1,-9,0
Réunion,1947,Friendly,3,6,0,2,0,2,-3,0
Réunion,1948,Friendly,2,7,0,2,0,2,-5,0
Réunion,1949,Friendly,1,9,0,2,0,2,-8,0
Réunion,1950,Friendly,5,17,1,1,0,2,-12,0
Réunion,1951,Friendly,3,13,0,2,0,2,-10,0
Réunion,1952,Friendly,0,7,0,2,0,2,-7,0
Réunion,1953,Friendly,8,15,0,2,0,2,-7,0
Réunion,1954,Friendly,6,13,1,1,0,2,-7,0
Réunion,1955,Friendly,3,7,0,2,0,2,-4,0
Réunion,1956,Friendly,5,12,0,2,0,2,-7,0
Réunion,1957,Friendly,1,2,1,2,0,3,-1,0
Réunion,1958,Friendly,1,5,0,2,0,2,-4,0
Réunion,1959,Friendly,0,1,0,1,0,1,-1,0
Réunion,1960,African Friendship Games,1,4,0,1,0,1,-3,0
Réunion,1963,Friendly,3,6,1,1,0,2,-3,0
Réunion,1973,Friendly,1,1,0,0,1,1,0,0
Réunion,1974,Friendly,2,0,1,0,0,1,2,0
Réunion,1976,Friendly,5,6,1,2,0,3,-1,0
Réunion,1977,Friendly,1,2,1,1,0,2,-1,0
Réunion,1978,Friendly,9,7,2,2,0,4,2,0
Réunion,1979,Indian Ocean Island Games,20,2,4,0,0,4,18,1
Réunion,1981,Friendly,4,11,0,4,0,4,-7,0
Réunion,1982,Friendly,4,4,1,1,1,3,0,0
Réunion,1983,Friendly,3,5,1,1,2,4,-2,0
Réunion,1984,Friendly,1,1,0,0,1,1,0,0
Réunion,1985,Friendly,3,10,0,2,0,2,-7,0
Réunion,1985,Indian Ocean Island Games,14,4,2,0,1,3,10,0
Réunion,1986,Friendly,1,0,1,0,2,3,1,0
Réunion,1987,Friendly,0,3,0,1,0,1,-3,0
Réunion,1988,Friendly,1,0,1,0,0,1,1,0
Réunion,1990,Friendly,2,1,1,0,0,1,1,0
Réunion,1990,Indian Ocean Island Games,0,1,0,1,1,2,-1,0
Réunion,1993,Friendly,3,0,1,0,0,1,3,0
Réunion,1993,Indian Ocean Island Games,5,1,3,1,0,4,4,0
Réunion,1998,Indian Ocean Island Games,10,3,3,0,1,4,7,0
Réunion,2002,Friendly,1,1,0,0,1,1,0,0
Réunion,2003,Friendly,1,1,0,0,1,1,0,0
Réunion,2003,Indian Ocean Island Games,7,2,3,1,0,4,5,0
Réunion,2005,Friendly,2,3,0,1,1,2,-1,0
Réunion,2006,Friendly,3,1,1,0,0,1,2,0
Réunion,2007,Friendly,1,6,0,2,1,3,-5,0
Réunion,2007,Indian Ocean Island Games,2,1,1,0,3,4,1,0
Réunion,2008,Coupe de l'Outre-Mer,9,1,3,0,0,3,8,1
Réunion,2010,Coupe de l'Outre-Mer,14,1,3,0,1,4,13,0
Réunion,2011,Friendly,7,3,2,0,0,2,4,0
Réunion,2011,Indian Ocean Island Games,4,5,2,2,0,4,-1,0
Réunion,2012,Coupe de l'Outre-Mer,16,3,3,0,1,4,13,0
Réunion,2015,Indian Ocean Island Games,8,1,4,0,0,4,7,1
Réunion,2019,Indian Ocean Island Games,10,2,3,1,1,5,8,0
Réunion,2023,Indian Ocean Island Games,3,3,1,1,2,4,0,0
Saare County,1999,Island Games,4,16,0,4,0,4,-12,0
Saare County,2001,Island Games,5,10,1,3,0,4,-5,0
Saare County,2003,Island Games,0,10,0,4,0,4,-10,0
Saare County,2005,Island Games,7,8,1,2,2,5,-1,0
Saare County,2007,Island Games,3,9,0,3,0,3,-6,0
Saare County,2009,Island Games,3,12,0,4,0,4,-9,0
Saare County,2011,Island Games,5,7,1,1,1,3,-2,0
Saare County,2015,Island Games,5,9,1,3,0,4,-4,0
Saare County,2017,Island Games,9,8,1,1,2,4,1,0
Saarland,1953,FIFA World Cup qualification,3,5,1,1,1,3,-2,0
Saarland,1954,FIFA World Cup qualification,1,3,0,1,0,1,-2,0
Saarland,1954,Friendly,2,12,0,2,0,2,-10,0
Saarland,1955,Friendly,1,2,0,1,0,1,-1,0
Saarland,1956,Friendly,3,4,0,1,1,2,-1,0
Saint Barthélemy,2010,Friendly,0,3,0,1,0,1,-3,0
Saint Barthélemy,2012,Friendly,1,8,0,1,0,1,-7,0
Saint Barthélemy,2018,Friendly,12,11,2,2,0,4,1,0
Saint Barthélemy,2019,Friendly,5,4,1,0,1,2,1,0
Saint Barthélemy,2023,Friendly,7,4,1,1,0,2,3,0
Saint Helena,2019,Friendly,2,7,0,1,0,1,-5,0
Saint Helena,2019,Inter Games Football Tournament,2,17,0,3,0,3,-15,0
Saint Helena,2023,Island Games,2,17,0,4,0,4,-15,0
Saint Kitts and Nevis,1938,Friendly,2,8,0,2,0,2,-6,0
Saint Kitts and Nevis,1972,Friendly,0,3,0,1,0,1,-3,0
Saint Kitts and Nevis,1979,CFU Caribbean Cup qualification,2,4,0,2,0,2,-2,0
Saint Kitts and Nevis,1983,CFU Caribbean Cup qualification,0,12,0,2,0,2,-12,0
Saint Kitts and Nevis,1985,Friendly,3,1,2,0,0,2,2,0
Saint Kitts and Nevis,1989,CFU Caribbean Cup qualification,6,5,2,2,0,4,1,0
Saint Kitts and Nevis,1990,CFU Caribbean Cup qualification,2,3,1,1,0,2,-1,0
Saint Kitts and Nevis,1990,Friendly,3,1,1,0,0,1,2,0
Saint Kitts and Nevis,1991,CFU Caribbean Cup qualification,1,1,0,0,2,2,0,0
Saint Kitts and Nevis,1992,CFU Caribbean Cup qualification,14,0,2,0,0,2,14,0
Saint Kitts and Nevis,1993,CFU Caribbean Cup,7,10,1,2,2,5,-3,0
Saint Kitts and Nevis,1993,CFU Caribbean Cup qualification,7,3,1,0,1,2,4,0
Saint Kitts and Nevis,1993,Friendly,0,3,0,1,0,1,-3,0
Saint Kitts and Nevis,1994,CFU Caribbean Cup qualification,11,4,1,1,0,2,7,0
Saint Kitts and Nevis,1995,CFU Caribbean Cup qualification,5,4,1,1,2,4,1,0
Saint Kitts and Nevis,1995,Friendly,1,3,1,1,0,2,-2,0
Saint Kitts and Nevis,1996,CFU Caribbean Cup,3,10,0,2,1,3,-7,0
Saint Kitts and Nevis,1996,CFU Caribbean Cup qualification,11,0,2,0,0,2,11,0
Saint Kitts and Nevis,1996,FIFA World Cup qualification,8,3,2,0,2,4,5,0
Saint Kitts and Nevis,1997,CFU Caribbean Cup,4,8,2,2,0,4,-4,0
Saint Kitts and Nevis,1997,Friendly,1,1,0,0,1,1,0,0
Saint Kitts and Nevis,1997,Gold Cup qualification,0,2,0,1,0,1,-2,0
Saint Kitts and Nevis,1998,CFU Caribbean Cup qualification,7,3,2,1,0,3,4,0
Saint Kitts and Nevis,1998,Friendly,4,12,0,3,0,3,-8,0
Saint Kitts and Nevis,1998,SKN Football Festival,4,1,1,0,0,1,3,1
Saint Kitts and Nevis,1999,CFU Caribbean Cup,0,4,0,2,0,2,-4,0
Saint Kitts and Nevis,1999,CFU Caribbean Cup qualification,9,8,2,1,0,3,1,0
Saint Kitts and Nevis,1999,Friendly,4,1,1,0,0,1,3,0
Saint Kitts and Nevis,2000,FIFA World Cup qualification,15,3,2,2,0,4,12,0
Saint Kitts and Nevis,2000,Friendly,0,2,0,2,0,2,-2,0
Saint Kitts and Nevis,2001,CFU Caribbean Cup,7,8,1,1,1,3,-1,0
Saint Kitts and Nevis,2001,CFU Caribbean Cup qualification,4,3,1,0,1,2,1,0
Saint Kitts and Nevis,2001,Friendly,4,0,2,0,0,2,4,0
Saint Kitts and Nevis,2001,SKN Football Festival,4,2,1,0,1,2,2,0
Saint Kitts and Nevis,2002,Friendly,2,3,0,1,1,2,-1,0
Saint Kitts and Nevis,2002,Gold Cup qualification,2,3,1,1,0,2,-1,0
Saint Kitts and Nevis,2002,SKN Football Festival,8,1,3,0,0,3,7,1
Saint Kitts and Nevis,2003,SKN Football Festival,2,2,1,1,0,2,0,0
Saint Kitts and Nevis,2004,CFU Caribbean Cup qualification,9,5,2,2,1,5,4,0
Saint Kitts and Nevis,2004,FIFA World Cup qualification,18,26,4,6,0,10,-8,0
Saint Kitts and Nevis,2004,Friendly,9,7,2,2,0,4,2,0
Saint Kitts and Nevis,2006,CFU Caribbean Cup qualification,7,3,1,1,1,3,4,0
Saint Kitts and Nevis,2006,Friendly,6,1,1,0,0,1,5,0
Saint Kitts and Nevis,2007,Friendly,7,7,2,2,0,4,0,0
Saint Kitts and Nevis,2008,CFU Caribbean Cup qualification,10,11,1,3,1,5,-1,0
Saint Kitts and Nevis,2008,FIFA World Cup qualification,2,4,0,1,1,2,-2,0
Saint Kitts and Nevis,2008,Friendly,0,2,0,1,0,1,-2,0
Saint Kitts and Nevis,2009,Friendly,6,5,1,2,1,4,1,0
Saint Kitts and Nevis,2010,CFU Caribbean Cup qualification,8,6,2,2,2,6,2,0
Saint Kitts and Nevis,2010,Friendly,5,3,1,1,1,3,2,0
Saint Kitts and Nevis,2011,FIFA World Cup qualification,6,8,1,1,4,6,-2,0
Saint Kitts and Nevis,2011,Friendly,1,0,1,0,1,2,1,0
Saint Kitts and Nevis,2012,CFU Caribbean Cup qualification,0,3,0,1,0,1,-3,0
Saint Kitts and Nevis,2012,Friendly,1,0,1,0,0,1,1,0
Saint Kitts and Nevis,2014,CFU Caribbean Cup qualification,9,4,2,1,1,4,5,0
Saint Kitts and Nevis,2015,FIFA World Cup qualification,15,10,2,1,1,4,5,0
Saint Kitts and Nevis,2015,Friendly,4,4,2,1,0,3,0,0
Saint Kitts and Nevis,2016,CFU Caribbean Cup qualification,5,3,4,2,0,6,2,0
Saint Kitts and Nevis,2016,Friendly,1,1,0,0,1,1,0,0
Saint Kitts and Nevis,2017,Friendly,5,11,2,2,2,6,-6,0
Saint Kitts and Nevis,2018,CONCACAF Nations League qualification,11,1,2,1,0,3,10,0
Saint Kitts and Nevis,2018,Friendly,2,5,0,2,0,2,-3,0
Saint Kitts and Nevis,2019,CONCACAF Nations League,8,8,1,3,2,6,0,0
Saint Kitts and Nevis,2019,CONCACAF Nations League qualification,0,2,0,1,0,1,-2,0
Saint Kitts and Nevis,2019,Friendly,4,3,1,0,0,1,1,0
Saint Kitts and Nevis,2021,FIFA World Cup qualification,8,8,3,3,0,6,0,0
Saint Kitts and Nevis,2022,CONCACAF Nations League,4,3,1,0,1,2,1,0
Saint Kitts and Nevis,2022,Friendly,0,1,0,1,0,1,-1,0
Saint Kitts and Nevis,2023,CONCACAF Nations League,9,13,3,4,1,8,-4,0
Saint Kitts and Nevis,2023,Gold Cup,0,14,0,3,0,3,-14,0
Saint Kitts and Nevis,2023,Gold Cup qualification,2,2,0,0,2,2,0,0
Saint Kitts and Nevis,2024,CONCACAF Nations League,12,8,4,1,1,6,4,0
Saint Kitts and Nevis,2024,FIFA World Cup qualification,1,4,1,1,0,2,-3,0
Saint Kitts and Nevis,2024,Friendly,3,1,1,0,1,2,2,0
Saint Lucia,1938,Friendly,4,6,1,2,0,3,-2,0
Saint Lucia,1961,Windward Islands Tournament,6,7,1,1,1,3,-1,0
Saint Lucia,1964,Windward Islands Tournament,11,4,2,0,2,4,7,1
Saint Lucia,1965,Windward Islands Tournament,2,2,1,1,0,2,0,0
Saint Lucia,1966,Windward Islands Tournament,5,14,0,3,0,3,-9,0
Saint Lucia,1967,Windward Islands Tournament,9,7,2,1,0,3,2,0
Saint Lucia,1968,Windward Islands Tournament,4,0,1,0,0,1,4,0
Saint Lucia,1969,Windward Islands Tournament,4,9,1,2,0,3,-5,0
Saint Lucia,1970,Windward Islands Tournament,2,7,0,1,1,2,-5,0
Saint Lucia,1971,Friendly,1,5,0,1,0,1,-4,0
Saint Lucia,1971,Windward Islands Tournament,4,7,0,1,1,2,-3,0
Saint Lucia,1972,Windward Islands Tournament,4,1,3,0,0,3,3,1
Saint Lucia,1973,Windward Islands Tournament,3,10,1,5,0,6,-7,0
Saint Lucia,1974,Windward Islands Tournament,2,7,0,3,0,3,-5,0
Saint Lucia,1984,Windward Islands Tournament,2,0,1,0,0,1,2,0
Saint Lucia,1985,Friendly,1,4,0,1,0,1,-3,0
Saint Lucia,1985,Windward Islands Tournament,0,0,0,0,1,1,0,0
Saint Lucia,1986,Friendly,0,6,0,1,0,1,-6,0
Saint Lucia,1986,Windward Islands Tournament,5,1,1,0,0,1,4,1
Saint Lucia,1987,Friendly,1,3,0,1,0,1,-2,0
Saint Lucia,1989,CFU Caribbean Cup qualification,1,1,0,0,2,2,0,0
Saint Lucia,1990,CFU Caribbean Cup qualification,2,3,1,2,0,3,-1,0
Saint Lucia,1991,CFU Caribbean Cup,6,4,2,1,2,5,2,0
Saint Lucia,1991,CFU Caribbean Cup qualification,9,0,2,0,0,2,9,0
Saint Lucia,1992,FIFA World Cup qualification,2,3,1,1,0,2,-1,0
Saint Lucia,1993,CFU Caribbean Cup,2,7,0,2,1,3,-5,0
Saint Lucia,1993,CFU Caribbean Cup qualification,6,2,3,0,0,3,4,1
Saint Lucia,1995,CFU Caribbean Cup,1,9,0,3,0,3,-8,0
Saint Lucia,1995,CFU Caribbean Cup qualification,7,4,2,1,1,4,3,0
Saint Lucia,1995,Windward Islands Tournament,3,3,1,1,0,2,0,0
Saint Lucia,1996,CFU Caribbean Cup qualification,2,3,1,2,1,4,-1,0
Saint Lucia,1996,FIFA World Cup qualification,1,6,0,2,0,2,-5,0
Saint Lucia,1997,CFU Caribbean Cup qualification,3,3,1,1,0,2,0,0
Saint Lucia,1997,Friendly,2,5,0,2,1,3,-3,0
Saint Lucia,1998,CFU Caribbean Cup qualification,6,5,2,1,0,3,1,0
Saint Lucia,1998,Friendly,3,1,1,0,1,2,2,0
Saint Lucia,1999,CFU Caribbean Cup qualification,8,7,1,1,1,3,1,0
Saint Lucia,1999,Friendly,10,8,3,3,1,7,2,0
Saint Lucia,2000,FIFA World Cup qualification,1,1,1,1,0,2,0,0
Saint Lucia,2000,Friendly,15,2,4,0,0,4,13,0
Saint Lucia,2001,CFU Caribbean Cup qualification,19,6,2,1,0,3,13,0
Saint Lucia,2001,Friendly,4,7,1,2,1,4,-3,0
Saint Lucia,2001,Windward Islands Tournament,5,7,1,2,1,4,-2,1
Saint Lucia,2002,Friendly,5,13,1,4,0,5,-8,0
Saint Lucia,2002,Gold Cup qualification,13,4,3,1,0,4,9,0
Saint Lucia,2003,Gold Cup qualification,6,11,1,2,0,3,-5,0
Saint Lucia,2004,CFU Caribbean Cup qualification,5,5,1,1,2,4,0,0
Saint Lucia,2004,FIFA World Cup qualification,10,7,2,2,0,4,3,0
Saint Lucia,2004,Friendly,5,8,1,3,1,5,-3,0
Saint Lucia,2006,CFU Caribbean Cup qualification,1,19,0,3,0,3,-18,0
Saint Lucia,2006,Friendly,3,7,0,3,0,3,-4,0
Saint Lucia,2008,FIFA World Cup qualification,4,11,1,3,0,4,-7,0
Saint Lucia,2008,Friendly,1,6,0,1,0,1,-5,0
Saint Lucia,2010,CFU Caribbean Cup qualification,3,5,0,2,1,3,-2,0
Saint Lucia,2010,Friendly,3,17,0,4,1,5,-14,0
Saint Lucia,2011,FIFA World Cup qualification,10,29,1,6,1,8,-19,0
Saint Lucia,2011,Friendly,0,4,0,1,0,1,-4,0
Saint Lucia,2012,CFU Caribbean Cup qualification,5,1,1,0,0,1,4,0
Saint Lucia,2013,Friendly,1,1,1,1,0,2,0,0
Saint Lucia,2013,Windward Islands Tournament,2,0,1,0,0,1,2,1
Saint Lucia,2014,CFU Caribbean Cup qualification,7,8,2,3,0,5,-1,0
Saint Lucia,2014,Friendly,0,8,0,3,1,4,-8,0
Saint Lucia,2014,Windward Islands Tournament,1,0,1,0,0,1,1,0
Saint Lucia,2015,FIFA World Cup qualification,4,5,1,1,0,2,-1,0
Saint Lucia,2015,Windward Islands Tournament,1,4,0,2,0,2,-3,0
Saint Lucia,2017,Windward Islands Tournament,3,2,1,0,2,3,1,0
Saint Lucia,2018,CONCACAF Nations League qualification,4,2,1,1,1,3,2,0
Saint Lucia,2019,CONCACAF Nations League,2,10,1,4,1,6,-8,0
Saint Lucia,2019,CONCACAF Nations League qualification,3,2,1,0,0,1,1,0
Saint Lucia,2022,CONCACAF Nations League,3,0,2,0,0,2,3,0
Saint Lucia,2022,Friendly,2,2,1,1,1,3,0,0
Saint Lucia,2023,CONCACAF Nations League,15,8,5,2,1,8,7,0
Saint Lucia,2023,Friendly,2,3,1,1,0,2,-1,0
Saint Lucia,2023,Gold Cup qualification,1,3,0,1,0,1,-2,0
Saint Lucia,2024,CONCACAF Nations League,7,15,3,3,0,6,-8,0
Saint Lucia,2024,FIFA World Cup qualification,3,4,0,1,1,2,-1,0
Saint Martin,1990,CFU Caribbean Cup qualification,5,2,2,1,0,3,3,0
Saint Martin,1997,Friendly,1,2,0,1,0,1,-1,0
Saint Martin,2001,CFU Caribbean Cup qualification,9,7,3,2,0,5,2,0
Saint Martin,2002,Friendly,3,1,2,0,0,2,2,0
Saint Martin,2002,Gold Cup qualification,4,15,0,2,0,2,-11,0
Saint Martin,2004,CFU Caribbean Cup qualification,0,14,0,2,1,3,-14,0
Saint Martin,2006,CFU Caribbean Cup qualification,0,2,0,2,1,3,-2,0
Saint Martin,2006,Friendly,1,6,0,1,0,1,-5,0
Saint Martin,2007,Friendly,0,1,0,1,0,1,-1,0
Saint Martin,2008,CFU Caribbean Cup qualification,2,13,0,3,0,3,-11,0
Saint Martin,2010,CFU Caribbean Cup qualification,2,5,0,2,1,3,-3,0
Saint Martin,2010,Friendly,9,2,3,0,0,3,7,0
Saint Martin,2012,CFU Caribbean Cup qualification,0,24,0,3,0,3,-24,0
Saint Martin,2014,Friendly,4,2,1,0,0,1,2,0
Saint Martin,2018,CONCACAF Nations League qualification,2,18,0,3,0,3,-16,0
Saint Martin,2018,Friendly,4,4,1,1,0,2,0,0
Saint Martin,2019,CONCACAF Nations League,7,8,3,3,0,6,-1,0
Saint Martin,2019,CONCACAF Nations League qualification,3,4,0,1,0,1,-1,0
Saint Martin,2019,Friendly,3,4,0,1,0,1,-1,0
Saint Martin,2022,CONCACAF Nations League,1,4,0,1,2,3,-3,0
Saint Martin,2023,CONCACAF Nations League,21,4,4,1,0,5,17,0
Saint Martin,2023,Friendly,3,2,1,0,0,1,1,0
Saint Martin,2024,CONCACAF Nations League,8,13,2,4,0,6,-5,0
Saint Pierre and Miquelon,2010,Coupe de l'Outre-Mer,0,28,0,3,0,3,-28,0
Saint Pierre and Miquelon,2012,Coupe de l'Outre-Mer,2,50,0,4,0,4,-48,0
Saint Vincent and the Grenadines,1961,Windward Islands Tournament,9,6,1,0,2,3,3,0
Saint Vincent and the Grenadines,1962,Windward Islands Tournament,1,2,0,1,0,1,-1,0
Saint Vincent and the Grenadines,1964,Windward Islands Tournament,5,5,0,0,4,4,0,0
Saint Vincent and the Grenadines,1965,Windward Islands Tournament,4,3,1,1,0,2,1,1
Saint Vincent and the Grenadines,1966,Windward Islands Tournament,6,2,3,0,0,3,4,1
Saint Vincent and the Grenadines,1967,Windward Islands Tournament,6,6,1,1,1,3,0,1
Saint Vincent and the Grenadines,1968,Windward Islands Tournament,1,1,0,0,1,1,0,0
Saint Vincent and the Grenadines,1969,Windward Islands Tournament,3,1,2,0,1,3,2,0
Saint Vincent and the Grenadines,1970,Windward Islands Tournament,4,5,1,1,0,2,-1,0
Saint Vincent and the Grenadines,1971,Friendly,5,1,1,0,0,1,4,0
Saint Vincent and the Grenadines,1971,Windward Islands Tournament,1,4,0,1,1,2,-3,0
Saint Vincent and the Grenadines,1972,Windward Islands Tournament,3,3,1,1,1,3,0,0
Saint Vincent and the Grenadines,1973,Windward Islands Tournament,9,3,3,0,2,5,6,0
Saint Vincent and the Grenadines,1974,Windward Islands Tournament,4,3,2,1,0,3,1,0
Saint Vincent and the Grenadines,1979,CFU Caribbean Cup,4,5,1,1,0,2,-1,0
Saint Vincent and the Grenadines,1979,CFU Caribbean Cup qualification,6,3,2,0,2,4,3,0
Saint Vincent and the Grenadines,1981,CFU Caribbean Cup,5,3,2,1,0,3,2,1
Saint Vincent and the Grenadines,1981,CFU Caribbean Cup qualification,12,10,4,1,1,6,2,0
Saint Vincent and the Grenadines,1983,CFU Caribbean Cup qualification,1,3,0,1,0,1,-2,0
Saint Vincent and the Grenadines,1984,Windward Islands Tournament,0,2,0,1,0,1,-2,0
Saint Vincent and the Grenadines,1985,CFU Caribbean Cup qualification,4,1,1,0,1,2,3,0
Saint Vincent and the Grenadines,1985,Friendly,1,2,0,1,0,1,-1,0
Saint Vincent and the Grenadines,1985,Windward Islands Tournament,0,0,0,0,2,2,0,0
Saint Vincent and the Grenadines,1986,Windward Islands Tournament,1,5,0,1,0,1,-4,0
Saint Vincent and the Grenadines,1987,Friendly,0,3,0,1,0,1,-3,0
Saint Vincent and the Grenadines,1989,CFU Caribbean Cup,1,3,0,1,1,2,-2,0
Saint Vincent and the Grenadines,1989,CFU Caribbean Cup qualification,3,2,1,0,0,1,1,0
Saint Vincent and the Grenadines,1990,CFU Caribbean Cup qualification,4,3,1,0,1,2,1,0
Saint Vincent and the Grenadines,1992,CFU Caribbean Cup qualification,2,2,0,0,1,1,0,0
Saint Vincent and the Grenadines,1992,FIFA World Cup qualification,5,32,2,7,1,10,-27,0
Saint Vincent and the Grenadines,1992,Friendly,3,4,0,1,1,2,-1,0
Saint Vincent and the Grenadines,1993,CFU Caribbean Cup,4,1,1,0,0,1,3,0
Saint Vincent and the Grenadines,1993,CFU Caribbean Cup qualification,2,1,1,1,0,2,1,0
Saint Vincent and the Grenadines,1994,CFU Caribbean Cup qualification,2,0,1,0,0,1,2,0
Saint Vincent and the Grenadines,1995,CFU Caribbean Cup,8,2,2,0,0,2,6,0
Saint Vincent and the Grenadines,1995,Windward Islands Tournament,3,4,1,3,0,4,-1,0
Saint Vincent and the Grenadines,1996,CFU Caribbean Cup,0,2,0,1,0,1,-2,0
Saint Vincent and the Grenadines,1996,FIFA World Cup qualification,17,33,2,6,2,10,-16,0
Saint Vincent and the Grenadines,1996,Gold Cup,0,8,0,2,0,2,-8,0
Saint Vincent and the Grenadines,1997,CFU Caribbean Cup qualification,2,3,0,1,0,1,-1,0
Saint Vincent and the Grenadines,1998,CFU Caribbean Cup qualification,2,3,0,1,0,1,-1,0
Saint Vincent and the Grenadines,1998,Friendly,9,2,2,0,0,2,7,0
Saint Vincent and the Grenadines,1999,CFU Caribbean Cup qualification,5,6,0,1,1,2,-1,0
Saint Vincent and the Grenadines,1999,Friendly,2,1,1,0,0,1,1,0
Saint Vincent and the Grenadines,2000,FIFA World Cup qualification,24,29,5,7,0,12,-5,0
Saint Vincent and the Grenadines,2000,Friendly,3,1,2,0,0,2,2,0
Saint Vincent and the Grenadines,2001,Windward Islands Tournament,4,0,2,0,0,2,4,0
Saint Vincent and the Grenadines,2004,FIFA World Cup qualification,11,15,3,4,1,8,-4,0
Saint Vincent and the Grenadines,2004,Friendly,8,6,2,1,2,5,2,0
Saint Vincent and the Grenadines,2006,CFU Caribbean Cup qualification,8,0,1,0,0,1,8,0
Saint Vincent and the Grenadines,2006,Friendly,4,4,0,0,3,3,0,0
Saint Vincent and the Grenadines,2007,CFU Caribbean Cup,0,1,0,1,0,1,-1,0
Saint Vincent and the Grenadines,2007,Friendly,0,3,0,1,0,1,-3,0
Saint Vincent and the Grenadines,2008,FIFA World Cup qualification,1,7,0,2,0,2,-6,0
Saint Vincent and the Grenadines,2008,Friendly,0,1,0,1,0,1,-1,0
Saint Vincent and the Grenadines,2009,Friendly,1,4,0,1,1,2,-3,0
Saint Vincent and the Grenadines,2010,CFU Caribbean Cup qualification,1,1,0,0,1,1,0,0
Saint Vincent and the Grenadines,2010,Friendly,5,1,1,0,0,1,4,0
Saint Vincent and the Grenadines,2011,FIFA World Cup qualification,4,12,1,3,2,6,-8,0
Saint Vincent and the Grenadines,2011,Friendly,3,2,1,0,1,2,1,0
Saint Vincent and the Grenadines,2012,CFU Caribbean Cup qualification,4,0,1,0,0,1,4,0
Saint Vincent and the Grenadines,2013,Windward Islands Tournament,0,2,0,1,0,1,-2,0
Saint Vincent and the Grenadines,2014,CFU Caribbean Cup qualification,5,0,2,0,0,2,5,0
Saint Vincent and the Grenadines,2015,FIFA World Cup qualification,10,18,1,3,2,6,-8,0
Saint Vincent and the Grenadines,2015,Windward Islands Tournament,2,1,1,0,0,1,1,0
Saint Vincent and the Grenadines,2016,CFU Caribbean Cup qualification,0,1,0,1,0,1,-1,0
Saint Vincent and the Grenadines,2016,FIFA World Cup qualification,5,24,0,4,0,4,-19,0
Saint Vincent and the Grenadines,2017,Friendly,7,6,1,1,0,2,1,0
Saint Vincent and the Grenadines,2017,Windward Islands Tournament,3,4,0,1,1,2,-1,0
Saint Vincent and the Grenadines,2018,CONCACAF Nations League qualification,3,5,1,2,0,3,-2,0
Saint Vincent and the Grenadines,2018,Friendly,1,1,0,0,1,1,0,0
Saint Vincent and the Grenadines,2019,CONCACAF Nations League,6,4,3,1,2,6,2,0
Saint Vincent and the Grenadines,2019,CONCACAF Nations League qualification,2,1,1,0,0,1,1,0
Saint Vincent and the Grenadines,2019,Friendly,2,2,1,1,1,3,0,0
Saint Vincent and the Grenadines,2021,FIFA World Cup qualification,3,16,1,3,0,4,-13,0
Saint Vincent and the Grenadines,2021,Gold Cup qualification,1,6,0,1,0,1,-5,0
Saint Vincent and the Grenadines,2022,CONCACAF Nations League,3,9,0,3,1,4,-6,0
Saint Vincent and the Grenadines,2022,Friendly,6,11,1,3,0,4,-5,0
Saint Vincent and the Grenadines,2023,CONCACAF Nations League,15,19,3,4,1,8,-4,0
Saint Vincent and the Grenadines,2024,CONCACAF Nations League,12,7,4,1,1,6,5,0
Saint Vincent and the Grenadines,2024,FIFA World Cup qualification,2,7,0,2,0,2,-5,0
Saint Vincent and the Grenadines,2024,Friendly,3,0,1,0,0,1,3,0
Saint Vincent and the Grenadines,2025,Friendly,1,1,0,0,1,1,0,0
Saint Vincent and the Grenadines,2025,Gold Cup qualification,1,4,0,1,1,2,-3,0
Samoa,1979,South Pacific Games,3,19,0,3,0,3,-16,0
Samoa,1981,South Pacific Mini Games,2,47,0,6,0,6,-45,0
Samoa,1983,South Pacific Games,7,8,1,2,1,4,-1,0
Samoa,1994,Oceania Nations Cup qualification,5,10,1,1,1,3,-5,0
Samoa,1996,FIFA World Cup qualification,2,2,1,1,0,2,0,0
Samoa,1998,Oceania Nations Cup qualification,8,7,2,2,0,4,1,0
Samoa,2001,FIFA World Cup qualification,9,18,1,3,0,4,-9,0
Samoa,2002,Oceania Nations Cup qualification,8,9,2,2,0,4,-1,0
Samoa,2004,FIFA World Cup qualification,5,11,1,3,0,4,-6,0
Samoa,2004,Friendly,0,0,0,0,1,1,0,0
Samoa,2007,South Pacific Games,9,8,2,2,0,4,1,0
Samoa,2011,FIFA World Cup qualification,5,3,2,0,1,3,2,0
Samoa,2011,Friendly,1,11,0,3,0,3,-10,0
Samoa,2012,Oceania Nations Cup,1,24,0,3,0,3,-23,0
Samoa,2015,FIFA World Cup qualification,6,3,2,1,0,3,3,0
Samoa,2016,Oceania Nations Cup,0,19,0,3,0,3,-19,0
Samoa,2019,Pacific Games,2,17,1,2,0,3,-15,0
Samoa,2023,Pacific Games,14,3,2,2,0,4,11,0
Samoa,2024,FIFA World Cup qualification,5,16,2,3,0,5,-11,0
Samoa,2024,Oceania Nations Cup,2,13,0,3,0,3,-11,0
Samoa,2024,Oceania Nations Cup qualification,5,1,2,0,0,2,4,0
San Marino,1990,UEFA Euro qualification,0,10,0,2,0,2,-10,0
San Marino,1991,UEFA Euro qualification,1,23,0,6,0,6,-22,0
San Marino,1992,FIFA World Cup qualification,1,16,0,3,0,3,-15,0
San Marino,1992,Friendly,0,4,0,1,0,1,-4,0
San Marino,1993,FIFA World Cup qualification,1,30,0,6,1,7,-29,0
San Marino,1994,UEFA Euro qualification,1,10,0,3,0,3,-9,0
San Marino,1995,UEFA Euro qualification,1,26,0,7,0,7,-25,0
San Marino,1996,FIFA World Cup qualification,0,21,0,4,0,4,-21,0
San Marino,1997,FIFA World Cup qualification,0,21,0,4,0,4,-21,0
San Marino,1998,UEFA Euro qualification,1,10,0,3,0,3,-9,0
San Marino,1999,UEFA Euro qualification,0,34,0,5,0,5,-34,0
San Marino,2000,FIFA World Cup qualification,0,3,0,2,0,2,-3,0
San Marino,2000,Friendly,0,1,0,1,0,1,-1,0
San Marino,2001,FIFA World Cup qualification,3,27,0,5,1,6,-24,0
San Marino,2002,Friendly,0,1,0,1,0,1,-1,0
San Marino,2002,UEFA Euro qualification,0,6,0,3,0,3,-6,0
San Marino,2003,Friendly,2,2,0,0,1,1,0,0
San Marino,2003,UEFA Euro qualification,0,24,0,5,0,5,-24,0
San Marino,2004,FIFA World Cup qualification,0,13,0,4,0,4,-13,0
San Marino,2004,Friendly,1,0,1,0,0,1,1,0
San Marino,2005,FIFA World Cup qualification,2,27,0,6,0,6,-25,0
San Marino,2006,Friendly,0,3,0,1,0,1,-3,0
San Marino,2006,UEFA Euro qualification,0,25,0,3,0,3,-25,0
San Marino,2007,UEFA Euro qualification,2,32,0,9,0,9,-30,0
San Marino,2008,FIFA World Cup qualification,1,12,0,4,0,4,-11,0
San Marino,2009,FIFA World Cup qualification,0,35,0,6,0,6,-35,0
San Marino,2010,UEFA Euro qualification,0,29,0,5,0,5,-29,0
San Marino,2011,Friendly,0,2,0,2,0,2,-2,0
San Marino,2011,UEFA Euro qualification,0,24,0,5,0,5,-24,0
San Marino,2012,FIFA World Cup qualification,0,16,0,4,0,4,-16,0
San Marino,2012,Friendly,2,3,0,1,0,1,-1,0
San Marino,2013,FIFA World Cup qualification,1,38,0,6,0,6,-37,0
San Marino,2013,Friendly,0,4,0,1,0,1,-4,0
San Marino,2014,Friendly,0,3,0,1,0,1,-3,0
San Marino,2014,UEFA Euro qualification,0,11,0,3,1,4,-11,0
San Marino,2015,Friendly,0,1,0,1,0,1,-1,0
San Marino,2015,UEFA Euro qualification,1,25,0,6,0,6,-24,0
San Marino,2016,FIFA World Cup qualification,1,17,0,4,0,4,-16,0
San Marino,2016,Friendly,0,10,0,1,0,1,-10,0
San Marino,2017,FIFA World Cup qualification,1,34,0,6,0,6,-33,0
San Marino,2017,Friendly,0,10,0,2,0,2,-10,0
San Marino,2018,UEFA Nations League,0,16,0,6,0,6,-16,0
San Marino,2019,UEFA Euro qualification,1,51,0,10,0,10,-50,0
San Marino,2020,Friendly,0,7,0,2,0,2,-7,0
San Marino,2020,UEFA Nations League,0,3,0,2,2,4,-3,0
San Marino,2021,FIFA World Cup qualification,1,46,0,10,0,10,-45,0
San Marino,2021,Friendly,1,11,0,2,0,2,-10,0
San Marino,2022,Friendly,2,7,0,4,2,6,-5,0
San Marino,2022,UEFA Nations League,0,9,0,4,0,4,-9,0
San Marino,2023,UEFA Euro qualification,3,31,0,10,0,10,-28,0
San Marino,2024,Friendly,2,14,0,5,1,6,-12,0
San Marino,2024,UEFA Nations League,5,3,2,1,1,4,2,0
San Marino,2025,FIFA World Cup qualification,1,7,0,2,0,2,-6,0
Sark,2003,Island Games,0,70,0,4,0,4,-70,0
Saudi Arabia,1963,Friendly,0,7,0,1,0,1,-7,0
Saudi Arabia,1967,Friendly,4,0,1,0,0,1,4,0
Saudi Arabia,1969,Friendly,1,2,0,1,0,1,-1,0
Saudi Arabia,1970,Gulf Cup,2,4,0,1,2,3,-2,0
Saudi Arabia,1972,Gulf Cup,12,3,3,0,1,4,9,1
Saudi Arabia,1974,Friendly,0,0,0,0,1,1,0,0
Saudi Arabia,1974,Gulf Cup,11,6,4,1,0,5,5,0
Saudi Arabia,1975,AFC Asian Cup qualification,12,5,3,2,1,6,7,0
Saudi Arabia,1975,Palestine Cup,1,3,0,2,0,2,-2,0
Saudi Arabia,1976,FIFA World Cup qualification,3,2,1,1,0,2,1,0
Saudi Arabia,1976,Friendly,1,8,0,4,1,5,-7,0
Saudi Arabia,1976,Gulf Cup,8,14,2,4,0,6,-6,0
Saudi Arabia,1977,FIFA World Cup qualification,0,5,0,2,0,2,-5,0
Saudi Arabia,1978,Asian Games,3,4,0,1,2,3,-1,0
Saudi Arabia,1979,Gulf Cup,14,4,3,1,2,6,10,0
Saudi Arabia,1980,Friendly,14,11,3,4,1,8,3,0
Saudi Arabia,1981,FIFA World Cup qualification,9,16,4,5,1,10,-7,0
Saudi Arabia,1981,Friendly,6,5,2,2,0,4,1,0
Saudi Arabia,1982,Asian Games,7,4,3,1,2,6,3,0
Saudi Arabia,1982,Friendly,2,1,1,0,1,2,1,0
Saudi Arabia,1982,Gulf Cup,6,4,2,2,1,5,2,0
Saudi Arabia,1984,AFC Asian Cup,7,3,3,0,3,6,4,1
Saudi Arabia,1984,AFC Asian Cup qualification,19,0,4,0,0,4,19,0
Saudi Arabia,1984,Friendly,10,9,3,2,0,5,1,0
Saudi Arabia,1984,Gulf Cup,9,8,3,2,1,6,1,0
Saudi Arabia,1985,Arab Cup,7,3,2,1,1,4,4,0
Saudi Arabia,1985,FIFA World Cup qualification,0,1,0,1,1,2,-1,0
Saudi Arabia,1985,Friendly,3,6,1,2,0,3,-3,0
Saudi Arabia,1986,Asian Games,9,6,3,1,2,6,3,0
Saudi Arabia,1986,Friendly,6,4,1,2,3,6,2,0
Saudi Arabia,1986,Gulf Cup,9,9,3,3,0,6,0,0
Saudi Arabia,1988,AFC Asian Cup,5,1,3,0,3,6,4,0
Saudi Arabia,1988,Friendly,13,19,3,5,4,12,-6,0
Saudi Arabia,1988,Gulf Cup,5,4,2,1,3,6,1,0
Saudi Arabia,1989,FIFA World Cup qualification,11,9,4,2,3,9,2,0
Saudi Arabia,1990,Asian Games,6,0,2,0,1,3,6,0
Saudi Arabia,1992,AFC Asian Cup,8,3,2,1,2,5,5,0
Saudi Arabia,1992,Arab Cup,7,5,2,1,1,4,2,0
Saudi Arabia,1992,Confederations Cup,4,3,1,1,0,2,1,0
Saudi Arabia,1992,Friendly,2,1,1,0,0,1,1,0
Saudi Arabia,1992,Gulf Cup,6,4,3,2,0,5,2,1
Saudi Arabia,1993,FIFA World Cup qualification,28,7,6,0,5,11,21,0
Saudi Arabia,1993,Friendly,22,7,7,1,0,8,15,0
Saudi Arabia,1994,Asian Games,9,10,3,2,0,5,-1,0
Saudi Arabia,1994,FIFA World Cup,5,6,2,2,0,4,-1,0
Saudi Arabia,1994,Friendly,15,23,6,8,3,17,-8,1
Saudi Arabia,1994,Gulf Cup,10,4,4,0,1,5,6,0
Saudi Arabia,1995,Confederations Cup,0,4,0,2,0,2,-4,0
Saudi Arabia,1995,Friendly,10,11,1,4,1,6,-1,1
Saudi Arabia,1996,AFC Asian Cup,11,6,3,1,2,6,5,0
Saudi Arabia,1996,AFC Asian Cup qualification,10,0,4,0,0,4,10,0
Saudi Arabia,1996,Friendly,16,10,5,2,2,9,6,0
Saudi Arabia,1996,Gulf Cup,8,6,2,1,2,5,2,0
Saudi Arabia,1997,Confederations Cup,1,8,1,2,0,3,-7,0
Saudi Arabia,1997,FIFA World Cup qualification,26,7,9,2,3,14,19,0
Saudi Arabia,1997,Friendly,13,2,4,0,1,5,11,0
Saudi Arabia,1998,Arab Cup,9,3,3,0,0,3,6,1
Saudi Arabia,1998,FIFA World Cup,2,7,0,2,1,3,-5,0
Saudi Arabia,1998,Friendly,18,15,5,2,4,11,3,0
Saudi Arabia,1998,Gulf Cup,5,2,3,0,2,5,3,0
Saudi Arabia,1999,Confederations Cup,8,16,1,3,1,5,-8,0
Saudi Arabia,1999,Friendly,13,6,5,3,2,10,7,0
Saudi Arabia,2000,AFC Asian Cup,11,8,3,2,1,6,3,0
Saudi Arabia,2000,Friendly,17,8,5,2,3,10,9,0
Saudi Arabia,2001,FIFA World Cup qualification,47,8,11,1,2,14,39,0
Saudi Arabia,2001,Friendly,15,8,6,3,1,10,7,0
Saudi Arabia,2002,Arab Cup,9,3,4,0,1,5,6,1
Saudi Arabia,2002,FIFA World Cup,0,12,0,3,0,3,-12,0
Saudi Arabia,2002,Friendly,9,9,4,3,1,8,0,0
Saudi Arabia,2002,Gulf Cup,10,3,4,0,1,5,7,1
Saudi Arabia,2003,AFC Asian Cup qualification,31,1,6,0,0,6,30,0
Saudi Arabia,2003,Friendly,3,3,1,1,2,4,0,0
Saudi Arabia,2003,Gulf Cup,2,0,1,0,1,2,2,0
Saudi Arabia,2004,AFC Asian Cup,3,5,0,2,1,3,-2,0
Saudi Arabia,2004,FIFA World Cup qualification,14,1,6,0,0,6,13,0
Saudi Arabia,2004,Friendly,3,3,0,0,2,2,0,0
Saudi Arabia,2004,Gulf Cup,9,7,4,2,1,7,2,0
Saudi Arabia,2005,FIFA World Cup qualification,10,1,4,0,2,6,9,0
Saudi Arabia,2005,Friendly,10,16,3,5,2,10,-6,0
Saudi Arabia,2006,AFC Asian Cup qualification,21,4,5,1,0,6,17,0
Saudi Arabia,2006,FIFA World Cup,2,7,0,2,1,3,-5,0
Saudi Arabia,2006,Friendly,14,19,4,6,5,15,-5,0
Saudi Arabia,2007,AFC Asian Cup,12,6,4,1,1,6,6,0
Saudi Arabia,2007,Friendly,19,4,7,0,2,9,15,0
Saudi Arabia,2007,Gulf Cup,4,3,2,1,1,4,1,0
Saudi Arabia,2008,FIFA World Cup qualification,18,9,6,2,1,9,9,0
Saudi Arabia,2008,Friendly,14,6,6,1,2,9,8,0
Saudi Arabia,2009,FIFA World Cup qualification,7,6,2,1,4,7,1,0
Saudi Arabia,2009,Friendly,12,8,4,2,2,8,4,0
Saudi Arabia,2009,Gulf Cup,10,0,3,0,2,5,10,0
Saudi Arabia,2010,Friendly,10,6,4,3,3,10,4,0
Saudi Arabia,2010,Gulf Cup,6,2,2,1,2,5,4,0
Saudi Arabia,2011,AFC Asian Cup,1,8,0,3,0,3,-7,0
Saudi Arabia,2011,FIFA World Cup qualification,12,3,3,1,3,7,9,0
Saudi Arabia,2011,Friendly,1,2,0,1,3,4,-1,0
Saudi Arabia,2012,Arab Cup,6,5,1,2,1,4,1,0
Saudi Arabia,2012,FIFA World Cup qualification,2,4,0,1,0,1,-2,0
Saudi Arabia,2012,Friendly,7,8,2,2,1,5,-1,0
Saudi Arabia,2012,WAFF Championship,1,1,1,1,1,3,0,0
Saudi Arabia,2013,AFC Asian Cup qualification,8,3,4,0,1,5,5,0
Saudi Arabia,2013,Friendly,4,1,1,0,0,1,3,0
Saudi Arabia,2013,Gulf Cup,2,3,1,2,0,3,-1,0
Saudi Arabia,2013,OSN Cup,1,4,0,2,0,2,-3,0
Saudi Arabia,2013,WAFF Championship,1,4,0,1,1,2,-3,0
Saudi Arabia,2014,AFC Asian Cup qualification,1,0,1,0,0,1,1,0
Saudi Arabia,2014,Friendly,7,15,1,4,2,7,-8,0
Saudi Arabia,2014,Gulf Cup,9,5,3,1,1,5,4,0
Saudi Arabia,2015,AFC Asian Cup,5,5,1,2,0,3,0,0
Saudi Arabia,2015,FIFA World Cup qualification,25,3,5,0,1,6,22,0
Saudi Arabia,2015,Friendly,2,3,1,1,0,2,-1,0
Saudi Arabia,2016,FIFA World Cup qualification,12,6,4,1,2,7,6,0
Saudi Arabia,2016,Friendly,4,0,1,0,0,1,4,0
Saudi Arabia,2017,FIFA World Cup qualification,8,5,3,2,0,5,3,0
Saudi Arabia,2017,Friendly,12,11,2,3,0,5,1,0
Saudi Arabia,2017,Gulf Cup,2,3,1,1,1,3,-1,0
Saudi Arabia,2018,FIFA World Cup,2,7,1,2,0,3,-5,0
Saudi Arabia,2018,Friendly,16,22,4,6,5,15,-6,0
Saudi Arabia,2019,AFC Asian Cup,6,3,2,2,0,4,3,0
Saudi Arabia,2019,FIFA World Cup qualification,8,4,2,0,2,4,4,0
Saudi Arabia,2019,Friendly,5,5,1,1,2,4,0,0
Saudi Arabia,2019,Gulf Cup,7,5,3,2,0,5,2,0
Saudi Arabia,2019,WAFF Championship,1,5,0,2,1,3,-4,0
Saudi Arabia,2020,Friendly,4,2,1,1,0,2,2,0
Saudi Arabia,2021,Arab Cup,1,3,0,2,1,3,-2,0
Saudi Arabia,2021,FIFA World Cup qualification,23,3,9,0,1,10,20,0
Saudi Arabia,2021,Friendly,1,0,1,0,0,1,1,0
Saudi Arabia,2022,FIFA World Cup,3,5,1,2,0,3,-2,0
Saudi Arabia,2022,FIFA World Cup qualification,3,3,2,1,1,4,0,0
Saudi Arabia,2022,Friendly,4,5,2,3,5,10,-1,0
Saudi Arabia,2023,FIFA World Cup qualification,6,0,2,0,0,2,6,0
Saudi Arabia,2023,Friendly,6,13,0,5,1,6,-7,0
Saudi Arabia,2023,Gulf Cup,3,4,1,2,0,3,-1,0
Saudi Arabia,2024,AFC Asian Cup,5,2,2,0,2,4,3,0
Saudi Arabia,2024,FIFA World Cup qualification,9,9,3,3,4,10,0,0
Saudi Arabia,2024,Friendly,3,0,2,0,1,3,3,0
Saudi Arabia,2024,Gulf Cup,9,8,2,2,0,4,1,0
Saudi Arabia,2025,FIFA World Cup qualification,1,0,1,0,1,2,1,0
Saugeais,2013,Friendly,1,1,0,0,1,1,0,0
Scotland,1872,Friendly,0,0,0,0,1,1,0,0
Scotland,1873,Friendly,2,4,0,1,0,1,-2,0
Scotland,1874,Friendly,2,1,1,0,0,1,1,1
Scotland,1875,Friendly,2,2,0,0,1,1,0,0
Scotland,1876,Friendly,7,0,2,0,0,2,7,1
Scotland,1877,Friendly,5,1,2,0,0,2,4,1
Scotland,1878,Friendly,16,2,2,0,0,2,14,1
Scotland,1879,Friendly,7,5,1,1,0,2,2,1
Scotland,1880,Friendly,10,5,2,0,0,2,5,1
Scotland,1881,Friendly,11,2,2,0,0,2,9,1
Scotland,1882,Friendly,10,1,2,0,0,2,9,1
Scotland,1883,Friendly,6,2,2,0,0,2,4,0
Scotland,1884,British Home Championship,10,1,3,0,0,3,9,1
Scotland,1885,British Home Championship,17,4,2,0,1,3,13,0
Scotland,1886,British Home Championship,12,4,2,0,1,3,8,1
Scotland,1887,British Home Championship,9,3,3,0,0,3,6,1
Scotland,1888,British Home Championship,15,8,2,1,0,3,7,0
Scotland,1888,Friendly,4,0,1,0,0,1,4,1
Scotland,1889,British Home Championship,10,2,2,0,1,3,8,0
Scotland,1890,British Home Championship,10,2,2,0,1,3,8,0
Scotland,1891,British Home Championship,7,6,2,1,0,3,1,0
Scotland,1892,British Home Championship,10,7,2,1,0,3,3,0
Scotland,1893,British Home Championship,16,6,2,1,0,3,10,0
Scotland,1894,British Home Championship,9,5,2,0,1,3,4,0
Scotland,1895,British Home Championship,5,6,1,1,1,3,-1,0
Scotland,1896,British Home Championship,9,4,2,0,1,3,5,1
Scotland,1897,British Home Championship,9,4,2,0,1,3,5,1
Scotland,1898,British Home Championship,9,5,2,1,0,3,4,0
Scotland,1899,British Home Championship,16,3,2,1,0,3,13,0
Scotland,1900,British Home Championship,12,3,3,0,0,3,9,1
Scotland,1901,British Home Championship,14,3,1,0,2,3,11,0
Scotland,1902,British Home Championship,12,4,2,0,1,3,8,0
Scotland,1903,British Home Championship,3,3,2,1,0,3,0,1
Scotland,1904,British Home Championship,2,3,0,1,2,3,-1,0
Scotland,1905,British Home Championship,5,4,1,2,0,3,1,0
Scotland,1906,British Home Championship,3,3,2,1,0,3,0,1
Scotland,1907,British Home Championship,4,2,1,1,1,3,2,0
Scotland,1908,British Home Championship,8,2,2,0,1,3,6,0
Scotland,1909,British Home Championship,7,5,1,2,0,3,2,0
Scotland,1910,British Home Championship,3,1,2,1,0,3,2,0
Scotland,1911,British Home Championship,5,3,1,0,2,3,2,0
Scotland,1912,British Home Championship,6,2,2,0,1,3,4,0
Scotland,1913,British Home Championship,2,2,1,1,1,3,0,0
Scotland,1914,British Home Championship,4,2,1,0,2,3,2,1
Scotland,1920,British Home Championship,8,6,1,1,1,3,2,0
Scotland,1921,British Home Championship,7,1,3,0,0,3,6,0
Scotland,1921,Friendly,1,0,1,0,0,1,1,0
Scotland,1922,British Home Championship,4,3,2,1,0,3,1,0
Scotland,1923,British Home Championship,5,2,2,0,1,3,3,0
Scotland,1924,British Home Championship,3,3,1,1,1,3,0,0
Scotland,1925,British Home Championship,11,1,4,0,0,4,10,1
Scotland,1926,British Home Championship,8,0,3,0,0,3,8,1
Scotland,1927,British Home Championship,5,4,1,1,1,3,1,0
Scotland,1928,British Home Championship,9,4,2,1,0,3,5,0
Scotland,1929,British Home Championship,12,5,3,0,0,3,7,0
Scotland,1929,Friendly,10,4,2,0,1,3,6,0
Scotland,1930,British Home Championship,6,7,1,1,1,3,-1,0
Scotland,1930,Friendly,2,0,1,0,0,1,2,0
Scotland,1931,British Home Championship,8,3,3,0,1,4,5,0
Scotland,1931,Friendly,3,10,1,2,0,3,-7,0
Scotland,1932,British Home Championship,6,8,1,2,0,3,-2,0
Scotland,1932,Friendly,3,1,1,0,0,1,2,0
Scotland,1933,British Home Championship,5,6,1,2,0,3,-1,0
Scotland,1933,Friendly,2,2,0,0,1,1,0,0
Scotland,1934,British Home Championship,4,7,1,2,0,3,-3,1
Scotland,1935,British Home Championship,5,2,2,0,1,3,3,1
Scotland,1935,Friendly,9,2,2,0,0,2,7,0
Scotland,1936,British Home Championship,5,4,1,1,1,3,1,0
Scotland,1936,Friendly,2,0,1,0,0,1,2,0
Scotland,1937,British Home Championship,5,4,1,1,1,3,1,0
Scotland,1937,Friendly,6,1,1,0,1,2,5,0
Scotland,1938,British Home Championship,6,2,3,0,0,3,4,0
Scotland,1938,Friendly,6,2,2,0,0,2,4,1
Scotland,1939,British Home Championship,1,2,0,1,0,1,-1,0
Scotland,1946,British Home Championship,1,3,0,1,1,2,-2,0
Scotland,1946,Friendly,8,5,2,0,2,4,3,0
Scotland,1947,British Home Championship,2,5,0,2,1,3,-3,0
Scotland,1947,Friendly,7,2,1,1,0,2,5,0
Scotland,1948,British Home Championship,6,5,2,1,0,3,1,1
Scotland,1948,Friendly,3,5,1,2,0,3,-2,0
Scotland,1949,British Home Championship,3,1,1,0,0,1,2,1
Scotland,1949,FIFA World Cup qualification,10,2,2,0,0,2,8,0
Scotland,1949,Friendly,6,0,2,0,0,2,6,0
Scotland,1950,British Home Championship,9,2,2,0,0,2,7,0
Scotland,1950,FIFA World Cup qualification,0,1,0,1,0,1,-1,0
Scotland,1950,Friendly,6,4,2,1,1,4,2,0
Scotland,1951,British Home Championship,6,3,2,1,0,3,3,0
Scotland,1951,Friendly,9,5,3,1,0,4,4,0
Scotland,1952,British Home Championship,4,4,1,1,1,3,0,0
Scotland,1952,Friendly,9,4,2,1,0,3,5,0
Scotland,1953,British Home Championship,8,6,1,0,2,3,2,0
Scotland,1953,Friendly,1,2,0,1,0,1,-1,0
Scotland,1954,British Home Championship,5,6,1,1,1,3,-1,0
Scotland,1954,FIFA World Cup,0,8,0,2,0,2,-8,0
Scotland,1954,Friendly,6,6,2,1,1,4,0,0
Scotland,1955,British Home Championship,5,9,1,2,0,3,-4,1
Scotland,1955,Friendly,10,6,2,1,1,4,4,0
Scotland,1956,British Home Championship,4,3,1,0,2,3,1,0
Scotland,1956,Friendly,3,1,1,0,1,2,2,0
Scotland,1957,British Home Championship,3,4,0,1,2,3,-1,0
Scotland,1957,FIFA World Cup qualification,10,9,3,1,0,4,1,0
Scotland,1957,Friendly,3,1,1,0,0,1,2,0
Scotland,1958,British Home Championship,5,6,1,1,1,3,-1,0
Scotland,1958,FIFA World Cup,4,6,0,2,1,3,-2,0
Scotland,1958,Friendly,3,2,1,0,1,2,1,0
Scotland,1959,British Home Championship,4,1,1,1,0,2,3,0
Scotland,1959,Friendly,5,4,2,1,0,3,1,0
Scotland,1960,British Home Championship,6,5,1,1,1,3,1,0
Scotland,1960,Friendly,8,14,0,3,1,4,-6,0
Scotland,1961,British Home Championship,11,10,2,1,0,3,1,0
Scotland,1961,FIFA World Cup qualification,12,11,3,2,0,5,1,0
Scotland,1962,British Home Championship,10,3,3,0,0,3,7,0
Scotland,1962,Friendly,2,3,0,1,0,1,-1,0
Scotland,1963,British Home Championship,5,4,2,1,0,3,1,1
Scotland,1963,Friendly,19,9,3,2,0,5,10,0
Scotland,1964,British Home Championship,6,5,2,1,0,3,1,1
Scotland,1964,FIFA World Cup qualification,3,1,1,0,0,1,2,0
Scotland,1964,Friendly,2,2,0,0,1,1,0,0
Scotland,1965,British Home Championship,8,6,1,1,1,3,2,1
Scotland,1965,FIFA World Cup qualification,5,7,2,2,1,5,-2,0
Scotland,1965,Friendly,0,0,0,0,1,1,0,0
Scotland,1966,British Home Championship,6,6,1,1,1,3,0,1
Scotland,1966,Friendly,1,5,0,2,1,3,-4,0
Scotland,1967,British Home Championship,6,5,2,1,0,3,1,1
Scotland,1967,Friendly,2,3,1,1,0,2,-1,0
Scotland,1968,British Home Championship,1,1,0,0,1,1,0,0
Scotland,1968,FIFA World Cup qualification,7,1,2,0,0,2,6,0
Scotland,1968,Friendly,1,0,1,0,1,2,1,0
Scotland,1969,British Home Championship,7,8,1,1,1,3,-1,0
Scotland,1969,FIFA World Cup qualification,11,6,1,2,1,4,5,0
Scotland,1969,Friendly,1,1,0,0,1,1,0,0
Scotland,1970,British Home Championship,1,0,1,0,2,3,1,0
Scotland,1970,UEFA Euro qualification,1,0,1,0,0,1,1,0
Scotland,1971,British Home Championship,1,4,0,2,1,3,-3,0
Scotland,1971,Friendly,1,3,0,2,0,2,-2,0
Scotland,1971,UEFA Euro qualification,3,7,2,3,0,5,-4,0
Scotland,1972,Brazil Independence Cup,2,3,0,1,2,3,-1,0
Scotland,1972,British Home Championship,3,1,2,1,0,3,2,0
Scotland,1972,FIFA World Cup qualification,6,1,2,0,0,2,5,0
Scotland,1972,Friendly,2,0,1,0,0,1,2,0
Scotland,1973,British Home Championship,3,3,1,2,0,3,0,0
Scotland,1973,FIFA World Cup qualification,2,2,1,1,0,2,0,0
Scotland,1973,Friendly,1,8,0,3,1,4,-7,0
Scotland,1974,British Home Championship,4,1,2,1,0,3,3,0
Scotland,1974,FIFA World Cup,3,1,1,0,2,3,2,0
Scotland,1974,Friendly,7,5,2,2,0,4,2,0
Scotland,1974,UEFA Euro qualification,1,2,0,1,0,1,-1,0
Scotland,1975,British Home Championship,6,7,1,1,1,3,-1,0
Scotland,1975,Friendly,2,1,1,0,1,2,1,0
Scotland,1975,UEFA Euro qualification,7,4,2,0,3,5,3,0
Scotland,1976,British Home Championship,8,2,3,0,0,3,6,1
Scotland,1976,FIFA World Cup qualification,1,2,1,1,0,2,-1,0
Scotland,1976,Friendly,7,0,2,0,0,2,7,0
Scotland,1977,British Home Championship,5,1,2,0,1,3,4,1
Scotland,1977,FIFA World Cup qualification,5,1,2,0,0,2,4,0
Scotland,1977,Friendly,8,7,2,2,1,5,1,0
Scotland,1978,British Home Championship,2,3,0,1,2,3,-1,0
Scotland,1978,FIFA World Cup,5,6,1,1,1,3,-1,0
Scotland,1978,Friendly,2,1,1,0,0,1,1,0
Scotland,1978,UEFA Euro qualification,5,6,1,2,0,3,-1,0
Scotland,1979,British Home Championship,2,6,1,2,0,3,-4,0
Scotland,1979,Friendly,2,4,0,1,1,2,-2,0
Scotland,1979,UEFA Euro qualification,6,6,1,2,1,4,0,0
Scotland,1980,British Home Championship,1,3,1,2,0,3,-2,0
Scotland,1980,FIFA World Cup qualification,1,0,1,0,1,2,1,0
Scotland,1980,Friendly,1,4,0,2,0,2,-3,0
Scotland,1980,UEFA Euro qualification,4,1,1,0,0,1,3,1
Scotland,1981,British Home Championship,3,2,2,1,0,3,1,1
Scotland,1981,FIFA World Cup qualification,8,4,3,1,2,6,4,0
Scotland,1982,British Home Championship,2,2,1,1,1,3,0,0
Scotland,1982,FIFA World Cup,8,8,1,1,1,3,0,0
Scotland,1982,Friendly,2,4,1,1,0,2,-2,0
Scotland,1982,UEFA Euro qualification,4,5,1,2,0,3,-1,0
Scotland,1983,British Home Championship,2,4,1,2,1,4,-2,0
Scotland,1983,Friendly,7,0,3,0,0,3,7,0
Scotland,1983,UEFA Euro qualification,4,5,0,1,2,3,-1,0
Scotland,1984,British Home Championship,3,2,1,0,1,2,1,0
Scotland,1984,FIFA World Cup qualification,6,1,2,0,0,2,5,0
Scotland,1984,Friendly,6,3,1,1,0,2,3,0
Scotland,1985,FIFA World Cup qualification,4,3,2,2,2,6,1,0
Scotland,1985,Friendly,0,0,0,0,1,1,0,0
Scotland,1985,Rous Cup,1,0,1,0,0,1,1,1
Scotland,1986,FIFA World Cup,1,3,0,2,1,3,-2,0
Scotland,1986,Friendly,4,0,2,0,1,3,4,0
Scotland,1986,Rous Cup,1,2,0,1,0,1,-1,0
Scotland,1986,UEFA Euro qualification,3,0,1,0,2,3,3,0
Scotland,1987,Friendly,2,0,1,0,0,1,2,0
Scotland,1987,Rous Cup,0,2,0,1,1,2,-2,0
Scotland,1987,UEFA Euro qualification,4,5,2,2,1,5,-1,0
Scotland,1988,FIFA World Cup qualification,3,2,1,0,1,2,1,0
Scotland,1988,Friendly,3,5,0,1,3,4,-2,0
Scotland,1988,Rous Cup,0,1,0,1,1,2,-1,0
Scotland,1989,FIFA World Cup qualification,9,10,3,2,1,6,-1,0
Scotland,1989,Rous Cup,2,2,1,1,0,2,0,1
Scotland,1990,FIFA World Cup,2,3,1,2,0,3,-1,0
Scotland,1990,Friendly,5,6,2,2,1,5,-1,0
Scotland,1990,UEFA Euro qualification,5,3,2,0,1,3,2,0
Scotland,1991,Friendly,0,1,0,1,0,1,-1,0
Scotland,1991,UEFA Euro qualification,9,4,2,1,2,5,5,0
Scotland,1992,FIFA World Cup qualification,1,3,0,1,2,3,-2,0
Scotland,1992,Friendly,6,2,3,0,2,5,4,0
Scotland,1992,UEFA Euro,3,3,1,2,0,3,0,0
Scotland,1993,FIFA World Cup qualification,13,10,4,2,1,7,3,0
Scotland,1993,Friendly,0,1,0,1,0,1,-1,0
Scotland,1994,Friendly,3,5,1,2,0,3,-2,0
Scotland,1994,UEFA Euro qualification,8,3,2,1,1,4,5,0
Scotland,1995,Friendly,0,2,0,1,0,1,-2,0
Scotland,1995,Kirin Cup,2,1,1,0,1,2,1,0
Scotland,1995,UEFA Euro qualification,11,0,5,0,1,6,11,0
Scotland,1996,FIFA World Cup qualification,3,0,2,0,1,3,3,0
Scotland,1996,Friendly,2,5,1,3,0,4,-3,0
Scotland,1996,UEFA Euro,1,2,1,1,1,3,-1,0
Scotland,1997,FIFA World Cup qualification,12,3,5,1,1,7,9,0
Scotland,1997,Friendly,4,5,1,2,0,3,-1,0
Scotland,1998,FIFA World Cup,2,6,0,2,1,3,-4,0
Scotland,1998,Friendly,1,2,0,1,2,3,-1,0
Scotland,1998,UEFA Euro qualification,5,3,2,0,1,3,2,0
Scotland,1999,Friendly,1,0,1,0,0,1,1,0
Scotland,1999,UEFA Euro qualification,11,9,4,3,2,9,2,0
Scotland,2000,FIFA World Cup qualification,4,1,2,0,1,3,3,0
Scotland,2000,Friendly,2,5,1,2,1,4,-3,0
Scotland,2001,FIFA World Cup qualification,8,5,2,1,2,5,3,0
Scotland,2001,Friendly,1,1,0,0,1,1,0,0
Scotland,2002,Friendly,5,17,1,6,0,7,-12,0
Scotland,2002,UEFA Euro qualification,4,2,1,0,1,2,2,0
Scotland,2003,Friendly,1,5,0,2,2,4,-4,0
Scotland,2003,UEFA Euro qualification,9,12,4,3,1,8,-3,0
Scotland,2004,FIFA World Cup qualification,1,2,0,1,2,3,-1,0
Scotland,2004,Friendly,8,16,2,5,1,8,-8,0
Scotland,2005,FIFA World Cup qualification,8,5,3,2,2,7,3,0
Scotland,2005,Friendly,3,3,0,0,2,2,0,0
Scotland,2006,Friendly,1,3,0,1,0,1,-2,0
Scotland,2006,Kirin Cup,5,1,1,0,1,2,4,0
Scotland,2006,UEFA Euro qualification,9,3,3,1,0,4,6,0
Scotland,2007,Friendly,2,0,2,0,0,2,2,0
Scotland,2007,UEFA Euro qualification,12,9,5,3,0,8,3,0
Scotland,2008,FIFA World Cup qualification,2,2,1,1,1,3,0,0
Scotland,2008,Friendly,2,5,0,2,2,4,-3,0
Scotland,2009,FIFA World Cup qualification,4,9,2,3,0,5,-5,0
Scotland,2009,Friendly,0,5,0,2,0,2,-5,0
Scotland,2010,Friendly,4,3,2,1,0,3,1,0
Scotland,2010,UEFA Euro qualification,4,5,1,2,1,4,-1,0
Scotland,2011,Friendly,4,4,2,1,0,3,0,0
Scotland,2011,Nations Cup,6,2,2,1,0,3,4,0
Scotland,2011,UEFA Euro qualification,5,5,2,1,1,4,0,0
Scotland,2012,FIFA World Cup qualification,2,5,0,2,2,4,-3,0
Scotland,2012,Friendly,7,8,2,1,1,4,-1,0
Scotland,2013,FIFA World Cup qualification,6,7,3,3,0,6,-1,0
Scotland,2013,Friendly,4,3,2,1,1,4,1,0
Scotland,2014,Friendly,4,5,1,1,1,3,-1,0
Scotland,2014,UEFA Euro qualification,5,4,2,1,1,4,1,0
Scotland,2015,Friendly,2,0,2,0,0,2,2,0
Scotland,2015,UEFA Euro qualification,17,8,2,2,2,6,9,0
Scotland,2016,FIFA World Cup qualification,6,8,1,2,1,4,-2,0
Scotland,2016,Friendly,2,4,2,2,0,4,-2,0
Scotland,2017,FIFA World Cup qualification,11,4,4,0,2,6,7,0
Scotland,2017,Friendly,1,2,0,1,1,2,-1,0
Scotland,2018,Friendly,2,11,1,5,0,6,-9,0
Scotland,2018,UEFA Nations League,10,4,3,1,0,4,6,0
Scotland,2019,UEFA Euro qualification,16,19,5,5,0,10,-3,0
Scotland,2020,UEFA Euro qualification,1,1,0,0,2,2,0,0
Scotland,2020,UEFA Nations League,5,4,3,2,1,6,1,0
Scotland,2021,FIFA World Cup qualification,17,7,7,1,2,10,10,0
Scotland,2021,Friendly,3,2,1,0,1,2,1,0
Scotland,2021,UEFA Euro,1,5,0,2,1,3,-4,0
Scotland,2022,FIFA World Cup qualification,1,3,0,1,0,1,-2,0
Scotland,2022,Friendly,4,5,0,1,2,3,-1,0
Scotland,2022,UEFA Nations League,11,5,4,1,1,6,6,0
Scotland,2023,Friendly,2,7,0,2,0,2,-5,0
Scotland,2023,UEFA Euro qualification,17,8,5,1,2,8,9,0
Scotland,2024,Friendly,4,7,1,2,1,4,-3,0
Scotland,2024,UEFA Euro,2,7,0,2,1,3,-5,0
Scotland,2024,UEFA Nations League,7,8,2,3,1,6,-1,0
Scotland,2025,UEFA Nations League,1,3,1,1,0,2,-2,0
Sealand,2004,Friendly,2,2,0,0,1,1,0,0
Sealand,2012,Friendly,2,4,0,1,1,2,-2,0
Sealand,2013,Friendly,2,1,1,0,0,1,1,0
Sealand,2013,Tynwald Hill Tournament,5,15,0,2,1,3,-10,0
Sealand,2014,Friendly,16,8,3,0,2,5,8,0
Seborga,2014,Friendly,2,3,0,1,0,1,-1,0
Senegal,1961,African Friendship Games,11,7,2,1,1,4,4,0
Senegal,1961,Friendly,2,3,0,1,0,1,-1,0
Senegal,1962,Friendly,1,1,0,0,1,1,0,0
Senegal,1963,African Friendship Games,12,3,4,0,1,5,9,0
Senegal,1963,Friendly,3,10,0,3,1,4,-7,0
Senegal,1965,African Cup of Nations,5,2,1,1,1,3,3,0
Senegal,1965,African Cup of Nations qualification,8,4,3,1,0,4,4,0
Senegal,1966,Friendly,0,5,0,1,0,1,-5,0
Senegal,1967,African Cup of Nations qualification,11,7,3,1,1,5,4,1
Senegal,1968,African Cup of Nations,5,5,1,1,1,3,0,0
Senegal,1968,FIFA World Cup qualification,0,1,0,1,0,1,-1,0
Senegal,1968,Friendly,0,2,0,1,0,1,-2,0
Senegal,1969,African Cup of Nations qualification,4,5,0,1,1,2,-1,0
Senegal,1969,FIFA World Cup qualification,2,3,1,1,0,2,-1,0
Senegal,1969,Friendly,3,7,1,2,0,3,-4,0
Senegal,1970,Friendly,6,13,2,5,0,7,-7,1
Senegal,1971,African Cup of Nations qualification,0,1,0,1,1,2,-1,0
Senegal,1971,Friendly,12,4,4,0,1,5,8,1
Senegal,1972,FIFA World Cup qualification,1,2,0,1,1,2,-1,0
Senegal,1972,Friendly,1,5,0,2,1,3,-4,0
Senegal,1973,African Cup of Nations qualification,3,3,1,1,0,2,0,0
Senegal,1973,Friendly,2,5,0,2,0,2,-3,0
Senegal,1974,Friendly,2,5,0,1,0,1,-3,0
Senegal,1975,African Cup of Nations qualification,2,5,1,1,0,2,-3,0
Senegal,1975,Friendly,4,4,2,2,1,5,0,0
Senegal,1976,FIFA World Cup qualification,1,2,0,1,1,2,-1,0
Senegal,1976,Friendly,7,7,1,1,1,3,0,0
Senegal,1977,African Cup of Nations qualification,6,5,3,1,0,4,1,0
Senegal,1977,Friendly,8,8,3,2,0,5,0,0
Senegal,1979,Amílcar Cabral Cup,7,1,4,0,0,4,6,1
Senegal,1979,Friendly,6,12,1,5,2,8,-6,0
Senegal,1980,African Cup of Nations qualification,4,1,2,0,0,2,3,0
Senegal,1980,Amílcar Cabral Cup,5,3,3,1,0,4,2,1
Senegal,1980,FIFA World Cup qualification,0,1,0,1,1,2,-1,0
Senegal,1980,Friendly,9,6,3,2,0,5,3,0
Senegal,1981,African Cup of Nations qualification,0,1,0,1,1,2,-1,0
Senegal,1981,Amílcar Cabral Cup,7,2,3,1,0,4,5,0
Senegal,1981,Friendly,2,3,1,2,0,3,-1,0
Senegal,1982,African Cup of Nations qualification,1,0,1,0,1,2,1,0
Senegal,1982,Amílcar Cabral Cup,5,4,3,1,1,5,1,0
Senegal,1982,Friendly,5,7,1,3,3,7,-2,0
Senegal,1982,Merdeka Tournament,9,6,2,1,2,5,3,0
Senegal,1983,African Cup of Nations qualification,3,5,1,2,1,4,-2,0
Senegal,1983,Amílcar Cabral Cup,9,4,3,0,2,5,5,1
Senegal,1983,Friendly,4,4,3,3,1,7,0,0
Senegal,1984,Amílcar Cabral Cup,10,3,3,1,1,5,7,0
Senegal,1984,FIFA World Cup qualification,1,1,1,1,0,2,0,0
Senegal,1984,Friendly,10,10,2,3,3,8,0,0
Senegal,1985,African Cup of Nations qualification,5,2,2,1,1,4,3,0
Senegal,1985,Amílcar Cabral Cup,8,2,4,0,1,5,6,1
Senegal,1985,Friendly,5,1,2,0,1,3,4,1
Senegal,1986,African Cup of Nations,3,1,2,1,0,3,2,0
Senegal,1986,Amílcar Cabral Cup,7,2,4,0,0,4,5,1
Senegal,1986,Friendly,2,0,2,0,0,2,2,0
Senegal,1987,African Cup of Nations qualification,4,0,1,0,3,4,4,0
Senegal,1987,All-African Games,1,4,1,3,0,4,-3,0
Senegal,1987,Amílcar Cabral Cup,2,2,1,2,1,4,0,0
Senegal,1987,Friendly,1,1,1,1,0,2,0,0
Senegal,1987,Kirin Cup,2,2,0,0,1,1,0,0
Senegal,1988,Amílcar Cabral Cup,10,5,2,0,3,5,5,0
Senegal,1988,Friendly,3,1,2,0,0,2,2,0
Senegal,1989,African Cup of Nations qualification,4,0,2,0,0,2,4,0
Senegal,1989,Amílcar Cabral Cup,3,4,0,1,2,3,-1,0
Senegal,1989,Friendly,7,2,3,0,2,5,5,0
Senegal,1990,African Cup of Nations,3,3,1,2,2,5,0,0
Senegal,1990,Friendly,2,2,1,1,1,3,0,0
Senegal,1991,Amílcar Cabral Cup,7,0,3,0,1,4,7,1
Senegal,1991,Dakar Tournament,2,2,0,0,2,2,0,0
Senegal,1991,Friendly,5,11,1,4,2,7,-6,0
Senegal,1992,African Cup of Nations,4,3,1,2,0,3,1,0
Senegal,1992,African Cup of Nations qualification,3,2,1,1,0,2,1,0
Senegal,1992,FIFA World Cup qualification,3,3,1,1,0,2,0,0
Senegal,1992,Friendly,3,3,0,0,2,2,0,0
Senegal,1993,African Cup of Nations qualification,5,7,1,2,1,4,-2,0
Senegal,1993,Amílcar Cabral Cup,6,3,2,2,1,5,3,0
Senegal,1993,FIFA World Cup qualification,8,9,2,3,1,6,-1,0
Senegal,1993,Friendly,2,2,1,1,0,2,0,0
Senegal,1994,African Cup of Nations,2,3,1,2,0,3,-1,0
Senegal,1994,African Cup of Nations qualification,0,2,0,1,1,2,-2,0
Senegal,1994,Friendly,7,7,2,3,3,8,0,0
Senegal,1995,African Cup of Nations qualification,10,6,3,1,2,6,4,0
Senegal,1995,Amílcar Cabral Cup,5,3,1,1,1,3,2,0
Senegal,1995,Friendly,0,2,0,1,0,1,-2,0
Senegal,1996,African Cup of Nations qualification,2,1,1,0,0,1,1,0
Senegal,1996,FIFA World Cup qualification,2,3,0,1,1,2,-1,0
Senegal,1996,Friendly,3,3,2,1,1,4,0,0
Senegal,1997,African Cup of Nations qualification,3,5,1,2,0,3,-2,0
Senegal,1997,Amílcar Cabral Cup,5,3,2,1,2,5,2,0
Senegal,1997,Friendly,4,9,0,3,2,5,-5,0
Senegal,1998,African Cup of Nations qualification,0,1,0,1,0,1,-1,0
Senegal,1998,Friendly,7,7,2,2,1,5,0,0
Senegal,1999,African Cup of Nations qualification,12,5,3,0,2,5,7,0
Senegal,1999,Friendly,10,3,4,1,2,7,7,0
Senegal,2000,African Cup of Nations,6,6,1,2,1,4,0,0
Senegal,2000,African Cup of Nations qualification,0,0,0,0,1,1,0,0
Senegal,2000,Amílcar Cabral Cup,5,6,0,1,3,4,-1,0
Senegal,2000,FIFA World Cup qualification,3,2,1,0,3,4,1,0
Senegal,2000,Friendly,1,4,0,1,3,4,-3,0
Senegal,2001,African Cup of Nations qualification,4,2,1,1,1,3,2,0
Senegal,2001,FIFA World Cup qualification,13,1,4,1,1,6,12,0
Senegal,2001,Friendly,7,4,4,1,1,6,3,0
Senegal,2002,African Cup of Nations,6,1,4,0,2,6,5,0
Senegal,2002,African Cup of Nations qualification,1,0,1,0,0,1,1,0
Senegal,2002,FIFA World Cup,7,6,2,1,2,5,1,0
Senegal,2002,Friendly,8,7,2,1,2,5,1,0
Senegal,2003,African Cup of Nations qualification,6,1,2,0,1,3,5,0
Senegal,2003,Friendly,4,4,3,3,0,6,0,0
Senegal,2004,African Cup of Nations,4,2,1,1,2,4,2,0
Senegal,2004,FIFA World Cup qualification,9,5,3,1,1,5,4,0
Senegal,2004,Friendly,9,6,3,1,1,5,3,0
Senegal,2005,FIFA World Cup qualification,12,3,3,0,2,5,9,0
Senegal,2005,Friendly,7,8,2,2,1,5,-1,0
Senegal,2006,African Cup of Nations,7,8,2,4,0,6,-1,0
Senegal,2006,African Cup of Nations qualification,2,1,1,1,0,2,1,0
Senegal,2006,Friendly,4,2,2,0,2,4,2,0
Senegal,2007,African Cup of Nations qualification,10,2,2,0,2,4,8,0
Senegal,2007,Friendly,12,10,4,1,1,6,2,0
Senegal,2008,African Cup of Nations,4,6,0,1,2,3,-2,0
Senegal,2008,FIFA World Cup qualification,9,7,2,1,3,6,2,0
Senegal,2008,Friendly,5,2,2,0,1,3,3,0
Senegal,2009,Friendly,4,7,1,2,2,5,-3,0
Senegal,2010,African Cup of Nations qualification,11,2,2,0,0,2,9,0
Senegal,2010,Friendly,5,4,3,2,0,5,1,0
Senegal,2011,African Cup of Nations qualification,5,0,3,0,1,4,5,0
Senegal,2011,Friendly,3,5,1,3,0,4,-2,0
Senegal,2012,African Cup of Nations,3,6,0,3,0,3,-3,0
Senegal,2012,African Cup of Nations qualification,2,6,0,2,0,2,-4,0
Senegal,2012,FIFA World Cup qualification,4,2,1,0,1,2,2,0
Senegal,2012,Friendly,3,1,2,0,2,4,2,0
Senegal,2013,FIFA World Cup qualification,7,6,2,1,3,6,1,0
Senegal,2013,Friendly,1,5,0,1,1,2,-4,0
Senegal,2014,African Cup of Nations qualification,8,1,4,1,1,6,7,0
Senegal,2014,Friendly,7,5,1,0,3,4,2,0
Senegal,2015,African Cup of Nations,3,4,1,1,1,3,-1,0
Senegal,2015,African Cup of Nations qualification,5,1,2,0,0,2,4,0
Senegal,2015,FIFA World Cup qualification,5,2,1,0,1,2,3,0
Senegal,2015,Friendly,8,5,3,2,0,5,3,0
Senegal,2016,African Cup of Nations qualification,8,1,4,0,0,4,7,0
Senegal,2016,FIFA World Cup qualification,2,0,1,0,0,1,2,0
Senegal,2016,Friendly,2,0,1,0,0,1,2,0
Senegal,2017,African Cup of Nations,6,2,2,0,2,4,4,0
Senegal,2017,African Cup of Nations qualification,3,0,1,0,0,1,3,0
Senegal,2017,FIFA World Cup qualification,8,3,3,0,2,5,5,0
Senegal,2017,Friendly,8,3,3,0,3,6,5,0
Senegal,2018,African Cup of Nations qualification,7,2,3,0,1,4,5,0
Senegal,2018,FIFA World Cup,4,4,1,1,1,3,0,0
Senegal,2018,Friendly,4,3,1,1,3,5,1,0
Senegal,2019,African Cup of Nations,8,2,5,2,0,7,6,0
Senegal,2019,African Cup of Nations qualification,8,1,3,0,0,3,7,0
Senegal,2019,Friendly,4,2,2,0,1,3,2,0
Senegal,2020,African Cup of Nations qualification,3,0,2,0,0,2,3,0
Senegal,2020,Friendly,1,3,0,1,0,1,-2,0
Senegal,2021,African Cup of Nations qualification,1,1,0,0,2,2,0,0
Senegal,2021,COSAFA Cup,8,6,3,1,2,6,2,0
Senegal,2021,FIFA World Cup qualification,15,4,5,0,1,6,11,0
Senegal,2021,Friendly,5,1,2,0,0,2,4,0
Senegal,2022,African Cup of Nations,9,2,4,0,3,7,7,0
Senegal,2022,African Cup of Nations qualification,4,1,2,0,0,2,3,0
Senegal,2022,COSAFA Cup,5,6,0,1,2,3,-1,0
Senegal,2022,FIFA World Cup,5,7,2,2,0,4,-2,0
Senegal,2022,FIFA World Cup qualification,1,1,1,1,0,2,0,0
Senegal,2022,Friendly,3,1,1,0,1,2,2,0
Senegal,2023,African Cup of Nations qualification,8,3,2,0,2,4,5,0
Senegal,2023,FIFA World Cup qualification,4,0,1,0,1,2,4,0
Senegal,2023,Friendly,5,3,2,1,0,3,2,0
Senegal,2024,African Cup of Nations,9,2,3,0,1,4,7,0
Senegal,2024,African Cup of Nations qualification,7,1,3,0,1,4,6,0
Senegal,2024,FIFA World Cup qualification,2,1,1,0,1,2,1,0
Senegal,2024,Friendly,5,0,3,0,0,3,5,0
Senegal,2025,FIFA World Cup qualification,2,0,1,0,1,2,2,0
Serbia,1950,Friendly,1,4,0,1,0,1,-3,0
Serbia,1994,Friendly,0,3,0,2,0,2,-3,0
Serbia,1995,Friendly,12,4,4,1,0,5,8,0
Serbia,1995,Lunar New Year Cup,1,0,1,0,0,1,1,1
Serbia,1996,FIFA World Cup qualification,18,4,4,1,0,5,14,0
Serbia,1996,Friendly,4,2,2,0,0,2,2,1
Serbia,1996,Kirin Cup,0,1,0,1,1,2,-1,0
Serbia,1997,FIFA World Cup qualification,23,4,5,0,2,7,19,0
Serbia,1997,Friendly,1,0,1,0,1,2,1,0
Serbia,1997,Korea Cup,4,2,1,0,2,3,2,0
Serbia,1997,Lunar New Year Cup,1,1,0,0,1,1,0,0
Serbia,1998,FIFA World Cup,5,4,2,1,1,4,1,0
Serbia,1998,Friendly,14,9,4,2,4,10,5,0
Serbia,1998,UEFA Euro qualification,1,0,1,0,0,1,1,0
Serbia,1999,UEFA Euro qualification,17,8,4,1,2,7,9,0
Serbia,2000,FIFA World Cup qualification,2,0,1,0,0,1,2,0
Serbia,2000,Friendly,9,5,4,1,3,8,4,0
Serbia,2000,UEFA Euro,8,13,1,2,1,4,-5,0
Serbia,2001,FIFA World Cup qualification,20,8,4,1,4,9,12,0
Serbia,2001,Kirin Cup,0,3,0,2,0,2,-3,0
Serbia,2001,Millennium Cup,10,2,4,0,1,5,8,1
Serbia,2002,Friendly,9,15,3,5,1,9,-6,0
Serbia,2002,UEFA Euro qualification,3,1,1,0,1,2,2,0
Serbia,2003,Friendly,5,9,0,4,0,4,-4,0
Serbia,2003,UEFA Euro qualification,8,10,2,2,2,6,-2,0
Serbia,2004,FIFA World Cup qualification,10,0,3,0,1,4,10,0
Serbia,2004,Friendly,2,3,0,1,2,3,-1,0
Serbia,2004,Kirin Cup,2,1,1,1,0,2,1,0
Serbia,2005,FIFA World Cup qualification,6,1,3,0,3,6,5,0
Serbia,2005,Friendly,6,8,1,3,2,6,-2,0
Serbia,2006,FIFA World Cup,2,10,0,3,0,3,-8,0
Serbia,2006,Friendly,6,7,2,1,2,5,-1,0
Serbia,2006,UEFA Euro qualification,6,1,3,0,1,4,5,0
Serbia,2007,UEFA Euro qualification,16,10,3,2,5,10,6,1
Serbia,2008,FIFA World Cup qualification,9,3,3,1,0,4,6,0
Serbia,2008,Friendly,10,10,1,4,2,7,0,0
Serbia,2009,Cyprus International Tournament,2,1,1,1,0,2,1,0
Serbia,2009,FIFA World Cup qualification,13,5,4,1,1,6,8,0
Serbia,2009,Friendly,7,1,4,0,0,4,6,0
Serbia,2010,FIFA World Cup,2,3,1,2,0,3,-1,0
Serbia,2010,Friendly,11,5,4,2,1,7,6,0
Serbia,2010,UEFA Euro qualification,5,7,1,2,1,4,-2,0
Serbia,2011,Friendly,3,7,1,4,1,6,-4,0
Serbia,2011,UEFA Euro qualification,8,5,3,1,2,6,3,0
Serbia,2012,FIFA World Cup qualification,6,5,1,2,1,4,1,0
Serbia,2012,Friendly,6,7,2,3,2,7,-1,0
Serbia,2013,FIFA World Cup qualification,12,6,3,2,1,6,6,0
Serbia,2013,Friendly,6,3,2,1,1,4,3,0
Serbia,2014,Friendly,7,4,3,1,1,5,3,0
Serbia,2014,UEFA Euro qualification,2,7,0,2,1,3,-5,0
Serbia,2015,Friendly,6,7,1,2,0,3,-1,0
Serbia,2015,UEFA Euro qualification,6,6,2,3,0,5,0,0
Serbia,2016,FIFA World Cup qualification,9,5,2,0,2,4,4,0
Serbia,2016,Friendly,7,9,3,3,1,7,-2,0
Serbia,2017,FIFA World Cup qualification,11,5,4,1,1,6,6,0
Serbia,2017,Friendly,3,1,1,0,2,3,2,0
Serbia,2018,FIFA World Cup,2,4,1,2,0,3,-2,0
Serbia,2018,Friendly,8,4,2,2,0,4,4,0
Serbia,2018,UEFA Nations League,11,4,4,0,2,6,7,0
Serbia,2019,Friendly,2,1,1,0,1,2,1,0
Serbia,2019,UEFA Euro qualification,17,17,4,2,2,8,0,0
Serbia,2020,UEFA Euro qualification,3,2,1,0,1,2,1,0
Serbia,2020,UEFA Nations League,9,7,1,2,3,6,2,0
Serbia,2021,FIFA World Cup qualification,18,9,6,0,2,8,9,0
Serbia,2021,Friendly,9,1,2,0,3,5,8,0
Serbia,2021,Kirin Challenge Cup,0,1,0,1,0,1,-1,0
Serbia,2022,FIFA World Cup,5,8,0,2,1,3,-3,0
Serbia,2022,Friendly,6,4,2,1,0,3,2,0
Serbia,2022,UEFA Nations League,13,5,4,1,1,6,8,0
Serbia,2023,Friendly,5,4,2,1,0,3,1,0
Serbia,2023,UEFA Euro qualification,15,9,4,2,2,8,6,0
Serbia,2024,Friendly,5,2,2,1,0,3,3,0
Serbia,2024,UEFA Euro,1,2,0,1,2,3,-1,0
Serbia,2024,UEFA Nations League,3,6,1,2,3,6,-3,0
Serbia,2025,UEFA Nations League,3,1,1,0,1,2,2,0
Seychelles,1974,Friendly,3,4,1,1,0,2,-1,0
Seychelles,1976,Friendly,2,8,0,2,0,2,-6,0
Seychelles,1977,Friendly,1,3,0,2,0,2,-2,0
Seychelles,1978,Friendly,2,6,1,2,0,3,-4,0
Seychelles,1979,Indian Ocean Island Games,11,6,1,2,1,4,5,0
Seychelles,1983,Friendly,2,4,0,2,1,3,-2,0
Seychelles,1985,Indian Ocean Island Games,1,4,0,2,0,2,-3,0
Seychelles,1987,Friendly,1,3,0,1,1,2,-2,0
Seychelles,1988,African Cup of Nations qualification,1,3,1,1,0,2,-2,0
Seychelles,1988,Friendly,1,1,0,0,1,1,0,0
Seychelles,1990,Indian Ocean Island Games,3,9,1,2,0,3,-6,0
Seychelles,1992,CECAFA Cup,3,7,0,2,0,2,-4,0
Seychelles,1993,Indian Ocean Island Games,3,12,0,4,0,4,-9,0
Seychelles,1994,CECAFA Cup,0,2,0,1,0,1,-2,0
Seychelles,1996,African Cup of Nations qualification,1,2,0,1,1,2,-1,0
Seychelles,1998,Friendly,1,2,0,1,1,2,-1,0
Seychelles,1998,Indian Ocean Island Games,9,10,2,2,0,4,-1,0
Seychelles,2000,African Cup of Nations qualification,0,6,0,2,0,2,-6,0
Seychelles,2000,FIFA World Cup qualification,1,4,0,1,1,2,-3,0
Seychelles,2002,African Cup of Nations qualification,1,3,1,1,0,2,-2,0
Seychelles,2002,Friendly,0,1,0,1,0,1,-1,0
Seychelles,2003,African Cup of Nations qualification,3,7,1,3,0,4,-4,0
Seychelles,2003,FIFA World Cup qualification,1,5,0,1,1,2,-4,0
Seychelles,2003,Indian Ocean Island Games,3,2,1,1,2,4,1,0
Seychelles,2005,COSAFA Cup,0,3,0,1,0,1,-3,0
Seychelles,2006,African Cup of Nations qualification,2,4,1,1,0,2,-2,0
Seychelles,2006,COSAFA Cup,1,3,0,1,1,2,-2,0
Seychelles,2006,Friendly,4,2,2,0,0,2,2,0
Seychelles,2007,African Cup of Nations qualification,1,10,0,3,1,4,-9,0
Seychelles,2007,COSAFA Cup,0,7,0,2,0,2,-7,0
Seychelles,2007,Friendly,2,0,1,0,0,1,2,0
Seychelles,2007,Indian Ocean Island Games,2,4,1,1,0,2,-2,0
Seychelles,2008,COSAFA Cup qualification,8,2,1,1,1,3,6,0
Seychelles,2008,FIFA World Cup qualification,4,17,0,6,0,6,-13,0
Seychelles,2009,COSAFA Cup,2,6,0,3,0,3,-4,0
Seychelles,2011,FIFA World Cup qualification,0,7,0,2,0,2,-7,0
Seychelles,2011,Friendly,1,5,0,2,0,2,-4,0
Seychelles,2011,Indian Ocean Island Games,10,4,3,0,2,5,6,0
Seychelles,2012,African Cup of Nations qualification,0,7,0,2,0,2,-7,0
Seychelles,2013,COSAFA Cup,2,8,0,2,0,2,-6,0
Seychelles,2013,Friendly,5,2,2,0,0,2,3,0
Seychelles,2014,African Cup of Nations qualification,0,2,0,1,0,1,-2,0
Seychelles,2014,Friendly,4,3,1,2,0,3,1,0
Seychelles,2015,African Cup of Nations qualification,1,5,0,1,1,2,-4,0
Seychelles,2015,COSAFA Cup,0,2,0,2,1,3,-2,0
Seychelles,2015,FIFA World Cup qualification,0,3,0,2,0,2,-3,0
Seychelles,2015,Indian Ocean Island Games,4,3,1,2,0,3,1,0
Seychelles,2016,African Cup of Nations qualification,4,6,1,3,0,4,-2,0
Seychelles,2016,COSAFA Cup,0,10,0,3,0,3,-10,0
Seychelles,2017,African Cup of Nations qualification,1,5,0,1,0,1,-4,0
Seychelles,2017,COSAFA Cup,1,10,0,3,0,3,-9,0
Seychelles,2018,African Cup of Nations qualification,1,17,0,3,1,4,-16,0
Seychelles,2018,COSAFA Cup,3,4,0,1,2,3,-1,0
Seychelles,2018,Friendly,0,0,0,0,1,1,0,0
Seychelles,2019,African Cup of Nations qualification,2,6,0,3,0,3,-4,0
Seychelles,2019,COSAFA Cup,0,6,0,2,1,3,-6,0
Seychelles,2019,FIFA World Cup qualification,0,10,0,2,0,2,-10,0
Seychelles,2019,Indian Ocean Island Games,2,8,0,2,2,4,-6,0
Seychelles,2021,Friendly,2,15,0,2,0,2,-13,0
Seychelles,2021,Mahinda Rajapaksa Cup,5,4,1,0,3,4,1,0
Seychelles,2022,African Cup of Nations qualification,1,3,0,1,1,2,-2,0
Seychelles,2022,COSAFA Cup,1,6,0,3,0,3,-5,0
Seychelles,2022,Friendly,0,0,0,0,2,2,0,0
Seychelles,2023,COSAFA Cup,2,9,0,3,0,3,-7,0
Seychelles,2023,FIFA World Cup qualification,0,14,0,2,0,2,-14,0
Seychelles,2023,Friendly,1,1,1,1,0,2,0,0
Seychelles,2023,Indian Ocean Island Games,0,2,0,2,0,2,-2,0
Seychelles,2024,FIFA World Cup qualification,2,8,0,2,0,2,-6,0
Seychelles,2025,FIFA World Cup qualification,0,8,0,2,0,2,-8,0
Shetland,1989,Island Games,1,13,0,4,0,4,-12,0
Shetland,1991,Island Games,7,8,2,2,0,4,-1,0
Shetland,1993,Island Games,3,10,1,3,0,4,-7,0
Shetland,1997,Island Games,4,6,2,1,1,4,-2,0
Shetland,1999,Island Games,14,14,2,3,0,5,0,0
Shetland,2001,Island Games,6,7,1,1,2,4,-1,0
Shetland,2003,Island Games,9,6,2,1,1,4,3,1
Shetland,2005,Island Games,9,2,3,1,1,5,7,0
Shetland,2009,Island Games,7,9,1,2,1,4,-2,0
Shetland,2015,Island Games,10,5,2,2,1,5,5,0
Shetland,2017,Island Games,7,12,1,3,0,4,-5,0
Shetland,2019,Inter Games Football Tournament,8,10,1,3,0,4,-2,0
Shetland,2023,Island Games,12,6,3,1,0,4,6,0
Sierra Leone,1949,Friendly,0,2,0,1,0,1,-2,0
Sierra Leone,1953,Friendly,1,2,0,1,0,1,-1,0
Sierra Leone,1954,Friendly,0,2,0,1,0,1,-2,0
Sierra Leone,1956,Friendly,4,4,1,1,0,2,0,0
Sierra Leone,1957,Friendly,2,3,0,1,0,1,-1,0
Sierra Leone,1960,Friendly,6,10,1,2,0,3,-4,0
Sierra Leone,1961,Friendly,1,4,0,1,0,1,-3,0
Sierra Leone,1966,Friendly,1,3,0,1,1,2,-2,0
Sierra Leone,1967,Friendly,3,2,1,0,1,2,1,0
Sierra Leone,1968,Friendly,4,6,1,1,1,3,-2,0
Sierra Leone,1969,Friendly,1,1,0,0,1,1,0,0
Sierra Leone,1970,Friendly,2,2,1,1,0,2,0,0
Sierra Leone,1971,Friendly,8,7,3,3,0,6,1,0
Sierra Leone,1972,FIFA World Cup qualification,0,3,0,2,0,2,-3,0
Sierra Leone,1972,Friendly,5,8,1,2,1,4,-3,0
Sierra Leone,1973,African Cup of Nations qualification,3,5,0,1,1,2,-2,0
Sierra Leone,1974,Friendly,1,4,0,1,0,1,-3,0
Sierra Leone,1976,FIFA World Cup qualification,8,9,1,2,1,4,-1,0
Sierra Leone,1976,Friendly,4,5,1,1,1,3,-1,0
Sierra Leone,1977,African Cup of Nations qualification,1,3,0,1,1,2,-2,0
Sierra Leone,1977,Friendly,0,4,0,1,0,1,-4,0
Sierra Leone,1978,Friendly,2,9,0,2,0,2,-7,0
Sierra Leone,1979,Friendly,3,0,2,0,1,3,3,0
Sierra Leone,1980,African Cup of Nations qualification,1,4,0,2,0,2,-3,0
Sierra Leone,1980,FIFA World Cup qualification,3,5,0,1,1,2,-2,0
Sierra Leone,1980,Friendly,5,6,1,1,0,2,-1,0
Sierra Leone,1982,African Cup of Nations qualification,0,4,0,2,0,2,-4,0
Sierra Leone,1982,Amílcar Cabral Cup,2,4,1,2,0,3,-2,0
Sierra Leone,1982,Friendly,0,1,0,1,0,1,-1,0
Sierra Leone,1983,Friendly,4,2,3,1,0,4,2,0
Sierra Leone,1984,African Cup of Nations qualification,4,3,1,1,0,2,1,0
Sierra Leone,1984,Amílcar Cabral Cup,3,0,2,0,3,5,3,0
Sierra Leone,1984,FIFA World Cup qualification,0,5,0,2,0,2,-5,0
Sierra Leone,1984,Friendly,1,2,1,2,0,3,-1,0
Sierra Leone,1985,Amílcar Cabral Cup,3,3,0,0,3,3,0,0
Sierra Leone,1986,African Cup of Nations qualification,3,2,1,0,1,2,1,0
Sierra Leone,1986,Amílcar Cabral Cup,9,7,4,1,0,5,2,0
Sierra Leone,1987,African Cup of Nations qualification,4,4,2,1,1,4,0,0
Sierra Leone,1987,Amílcar Cabral Cup,3,0,2,0,2,4,3,0
Sierra Leone,1988,Amílcar Cabral Cup,6,8,1,2,2,5,-2,0
Sierra Leone,1988,Friendly,0,1,0,1,1,2,-1,0
Sierra Leone,1989,Amílcar Cabral Cup,2,3,1,2,0,3,-1,0
Sierra Leone,1989,Friendly,0,1,0,1,0,1,-1,0
Sierra Leone,1990,African Cup of Nations qualification,3,2,1,0,1,2,1,0
Sierra Leone,1991,African Cup of Nations qualification,2,2,1,2,1,4,0,0
Sierra Leone,1991,Amílcar Cabral Cup,2,1,1,0,3,4,1,0
Sierra Leone,1992,African Cup of Nations qualification,6,0,3,0,0,3,6,0
Sierra Leone,1992,Friendly,0,0,0,0,1,1,0,0
Sierra Leone,1993,African Cup of Nations qualification,3,1,1,0,2,3,2,0
Sierra Leone,1993,Amílcar Cabral Cup,6,2,2,0,2,4,4,0
Sierra Leone,1993,Friendly,2,8,0,3,0,3,-6,0
Sierra Leone,1994,African Cup of Nations,0,4,0,1,1,2,-4,0
Sierra Leone,1994,African Cup of Nations qualification,4,6,1,1,0,2,-2,0
Sierra Leone,1995,African Cup of Nations qualification,3,0,2,0,0,2,3,0
Sierra Leone,1995,Amílcar Cabral Cup,7,1,3,0,2,5,6,0
Sierra Leone,1995,Friendly,2,8,1,3,0,4,-6,0
Sierra Leone,1996,African Cup of Nations,2,7,1,2,0,3,-5,0
Sierra Leone,1996,African Cup of Nations qualification,0,2,0,1,0,1,-2,0
Sierra Leone,1996,FIFA World Cup qualification,0,6,0,3,0,3,-6,0
Sierra Leone,1996,Friendly,2,1,1,0,0,1,1,0
Sierra Leone,1997,African Cup of Nations qualification,0,1,0,1,0,1,-1,0
Sierra Leone,1997,Amílcar Cabral Cup,3,5,1,1,1,3,-2,0
Sierra Leone,1997,FIFA World Cup qualification,4,2,2,1,1,4,2,0
Sierra Leone,1997,Friendly,2,1,1,0,0,1,1,0
Sierra Leone,1999,Friendly,0,0,0,0,1,1,0,0
Sierra Leone,2000,African Cup of Nations qualification,2,2,1,1,0,2,0,0
Sierra Leone,2000,Amílcar Cabral Cup,2,3,0,1,1,2,-1,0
Sierra Leone,2000,FIFA World Cup qualification,4,9,1,3,0,4,-5,0
Sierra Leone,2001,FIFA World Cup qualification,2,8,1,4,1,6,-6,0
Sierra Leone,2001,Friendly,1,1,0,0,1,1,0,0
Sierra Leone,2002,African Cup of Nations qualification,5,1,2,0,0,2,4,0
Sierra Leone,2002,Friendly,2,2,1,1,0,2,0,0
Sierra Leone,2003,African Cup of Nations qualification,2,3,1,2,1,4,-1,0
Sierra Leone,2003,FIFA World Cup qualification,1,2,0,1,1,2,-1,0
Sierra Leone,2005,Amílcar Cabral Cup,1,2,0,1,1,2,-1,0
Sierra Leone,2005,Friendly,5,0,3,0,0,3,5,0
Sierra Leone,2006,African Cup of Nations qualification,0,2,0,1,1,2,-2,0
Sierra Leone,2007,African Cup of Nations qualification,1,12,0,4,0,4,-11,0
Sierra Leone,2007,Amílcar Cabral Cup,0,2,0,1,0,1,-2,0
Sierra Leone,2007,FIFA World Cup qualification,1,0,1,0,1,2,1,0
Sierra Leone,2007,Friendly,1,2,0,1,0,1,-1,0
Sierra Leone,2008,FIFA World Cup qualification,4,8,2,3,1,6,-4,0
Sierra Leone,2008,Friendly,1,3,0,1,0,1,-2,0
Sierra Leone,2010,African Cup of Nations qualification,1,1,0,0,2,2,0,0
Sierra Leone,2011,African Cup of Nations qualification,4,4,2,1,1,4,0,0
Sierra Leone,2011,Friendly,1,2,0,1,0,1,-1,0
Sierra Leone,2012,African Cup of Nations qualification,7,6,1,1,2,4,1,0
Sierra Leone,2012,FIFA World Cup qualification,4,3,1,0,1,2,1,0
Sierra Leone,2012,Friendly,1,8,0,3,0,3,-7,0
Sierra Leone,2013,FIFA World Cup qualification,6,7,1,2,1,4,-1,0
Sierra Leone,2014,African Cup of Nations qualification,7,15,2,5,2,9,-8,0
Sierra Leone,2015,African Cup of Nations qualification,0,1,0,1,1,2,-1,0
Sierra Leone,2015,FIFA World Cup qualification,2,2,1,1,0,2,0,0
Sierra Leone,2016,African Cup of Nations qualification,2,1,1,0,1,2,1,0
Sierra Leone,2016,Friendly,2,2,1,1,0,2,0,0
Sierra Leone,2018,Friendly,0,4,0,1,1,2,-4,0
Sierra Leone,2019,African Cup of Nations qualification,1,2,0,1,1,2,-1,0
Sierra Leone,2019,FIFA World Cup qualification,2,3,1,1,0,2,-1,0
Sierra Leone,2020,African Cup of Nations qualification,4,4,0,0,2,2,0,0
Sierra Leone,2020,Friendly,1,3,0,2,0,2,-2,0
Sierra Leone,2021,African Cup of Nations qualification,1,0,1,0,1,2,1,1
Sierra Leone,2021,Friendly,3,4,1,1,2,4,-1,0
Sierra Leone,2022,African Cup of Nations,2,3,0,1,2,3,-1,0
Sierra Leone,2022,African Cup of Nations qualification,3,4,0,1,1,2,-1,0
Sierra Leone,2022,Friendly,3,11,2,3,0,5,-8,0
Sierra Leone,2023,African Cup of Nations qualification,7,7,1,2,1,4,0,0
Sierra Leone,2023,FIFA World Cup qualification,0,2,0,1,1,2,-2,0
Sierra Leone,2023,Friendly,3,1,1,0,1,2,2,0
Sierra Leone,2024,African Cup of Nations qualification,4,7,1,2,1,4,-3,0
Sierra Leone,2024,FIFA World Cup qualification,4,3,1,0,1,2,1,0
Sierra Leone,2024,Friendly,2,8,0,2,0,2,-6,0
Sierra Leone,2025,FIFA World Cup qualification,3,2,1,1,0,2,1,0
Silesia,1933,Friendly,1,2,0,1,0,1,-1,0
Silesia,1937,Friendly,3,4,0,1,0,1,-1,0
Silesia,1948,Friendly,2,1,1,0,0,1,1,0
Silesia,1952,Friendly,5,1,1,0,0,1,4,0
Silesia,1953,Friendly,5,6,0,1,1,2,-1,0
Silesia,1974,Friendly,7,2,1,0,0,1,5,0
Silesia,2006,Friendly,1,1,0,0,1,1,0,0
Singapore,1953,Friendly,9,8,2,2,1,5,1,0
Singapore,1954,Asian Games,3,7,0,1,1,2,-4,0
Singapore,1954,Friendly,2,2,0,0,1,1,0,0
Singapore,1956,Friendly,3,11,0,1,1,2,-8,0
Singapore,1957,Friendly,4,4,1,1,0,2,0,0
Singapore,1957,Merdeka Tournament,16,10,2,1,2,5,6,0
Singapore,1958,Asian Games,2,4,0,2,0,2,-2,0
Singapore,1958,Friendly,10,23,0,4,2,6,-13,0
Singapore,1958,Merdeka Tournament,4,6,0,1,2,3,-2,0
Singapore,1959,AFC Asian Cup qualification,3,9,0,2,0,2,-6,0
Singapore,1959,Friendly,8,13,1,3,0,4,-5,0
Singapore,1959,Merdeka Tournament,2,10,0,3,0,3,-8,0
Singapore,1960,Friendly,7,1,2,0,0,2,6,0
Singapore,1960,Merdeka Tournament,7,13,0,2,1,3,-6,0
Singapore,1961,Merdeka Tournament,6,6,1,2,0,3,0,0
Singapore,1962,Friendly,7,11,1,2,1,4,-4,0
Singapore,1962,Merdeka Tournament,7,4,1,1,1,3,3,0
Singapore,1963,Friendly,4,3,1,0,0,1,1,0
Singapore,1964,Friendly,4,4,1,1,1,3,0,0
Singapore,1965,Friendly,4,7,1,2,1,4,-3,0
Singapore,1965,Southeast Asian Peninsular Games,1,6,0,2,0,2,-5,0
Singapore,1966,Asian Games,11,15,2,4,1,7,-4,0
Singapore,1966,Friendly,3,5,0,1,1,2,-2,0
Singapore,1966,Merdeka Tournament,8,6,2,2,1,5,2,0
Singapore,1967,AFC Asian Cup qualification,0,3,0,1,0,1,-3,0
Singapore,1967,Friendly,5,0,2,0,0,2,5,0
Singapore,1967,Merdeka Tournament,7,18,0,4,1,5,-11,0
Singapore,1967,Vietnam Independence Cup,2,10,0,3,0,3,-8,0
Singapore,1968,Friendly,6,3,3,0,0,3,3,0
Singapore,1968,King's Cup,0,12,0,3,0,3,-12,0
Singapore,1968,Merdeka Tournament,6,13,0,3,1,4,-7,0
Singapore,1969,Friendly,7,5,1,1,0,2,2,0
Singapore,1969,King's Cup,5,6,1,1,1,3,-1,0
Singapore,1969,Merdeka Tournament,7,26,1,4,0,5,-19,0
Singapore,1970,Friendly,3,8,0,1,0,1,-5,0
Singapore,1970,Indonesia Tournament,0,13,0,2,0,2,-13,0
Singapore,1970,King's Cup,2,10,1,3,0,4,-8,0
Singapore,1970,Merdeka Tournament,7,23,0,6,0,6,-16,0
Singapore,1971,Friendly,5,6,1,1,0,2,-1,0
Singapore,1971,Indonesia Tournament,0,9,0,2,0,2,-9,0
Singapore,1971,King's Cup,4,7,0,2,0,2,-3,0
Singapore,1971,Merdeka Tournament,9,11,2,1,2,5,-2,0
Singapore,1971,Southeast Asian Peninsular Games,2,11,0,2,0,2,-9,0
Singapore,1971,Vietnam Independence Cup,4,3,1,1,1,3,1,1
Singapore,1972,Friendly,12,6,3,1,0,4,6,0
Singapore,1972,Indonesia Tournament,0,5,0,2,0,2,-5,0
Singapore,1972,King's Cup,2,9,1,3,1,5,-7,0
Singapore,1972,Korea Cup,6,5,1,2,0,3,1,0
Singapore,1972,Merdeka Tournament,8,11,1,3,1,5,-3,0
Singapore,1972,Vietnam Independence Cup,5,5,2,1,0,3,0,1
Singapore,1973,Friendly,4,6,0,2,0,2,-2,0
Singapore,1973,King's Cup,3,12,0,3,0,3,-9,0
Singapore,1973,Merdeka Tournament,5,6,1,3,2,6,-1,0
Singapore,1973,Southeast Asian Peninsular Games,2,4,1,1,2,4,-2,0
Singapore,1973,Vietnam Independence Cup,3,6,0,2,0,2,-3,0
Singapore,1974,Friendly,1,3,0,2,1,3,-2,0
Singapore,1974,King's Cup,3,2,1,1,1,3,1,0
Singapore,1974,Merdeka Tournament,1,6,0,1,1,2,-5,0
Singapore,1975,AFC Asian Cup qualification,0,1,0,1,0,1,-1,0
Singapore,1975,Friendly,2,2,0,0,1,1,0,0
Singapore,1975,King's Cup,1,11,1,2,1,4,-10,0
Singapore,1975,Southeast Asian Peninsular Games,4,5,0,1,2,3,-1,0
Singapore,1976,Friendly,0,1,0,1,0,1,-1,0
Singapore,1976,King's Cup,0,10,0,2,0,2,-10,0
Singapore,1976,Korea Cup,3,12,1,2,0,3,-9,0
Singapore,1977,FIFA World Cup qualification,5,7,2,2,1,5,-2,0
Singapore,1977,Friendly,0,6,0,2,0,2,-6,0
Singapore,1977,King's Cup,4,8,0,3,0,3,-4,0
Singapore,1977,Southeast Asian Games,1,7,0,2,0,2,-6,0
Singapore,1978,Friendly,0,2,0,1,0,1,-2,0
Singapore,1978,Indonesia Tournament,4,6,0,1,2,3,-2,0
Singapore,1978,King's Cup,3,2,1,0,1,2,1,0
Singapore,1978,Merdeka Tournament,7,15,2,4,1,7,-8,0
Singapore,1979,Friendly,0,5,0,1,0,1,-5,0
Singapore,1979,Merdeka Tournament,3,11,0,3,2,5,-8,0
Singapore,1979,Southeast Asian Games,4,8,1,2,1,4,-4,0
Singapore,1980,FIFA World Cup qualification,1,3,0,2,1,3,-2,0
Singapore,1980,Friendly,0,2,0,1,0,1,-2,0
Singapore,1980,King's Cup,4,1,1,0,1,2,3,0
Singapore,1981,Friendly,3,3,1,1,2,4,0,0
Singapore,1981,King's Cup,2,3,1,2,0,3,-1,0
Singapore,1981,Merdeka Tournament,1,9,0,3,0,3,-8,0
Singapore,1981,Southeast Asian Games,5,4,1,2,1,4,1,0
Singapore,1982,Friendly,8,9,2,2,0,4,-1,0
Singapore,1982,King's Cup,6,4,2,1,2,5,2,0
Singapore,1982,Kirin Cup,0,2,0,1,0,1,-2,0
Singapore,1982,Merdeka Tournament,5,3,2,1,0,3,2,0
Singapore,1982,Merlion Cup,7,1,1,1,0,2,6,0
Singapore,1983,Friendly,4,1,1,1,1,3,3,0
Singapore,1983,Merlion Cup,7,4,2,1,0,3,3,0
Singapore,1983,Southeast Asian Games,12,3,3,1,0,4,9,0
Singapore,1984,AFC Asian Cup,3,4,1,2,1,4,-1,0
Singapore,1984,Friendly,1,3,0,2,1,3,-2,0
Singapore,1985,FIFA World Cup qualification,2,11,0,3,1,4,-9,0
Singapore,1985,Merlion Cup,8,1,3,0,0,3,7,1
Singapore,1985,Southeast Asian Games,6,4,2,1,1,4,2,0
Singapore,1986,Friendly,0,4,0,1,0,1,-4,0
Singapore,1986,Merlion Cup,1,9,0,5,0,5,-8,0
Singapore,1987,Southeast Asian Games,0,0,0,0,1,1,0,0
Singapore,1988,Friendly,0,1,0,1,0,1,-1,0
Singapore,1988,Merdeka Tournament,3,1,1,0,0,1,2,0
Singapore,1989,FIFA World Cup qualification,12,9,2,3,1,6,3,0
Singapore,1989,Friendly,1,2,0,1,0,1,-1,0
Singapore,1989,Southeast Asian Games,7,4,2,1,1,4,3,0
Singapore,1990,Asian Games,7,13,1,2,0,3,-6,0
Singapore,1990,Friendly,3,6,1,1,0,2,-3,0
Singapore,1991,Friendly,2,0,1,0,0,1,2,0
Singapore,1991,Southeast Asian Games,4,1,2,0,2,4,3,0
Singapore,1992,AFC Asian Cup qualification,2,4,0,2,1,3,-2,0
Singapore,1992,Merlion Cup,3,0,1,0,0,1,3,1
Singapore,1993,FIFA World Cup qualification,12,12,5,3,0,8,0,0
Singapore,1993,Friendly,0,3,0,1,0,1,-3,0
Singapore,1993,Merdeka Tournament,2,3,0,1,1,2,-1,0
Singapore,1993,Southeast Asian Games,16,5,3,0,2,5,11,0
Singapore,1995,Friendly,0,3,0,1,1,2,-3,0
Singapore,1995,Southeast Asian Games,11,5,3,1,2,6,6,0
Singapore,1996,AFC Asian Cup qualification,16,7,3,0,3,6,9,0
Singapore,1996,AFF Championship,7,2,2,1,1,4,5,0
Singapore,1997,Dunhill Cup,1,4,0,2,1,3,-3,0
Singapore,1997,FIFA World Cup qualification,2,8,0,3,1,4,-6,0
Singapore,1997,Southeast Asian Games,6,6,2,2,2,6,0,0
Singapore,1998,AFF Championship,9,2,4,0,1,5,7,0
Singapore,1998,AFF Championship qualification,4,0,2,0,0,2,4,1
Singapore,1998,Friendly,0,4,0,1,0,1,-4,0
Singapore,1999,Friendly,0,3,0,3,0,3,-3,0
Singapore,1999,Southeast Asian Games,8,5,3,1,2,6,3,0
Singapore,2000,AFC Asian Cup qualification,2,3,2,1,0,3,-1,0
Singapore,2000,AFF Championship,4,2,2,2,0,4,2,0
Singapore,2000,Friendly,9,7,3,2,1,6,2,0
Singapore,2001,FIFA World Cup qualification,3,8,0,4,2,6,-5,0
Singapore,2001,Friendly,4,9,1,2,1,4,-5,0
Singapore,2002,AFF Championship,3,6,1,1,1,3,-3,0
Singapore,2002,Friendly,11,8,4,2,1,7,3,0
Singapore,2002,King's Cup,2,13,0,4,0,4,-11,0
Singapore,2003,AFC Asian Cup qualification,8,9,3,3,1,7,-1,0
Singapore,2003,Friendly,9,7,2,2,0,4,2,0
Singapore,2004,AFF Championship,14,6,3,0,2,5,8,1
Singapore,2004,FIFA World Cup qualification,3,13,1,5,0,6,-10,0
Singapore,2004,Friendly,6,9,2,3,1,6,-3,0
Singapore,2005,AFF Championship,9,4,3,0,0,3,5,1
Singapore,2005,Friendly,6,1,3,0,0,3,5,0
Singapore,2006,AFC Asian Cup qualification,4,6,1,3,1,5,-2,0
Singapore,2006,Friendly,4,5,1,2,3,6,-1,0
Singapore,2006,King's Cup,2,5,0,2,1,3,-3,0
Singapore,2007,AFF Championship,18,6,2,0,5,7,12,0
Singapore,2007,FIFA World Cup qualification,7,1,2,0,1,3,6,0
Singapore,2007,Friendly,7,10,1,3,1,5,-3,0
Singapore,2007,Merdeka Tournament,8,4,2,0,0,2,4,0
Singapore,2008,AFF Championship,10,1,3,0,1,4,9,0
Singapore,2008,FIFA World Cup qualification,7,16,2,4,0,6,-9,0
Singapore,2008,Friendly,5,7,1,3,3,7,-2,0
Singapore,2009,AFC Asian Cup qualification,4,10,2,2,0,4,-6,0
Singapore,2009,Friendly,11,10,2,1,2,5,1,0
Singapore,2010,AFC Asian Cup qualification,2,5,0,2,0,2,-3,0
Singapore,2010,AFF Championship,3,3,1,1,1,3,0,0
Singapore,2010,Friendly,4,1,1,1,0,2,3,0
Singapore,2010,King's Cup,1,7,0,2,0,2,-6,0
Singapore,2010,VFF Cup,2,3,0,1,1,2,-1,0
Singapore,2011,FIFA World Cup qualification,7,17,1,5,1,7,-10,0
Singapore,2011,Friendly,5,2,2,0,1,3,3,0
Singapore,2012,AFF Championship,11,6,4,2,1,7,5,0
Singapore,2012,FIFA World Cup qualification,1,7,0,1,0,1,-6,0
Singapore,2012,Friendly,13,11,3,4,3,10,2,0
Singapore,2013,AFC Asian Cup qualification,2,11,1,3,0,4,-9,0
Singapore,2013,Friendly,10,9,4,2,0,6,1,0
Singapore,2014,AFC Asian Cup qualification,2,6,0,2,0,2,-4,0
Singapore,2014,AFF Championship,6,7,1,2,0,3,-1,0
Singapore,2014,Friendly,11,9,3,2,2,7,2,0
Singapore,2015,FIFA World Cup qualification,8,7,3,3,1,7,1,0
Singapore,2015,Friendly,9,10,2,2,1,5,-1,0
Singapore,2016,AFF Championship,1,3,0,2,1,3,-2,0
Singapore,2016,FIFA World Cup qualification,1,2,0,1,0,1,-1,0
Singapore,2016,Friendly,6,13,3,5,1,9,-7,0
Singapore,2017,AFC Asian Cup qualification,3,8,0,3,2,5,-5,0
Singapore,2017,Friendly,3,13,0,4,1,5,-10,0
Singapore,2018,AFC Asian Cup qualification,0,1,0,1,0,1,-1,0
Singapore,2018,AFF Championship,7,5,2,2,0,4,2,0
Singapore,2018,Friendly,10,4,4,0,1,5,6,0
Singapore,2019,FIFA World Cup qualification,7,10,2,2,1,5,-3,0
Singapore,2019,Friendly,6,8,1,2,2,5,-2,0
Singapore,2021,AFF Championship,10,8,3,2,1,6,2,0
Singapore,2021,FIFA World Cup qualification,0,12,0,3,0,3,-12,0
Singapore,2021,Friendly,2,3,0,1,1,2,-1,0
Singapore,2022,AFC Asian Cup qualification,7,5,1,2,0,3,2,0
Singapore,2022,AFF Championship,5,2,2,0,1,3,3,0
Singapore,2022,Friendly,8,9,3,2,1,6,-1,0
Singapore,2023,AFF Championship,1,4,0,1,0,1,-3,0
Singapore,2023,FIFA World Cup qualification,4,9,2,2,0,4,-5,0
Singapore,2023,Friendly,8,7,2,1,3,6,1,0
Singapore,2024,ASEAN Championship,8,10,2,3,1,6,-2,0
Singapore,2024,FIFA World Cup qualification,4,16,0,3,1,4,-12,0
Singapore,2024,Friendly,5,5,1,1,0,2,0,0
Singapore,2025,AFC Asian Cup qualification,0,0,0,0,1,1,0,0
Singapore,2025,Friendly,0,1,0,1,0,1,-1,0
Sint Maarten,1989,CFU Caribbean Cup qualification,2,14,0,3,0,3,-12,0
Sint Maarten,1990,CFU Caribbean Cup qualification,1,1,0,0,1,1,0,0
Sint Maarten,1992,CFU Caribbean Cup qualification,5,3,1,0,1,2,2,0
Sint Maarten,1993,CFU Caribbean Cup,2,7,0,2,1,3,-5,0
Sint Maarten,1993,CFU Caribbean Cup qualification,3,0,2,0,0,2,3,0
Sint Maarten,1994,CFU Caribbean Cup qualification,5,8,1,2,0,3,-3,0
Sint Maarten,1995,CFU Caribbean Cup qualification,1,2,1,1,0,2,-1,0
Sint Maarten,1996,CFU Caribbean Cup qualification,4,3,1,1,0,2,1,0
Sint Maarten,1997,CFU Caribbean Cup qualification,6,3,2,1,0,3,3,0
Sint Maarten,2000,Friendly,1,3,0,1,1,2,-2,0
Sint Maarten,2016,CFU Caribbean Cup qualification,1,2,0,1,0,1,-1,0
Sint Maarten,2016,Friendly,2,0,1,0,0,1,2,0
Sint Maarten,2018,CONCACAF Nations League qualification,0,27,0,3,0,3,-27,0
Sint Maarten,2018,Friendly,4,6,0,1,1,2,-2,0
Sint Maarten,2019,CONCACAF Nations League,6,15,0,4,0,4,-9,0
Sint Maarten,2019,CONCACAF Nations League qualification,4,3,1,0,0,1,1,0
Sint Maarten,2019,Friendly,1,1,0,0,1,1,0,0
Sint Maarten,2022,CONCACAF Nations League,11,7,1,1,2,4,4,0
Sint Maarten,2023,CONCACAF Nations League,14,17,4,4,0,8,-3,0
Sint Maarten,2023,Friendly,1,5,0,1,0,1,-4,0
Sint Maarten,2023,Gold Cup qualification,1,4,0,1,0,1,-3,0
Sint Maarten,2024,CONCACAF Nations League,7,18,3,3,0,6,-11,0
Slovakia,1939,Friendly,3,3,1,1,0,2,0,0
Slovakia,1940,Friendly,4,2,1,1,0,2,2,0
Slovakia,1941,Friendly,4,12,0,3,0,3,-8,0
Slovakia,1942,Friendly,5,13,1,3,0,4,-8,0
Slovakia,1943,Friendly,2,3,0,1,1,2,-1,0
Slovakia,1944,Friendly,3,7,0,1,0,1,-4,0
Slovakia,1992,Friendly,4,2,2,0,0,2,2,0
Slovakia,1993,Friendly,4,2,1,0,1,2,2,0
Slovakia,1994,Friendly,8,5,2,1,1,4,3,0
Slovakia,1994,UEFA Euro qualification,4,5,0,1,2,3,-1,0
Slovakia,1994,United Arab Emirates Friendship Tournament,2,3,1,2,0,3,-1,0
Slovakia,1995,Friendly,3,8,1,2,1,4,-5,0
Slovakia,1995,UEFA Euro qualification,10,13,4,3,0,7,-3,0
Slovakia,1996,FIFA World Cup qualification,12,5,3,1,0,4,7,0
Slovakia,1996,Friendly,7,7,1,2,1,4,0,0
Slovakia,1997,FIFA World Cup qualification,6,9,2,3,1,6,-3,0
Slovakia,1997,Friendly,7,4,3,1,1,5,3,0
Slovakia,1998,Cyprus International Tournament,5,2,2,0,1,3,3,1
Slovakia,1998,Friendly,1,7,0,3,2,5,-6,0
Slovakia,1998,UEFA Euro qualification,7,3,2,1,0,3,4,0
Slovakia,1999,Friendly,5,8,3,3,0,6,-3,0
Slovakia,1999,UEFA Euro qualification,5,6,3,2,2,7,-1,0
Slovakia,2000,FIFA World Cup qualification,3,0,2,0,1,3,3,0
Slovakia,2000,Friendly,7,6,2,2,4,8,1,0
Slovakia,2000,Kirin Cup,3,1,1,0,1,2,2,0
Slovakia,2001,FIFA World Cup qualification,13,9,3,3,1,7,4,0
Slovakia,2001,Friendly,4,7,0,2,2,4,-3,0
Slovakia,2001,Merdeka Tournament,2,3,1,2,0,3,-1,0
Slovakia,2002,Friendly,10,11,2,2,2,6,-1,0
Slovakia,2002,Kirin Cup,0,1,0,1,0,1,-1,0
Slovakia,2002,UEFA Euro qualification,1,5,0,2,0,2,-4,0
Slovakia,2003,Cyprus International Tournament,4,3,1,1,0,2,1,1
Slovakia,2003,Friendly,2,2,0,0,2,2,0,0
Slovakia,2003,UEFA Euro qualification,10,4,3,2,1,6,6,0
Slovakia,2004,FIFA World Cup qualification,15,3,3,0,1,4,12,0
Slovakia,2004,Friendly,2,3,0,1,3,4,-1,0
Slovakia,2004,King's Cup,2,1,1,0,1,2,1,0
Slovakia,2004,Kirin Cup,1,5,0,2,0,2,-4,0
Slovakia,2005,FIFA World Cup qualification,11,11,3,2,5,10,0,0
Slovakia,2005,Friendly,4,2,1,0,1,2,2,0
Slovakia,2006,Friendly,11,4,4,0,1,5,7,0
Slovakia,2006,UEFA Euro qualification,12,9,2,2,0,4,3,0
Slovakia,2007,Friendly,2,6,0,2,1,3,-4,0
Slovakia,2007,UEFA Euro qualification,21,14,3,4,1,8,7,0
Slovakia,2008,FIFA World Cup qualification,8,5,3,1,0,4,3,0
Slovakia,2008,Friendly,6,8,1,4,1,6,-2,0
Slovakia,2009,Cyprus International Tournament,4,6,0,2,0,2,-2,0
Slovakia,2009,FIFA World Cup qualification,14,5,4,1,1,6,9,0
Slovakia,2009,Friendly,3,7,1,2,1,4,-4,0
Slovakia,2010,FIFA World Cup,5,7,1,2,1,4,-2,0
Slovakia,2010,Friendly,7,6,1,2,2,5,1,0
Slovakia,2010,UEFA Euro qualification,4,4,2,1,1,4,0,0
Slovakia,2011,Friendly,4,5,1,2,0,3,-1,0
Slovakia,2011,UEFA Euro qualification,3,6,2,2,2,6,-3,0
Slovakia,2012,FIFA World Cup qualification,5,3,2,1,1,4,2,0
Slovakia,2012,Friendly,5,8,2,3,0,5,-3,0
Slovakia,2013,FIFA World Cup qualification,6,7,1,2,3,6,-1,0
Slovakia,2013,Friendly,4,3,1,1,3,5,1,0
Slovakia,2014,Friendly,8,3,4,1,0,5,5,0
Slovakia,2014,UEFA Euro qualification,8,2,4,0,0,4,6,0
Slovakia,2015,Friendly,7,3,3,0,0,3,4,0
Slovakia,2015,UEFA Euro qualification,9,6,3,2,1,6,3,0
Slovakia,2016,FIFA World Cup qualification,7,2,2,2,0,4,5,0
Slovakia,2016,Friendly,8,4,2,0,4,6,4,0
Slovakia,2016,UEFA Euro,3,6,1,2,1,4,-3,0
Slovakia,2017,FIFA World Cup qualification,10,5,4,2,0,6,5,0
Slovakia,2017,Friendly,2,2,1,1,0,2,0,0
Slovakia,2018,Friendly,11,7,3,1,2,6,4,0
Slovakia,2018,UEFA Nations League,5,5,1,3,0,4,0,0
Slovakia,2019,Friendly,6,2,1,0,1,2,4,0
Slovakia,2019,UEFA Euro qualification,13,11,4,3,1,8,2,0
Slovakia,2020,UEFA Euro qualification,2,1,1,0,1,2,1,1
Slovakia,2020,UEFA Nations League,5,10,1,4,1,6,-5,0
Slovakia,2021,FIFA World Cup qualification,17,10,3,2,5,10,7,0
Slovakia,2021,Friendly,1,1,0,0,2,2,0,0
Slovakia,2021,UEFA Euro,2,7,1,2,0,3,-5,0
Slovakia,2022,Friendly,4,4,1,1,2,4,0,0
Slovakia,2022,UEFA Nations League,5,6,2,3,1,6,-1,0
Slovakia,2023,UEFA Euro qualification,17,8,7,2,1,10,9,0
Slovakia,2024,Friendly,9,3,2,1,1,4,6,0
Slovakia,2024,UEFA Euro,4,5,1,2,1,4,-1,0
Slovakia,2024,UEFA Nations League,10,5,4,1,1,6,5,0
Slovakia,2025,UEFA Nations League,0,1,0,1,1,2,-1,0
Slovenia,1991,Friendly,0,1,0,1,0,1,-1,0
Slovenia,1992,Friendly,2,2,0,0,2,2,0,0
Slovenia,1993,Friendly,3,6,1,2,0,3,-3,0
Slovenia,1994,Friendly,4,2,2,1,1,4,2,0
Slovenia,1994,Malta International Tournament,4,2,2,0,1,3,2,1
Slovenia,1994,UEFA Euro qualification,2,3,0,1,2,3,-1,0
Slovenia,1995,Friendly,2,1,1,0,0,1,1,0
Slovenia,1995,UEFA Euro qualification,11,10,3,4,0,7,1,0
Slovenia,1996,FIFA World Cup qualification,1,6,0,3,0,3,-5,0
Slovenia,1996,Friendly,2,2,0,0,2,2,0,0
Slovenia,1996,Malta International Tournament,8,4,1,1,1,3,4,0
Slovenia,1997,FIFA World Cup qualification,4,14,0,4,1,5,-10,0
Slovenia,1997,Friendly,2,0,1,0,0,1,2,0
Slovenia,1998,Cyprus International Tournament,4,4,1,1,1,3,0,0
Slovenia,1998,Friendly,2,7,0,3,0,3,-5,0
Slovenia,1998,UEFA Euro qualification,4,4,1,1,1,3,0,0
Slovenia,1999,Friendly,8,3,1,1,1,3,5,0
Slovenia,1999,UEFA Euro qualification,11,12,5,2,2,9,-1,0
Slovenia,2000,FIFA World Cup qualification,6,5,1,0,2,3,1,0
Slovenia,2000,Friendly,10,4,3,1,1,5,6,0
Slovenia,2000,UEFA Euro,4,5,0,1,2,3,-1,0
Slovenia,2001,FIFA World Cup qualification,14,6,5,0,4,9,8,0
Slovenia,2001,Friendly,2,7,0,2,1,3,-5,0
Slovenia,2002,FIFA World Cup,2,7,0,3,0,3,-5,0
Slovenia,2002,Friendly,4,0,3,0,1,4,4,0
Slovenia,2002,Lunar New Year Cup,1,5,0,1,1,2,-4,0
Slovenia,2002,UEFA Euro qualification,3,5,1,1,0,2,-2,0
Slovenia,2003,Friendly,3,6,1,1,0,2,-3,0
Slovenia,2003,UEFA Euro qualification,13,9,3,2,3,8,4,0
Slovenia,2004,FIFA World Cup qualification,4,3,2,1,1,4,1,0
Slovenia,2004,Friendly,2,6,0,3,2,5,-4,0
Slovenia,2005,FIFA World Cup qualification,6,10,1,3,2,6,-4,0
Slovenia,2005,Friendly,0,4,0,2,1,3,-4,0
Slovenia,2006,Cyprus International Tournament,1,2,1,1,0,2,-1,0
Slovenia,2006,Friendly,4,5,1,1,1,3,-1,0
Slovenia,2006,UEFA Euro qualification,4,7,1,2,0,3,-3,0
Slovenia,2007,Friendly,2,1,1,0,1,2,1,0
Slovenia,2007,UEFA Euro qualification,5,9,2,5,2,9,-4,0
Slovenia,2008,FIFA World Cup qualification,5,3,2,1,1,4,2,0
Slovenia,2008,Friendly,7,10,1,4,0,5,-3,0
Slovenia,2009,FIFA World Cup qualification,15,3,5,2,1,8,12,0
Slovenia,2009,Friendly,1,4,0,2,0,2,-3,0
Slovenia,2010,FIFA World Cup,3,3,1,1,1,3,0,0
Slovenia,2010,Friendly,10,4,3,1,0,4,6,0
Slovenia,2010,UEFA Euro qualification,7,3,2,1,1,4,4,0
Slovenia,2011,Friendly,4,4,1,1,1,3,0,0
Slovenia,2011,UEFA Euro qualification,4,4,2,3,1,6,0,0
Slovenia,2012,FIFA World Cup qualification,3,6,1,3,0,4,-3,0
Slovenia,2012,Friendly,8,8,1,1,2,4,0,0
Slovenia,2013,FIFA World Cup qualification,11,5,4,2,0,6,6,0
Slovenia,2013,Friendly,3,5,2,2,0,4,-2,0
Slovenia,2014,Friendly,0,5,0,3,0,3,-5,0
Slovenia,2014,UEFA Euro qualification,4,4,2,2,0,4,0,0
Slovenia,2015,Friendly,0,1,0,1,0,1,-1,0
Slovenia,2015,UEFA Euro qualification,15,10,3,3,2,8,5,0
Slovenia,2016,FIFA World Cup qualification,4,2,2,0,2,4,2,0
Slovenia,2016,Friendly,2,3,1,2,2,5,-1,0
Slovenia,2017,FIFA World Cup qualification,8,5,2,3,1,6,3,0
Slovenia,2018,Friendly,2,5,1,2,0,3,-3,0
Slovenia,2018,UEFA Nations League,5,8,0,3,3,6,-3,0
Slovenia,2019,UEFA Euro qualification,16,11,4,4,2,10,5,0
Slovenia,2020,Friendly,4,0,1,0,1,2,4,0
Slovenia,2020,UEFA Nations League,8,1,4,0,2,6,7,0
Slovenia,2021,FIFA World Cup qualification,13,12,4,4,2,10,1,0
Slovenia,2021,Friendly,7,1,1,0,1,2,6,0
Slovenia,2022,Friendly,4,2,2,0,2,4,2,0
Slovenia,2022,UEFA Nations League,6,10,1,2,3,6,-4,0
Slovenia,2023,UEFA Euro qualification,20,9,7,2,1,10,11,0
Slovenia,2024,Friendly,8,4,3,0,2,5,4,0
Slovenia,2024,UEFA Euro,2,2,0,0,4,4,0,0
Slovenia,2024,UEFA Nations League,7,9,2,2,2,6,-2,0
Slovenia,2025,UEFA Nations League,1,0,1,0,1,2,1,0
Solomon Islands,1963,South Pacific Games,6,26,1,2,0,3,-20,0
Solomon Islands,1966,South Pacific Games,4,12,0,1,1,2,-8,0
Solomon Islands,1969,South Pacific Games,4,24,0,4,1,5,-20,0
Solomon Islands,1975,South Pacific Games,9,8,2,1,1,4,1,0
Solomon Islands,1979,South Pacific Games,24,5,4,1,0,5,19,0
Solomon Islands,1980,Oceania Nations Cup,3,21,0,3,0,3,-18,0
Solomon Islands,1981,South Pacific Mini Games,11,10,2,3,1,6,1,0
Solomon Islands,1983,South Pacific Games,0,11,0,2,0,2,-11,0
Solomon Islands,1988,Friendly,8,4,2,1,1,4,4,0
Solomon Islands,1989,Friendly,2,2,1,1,2,4,0,0
Solomon Islands,1990,Friendly,3,4,1,1,2,4,-1,0
Solomon Islands,1991,South Pacific Games,13,2,3,0,2,5,11,0
Solomon Islands,1992,FIFA World Cup qualification,5,13,0,3,1,4,-8,0
Solomon Islands,1992,Friendly,4,4,1,2,0,3,0,0
Solomon Islands,1993,South Pacific Mini Games,12,5,1,2,0,3,7,0
Solomon Islands,1994,Friendly,1,0,1,0,0,1,1,0
Solomon Islands,1994,Oceania Nations Cup qualification,10,1,4,0,0,4,9,0
Solomon Islands,1995,Oceania Nations Cup,0,1,0,1,0,1,-1,0
Solomon Islands,1995,South Pacific Games,34,10,3,2,1,6,24,0
Solomon Islands,1996,FIFA World Cup qualification,2,2,0,0,2,2,0,0
Solomon Islands,1996,Oceania Nations Cup,1,2,0,1,0,1,-1,0
Solomon Islands,1997,FIFA World Cup qualification,20,21,3,2,1,6,-1,0
Solomon Islands,1997,Friendly,4,4,1,1,0,2,0,0
Solomon Islands,1998,Friendly,2,1,1,0,0,1,1,0
Solomon Islands,1998,Oceania Nations Cup qualification,8,7,2,1,1,4,1,0
Solomon Islands,2000,Oceania Nations Cup,7,10,2,2,0,4,-3,1
Solomon Islands,2000,Oceania Nations Cup qualification,10,9,2,1,1,4,1,0
Solomon Islands,2001,FIFA World Cup qualification,17,10,2,2,0,4,7,0
Solomon Islands,2002,Oceania Nations Cup,3,9,0,2,1,3,-6,0
Solomon Islands,2003,Friendly,5,3,1,0,0,1,2,0
Solomon Islands,2003,South Pacific Games,14,4,2,1,1,4,10,0
Solomon Islands,2004,FIFA World Cup qualification,14,1,3,0,1,4,13,0
Solomon Islands,2004,Friendly,4,2,2,0,0,2,2,0
Solomon Islands,2004,Oceania Nations Cup,10,17,3,3,1,7,-7,0
Solomon Islands,2005,FIFA World Cup qualification,1,9,0,2,0,2,-8,0
Solomon Islands,2007,Friendly,2,1,1,0,0,1,1,0
Solomon Islands,2007,South Pacific Games,23,6,4,2,0,6,17,0
Solomon Islands,2008,Friendly,1,2,0,1,0,1,-1,0
Solomon Islands,2011,Friendly,2,3,1,1,2,4,-1,0
Solomon Islands,2011,Pacific Games,21,6,5,2,0,7,15,0
Solomon Islands,2012,FIFA World Cup qualification,5,17,1,3,0,4,-12,0
Solomon Islands,2012,Oceania Nations Cup,5,6,1,2,2,5,-1,0
Solomon Islands,2013,FIFA World Cup qualification,0,4,0,2,0,2,-4,0
Solomon Islands,2016,FIFA World Cup qualification,1,3,1,1,0,2,-2,0
Solomon Islands,2016,Friendly,2,4,1,2,0,3,-2,0
Solomon Islands,2016,Oceania Nations Cup,2,4,1,3,0,4,-2,0
Solomon Islands,2017,FIFA World Cup qualification,8,11,2,1,1,4,-3,0
Solomon Islands,2017,Friendly,1,2,0,1,1,2,-1,0
Solomon Islands,2017,Pacific Mini Games,16,3,2,1,2,5,13,0
Solomon Islands,2018,Friendly,5,2,1,0,1,2,3,0
Solomon Islands,2019,Friendly,7,5,2,1,0,3,2,0
Solomon Islands,2019,Pacific Games,30,9,2,2,1,5,21,0
Solomon Islands,2022,FIFA World Cup qualification,8,8,3,1,0,4,0,0
Solomon Islands,2022,MSG Prime Minister's Cup,3,3,1,1,1,3,0,0
Solomon Islands,2023,Friendly,6,5,2,1,1,4,1,0
Solomon Islands,2023,MSG Prime Minister's Cup,5,1,3,0,0,3,4,0
Solomon Islands,2023,Pacific Games,16,2,3,0,1,4,14,0
Solomon Islands,2024,FIFA World Cup qualification,4,5,1,2,0,3,-1,0
Solomon Islands,2024,Friendly,2,3,1,1,0,2,-1,0
Solomon Islands,2024,Oceania Nations Cup,0,4,0,2,0,2,-4,0
Solomon Islands,2024,Tri-Nations Series,0,4,0,2,0,2,-4,0
Somalia,1963,Friendly,0,14,0,1,0,1,-14,0
Somalia,1969,Friendly,1,14,0,2,0,2,-13,0
Somalia,1972,Friendly,1,3,0,1,0,1,-2,0
Somalia,1973,CECAFA Cup,2,12,0,2,0,2,-10,0
Somalia,1973,Friendly,4,7,0,1,0,1,-3,0
Somalia,1974,African Cup of Nations qualification,1,2,1,1,0,2,-1,0
Somalia,1974,CECAFA Cup,2,3,0,1,1,2,-1,0
Somalia,1974,Friendly,4,6,0,2,0,2,-2,0
Somalia,1976,CECAFA Cup,2,7,0,3,0,3,-5,0
Somalia,1976,Friendly,1,1,0,0,1,1,0,0
Somalia,1977,CECAFA Cup,1,0,1,0,0,1,1,0
Somalia,1978,CECAFA Cup,3,10,0,3,1,4,-7,0
Somalia,1980,CECAFA Cup,1,3,0,1,1,2,-2,0
Somalia,1980,FIFA World Cup qualification,1,1,0,0,2,2,0,0
Somalia,1982,African Cup of Nations qualification,0,1,0,1,0,1,-1,0
Somalia,1983,CECAFA Cup,3,5,0,2,1,3,-2,0
Somalia,1984,African Cup of Nations qualification,1,1,1,1,0,2,0,0
Somalia,1984,CECAFA Cup,3,3,1,1,1,3,0,0
Somalia,1986,African Cup of Nations qualification,0,5,0,1,1,2,-5,0
Somalia,1986,Friendly,1,2,0,1,0,1,-1,0
Somalia,1994,CECAFA Cup,3,8,1,2,0,3,-5,0
Somalia,1995,CECAFA Cup,0,12,0,2,0,2,-12,0
Somalia,1999,CECAFA Cup,0,5,0,2,0,2,-5,0
Somalia,2000,CECAFA Cup,1,8,0,2,1,3,-7,0
Somalia,2000,FIFA World Cup qualification,0,6,0,2,0,2,-6,0
Somalia,2001,CECAFA Cup,0,6,0,2,1,3,-6,0
Somalia,2002,CECAFA Cup,1,4,1,3,0,4,-3,0
Somalia,2003,FIFA World Cup qualification,0,7,0,2,0,2,-7,0
Somalia,2004,CECAFA Cup,0,7,0,3,0,3,-7,0
Somalia,2005,CECAFA Cup,4,15,1,3,0,4,-11,0
Somalia,2006,Arab Cup qualification,3,18,0,3,0,3,-15,0
Somalia,2006,CECAFA Cup,0,8,0,3,0,3,-8,0
Somalia,2007,CECAFA Cup,0,6,0,3,0,3,-6,0
Somalia,2007,FIFA World Cup qualification,0,1,0,1,0,1,-1,0
Somalia,2008,Friendly,3,2,1,0,0,1,1,0
Somalia,2009,CECAFA Cup,2,13,1,5,0,6,-11,0
Somalia,2010,CECAFA Cup,0,11,0,3,0,3,-11,0
Somalia,2011,CECAFA Cup,1,11,0,3,0,3,-10,0
Somalia,2011,FIFA World Cup qualification,0,5,0,1,1,2,-5,0
Somalia,2012,CECAFA Cup,1,13,0,3,0,3,-12,0
Somalia,2013,CECAFA Cup,0,7,0,3,0,3,-7,0
Somalia,2015,CECAFA Cup,0,9,0,3,0,3,-9,0
Somalia,2015,FIFA World Cup qualification,0,6,0,2,0,2,-6,0
Somalia,2019,FIFA World Cup qualification,2,3,1,1,0,2,-1,0
Somalia,2021,Arab Cup qualification,1,2,0,1,0,1,-1,0
Somalia,2021,Friendly,0,1,0,1,0,1,-1,0
Somalia,2022,African Cup of Nations qualification,1,5,0,2,0,2,-4,0
Somalia,2023,FIFA World Cup qualification,1,4,0,2,0,2,-3,0
Somalia,2023,Friendly,0,5,0,2,0,2,-5,0
Somalia,2024,African Cup of Nations qualification,2,5,0,1,1,2,-3,0
Somalia,2024,FIFA World Cup qualification,2,5,0,2,0,2,-3,0
Somalia,2025,FIFA World Cup qualification,0,2,0,1,1,2,-2,0
Somaliland,2014,Friendly,2,2,0,0,1,1,0,0
Somaliland,2016,CONIFA World Football Cup,10,12,2,2,0,4,-2,0
Somaliland,2019,Friendly,2,6,0,1,0,1,-4,0
South Africa,1924,Friendly,3,3,1,1,0,2,0,0
South Africa,1947,Friendly,36,21,7,1,1,9,15,0
South Africa,1950,Friendly,6,7,2,2,0,4,-1,0
South Africa,1953,Friendly,1,3,0,1,0,1,-2,0
South Africa,1954,Friendly,2,1,1,0,0,1,1,0
South Africa,1955,Friendly,23,1,5,0,0,5,22,0
South Africa,1958,Friendly,3,9,0,1,0,1,-6,0
South Africa,1977,Friendly,8,1,1,0,1,2,7,0
South Africa,1992,African Cup of Nations qualification,1,5,0,2,0,2,-4,0
South Africa,1992,FIFA World Cup qualification,1,4,1,1,0,2,-3,0
South Africa,1992,Friendly,4,4,1,1,1,3,0,0
South Africa,1993,African Cup of Nations qualification,4,5,1,1,2,4,-1,0
South Africa,1993,FIFA World Cup qualification,1,0,1,0,1,2,1,0
South Africa,1993,Friendly,2,4,1,1,0,2,-2,0
South Africa,1994,Friendly,1,2,1,2,0,3,-1,0
South Africa,1994,Simba Tournament,1,1,0,0,2,2,0,0
South Africa,1995,Friendly,4,3,1,0,2,3,1,0
South Africa,1995,Simba Tournament,6,2,2,0,1,3,4,0
South Africa,1996,African Cup of Nations,11,2,5,1,0,6,9,0
South Africa,1996,FIFA World Cup qualification,5,0,3,0,0,3,5,0
South Africa,1996,Friendly,2,3,0,1,0,1,-1,0
South Africa,1996,Simba Tournament,3,0,2,0,1,3,3,0
South Africa,1997,Confederations Cup,5,7,0,2,1,3,-2,0
South Africa,1997,FIFA World Cup qualification,6,3,3,1,1,5,3,0
South Africa,1997,Friendly,3,11,0,5,0,5,-8,0
South Africa,1998,African Cup of Nations,9,6,3,1,2,6,3,0
South Africa,1998,African Cup of Nations qualification,1,0,1,0,0,1,1,0
South Africa,1998,COSAFA Cup qualification,2,3,0,1,0,1,-1,0
South Africa,1998,FIFA World Cup,3,6,0,1,2,3,-3,0
South Africa,1998,Friendly,4,5,1,1,2,4,-1,0
South Africa,1999,African Cup of Nations qualification,9,5,2,1,2,5,4,0
South Africa,1999,COSAFA Cup,1,1,0,0,1,1,0,0
South Africa,1999,COSAFA Cup qualification,2,1,1,0,0,1,1,0
South Africa,1999,Friendly,4,5,2,2,3,7,-1,0
South Africa,2000,African Cup of Nations,8,6,3,1,2,6,2,0
South Africa,2000,African Cup of Nations qualification,4,2,2,0,0,2,2,1
South Africa,2000,COSAFA Cup,5,1,2,1,0,3,4,0
South Africa,2000,FIFA World Cup qualification,5,0,3,0,0,3,5,0
South Africa,2000,Friendly,1,0,1,0,1,2,1,0
South Africa,2000,USA Cup,3,10,0,3,0,3,-7,0
South Africa,2001,African Cup of Nations qualification,5,2,1,0,3,4,3,0
South Africa,2001,COSAFA Cup,3,1,1,1,0,2,2,0
South Africa,2001,FIFA World Cup qualification,8,3,4,0,1,5,5,0
South Africa,2001,Friendly,1,4,1,2,0,3,-3,0
South Africa,2002,African Cup of Nations,3,3,1,1,2,4,0,0
South Africa,2002,African Cup of Nations qualification,2,0,1,0,1,2,2,0
South Africa,2002,COSAFA Cup,8,2,3,0,2,5,6,1
South Africa,2002,FIFA World Cup,5,5,1,1,1,3,0,0
South Africa,2002,Friendly,10,8,4,2,4,10,2,0
South Africa,2003,African Cup of Nations qualification,4,1,2,0,0,2,3,0
South Africa,2003,COSAFA Cup,0,1,0,1,0,1,-1,0
South Africa,2003,Friendly,11,8,4,3,1,8,3,0
South Africa,2004,African Cup of Nations,3,5,1,1,1,3,-2,0
South Africa,2004,COSAFA Cup,0,2,0,1,0,1,-2,0
South Africa,2004,FIFA World Cup qualification,5,5,3,2,0,5,0,0
South Africa,2004,Friendly,5,4,2,2,0,4,1,0
South Africa,2005,COSAFA Cup,6,2,2,0,1,3,4,0
South Africa,2005,FIFA World Cup qualification,7,9,2,2,1,5,-2,0
South Africa,2005,Friendly,6,12,0,3,1,4,-6,0
South Africa,2005,Gold Cup,7,6,1,0,3,4,1,0
South Africa,2006,African Cup of Nations,0,5,0,3,0,3,-5,0
South Africa,2006,African Cup of Nations qualification,1,0,1,0,1,2,1,0
South Africa,2006,COSAFA Cup,1,0,1,0,1,2,1,0
South Africa,2006,Friendly,3,2,2,1,1,4,1,0
South Africa,2007,African Cup of Nations qualification,9,4,2,1,1,4,5,0
South Africa,2007,COSAFA Cup,3,0,2,0,2,4,3,0
South Africa,2007,Friendly,2,5,1,4,1,6,-3,0
South Africa,2008,African Cup of Nations,3,5,0,1,2,3,-2,0
South Africa,2008,COSAFA Cup,4,1,3,0,0,3,3,1
South Africa,2008,FIFA World Cup qualification,5,5,2,3,1,6,0,0
South Africa,2008,Friendly,19,8,7,1,1,9,11,0
South Africa,2009,COSAFA Cup,3,2,1,1,1,3,1,0
South Africa,2009,Confederations Cup,4,6,1,3,1,5,-2,0
South Africa,2009,Friendly,6,13,4,7,2,13,-7,0
South Africa,2010,African Cup of Nations qualification,2,0,1,0,1,2,2,0
South Africa,2010,FIFA World Cup,3,5,1,1,1,3,-2,0
South Africa,2010,Friendly,21,5,7,1,4,12,16,0
South Africa,2011,African Cup of Nations qualification,2,2,1,1,2,4,0,0
South Africa,2011,Friendly,8,3,3,1,1,5,5,0
South Africa,2012,FIFA World Cup qualification,2,2,0,0,2,2,0,0
South Africa,2012,Friendly,10,5,4,3,2,9,5,0
South Africa,2013,African Cup of Nations,5,3,1,0,3,4,2,0
South Africa,2013,COSAFA Cup,4,2,2,0,1,3,2,0
South Africa,2013,FIFA World Cup qualification,10,3,3,1,0,4,7,0
South Africa,2013,Friendly,10,6,4,3,2,9,4,0
South Africa,2014,African Cup of Nations qualification,9,3,3,0,3,6,6,0
South Africa,2014,Friendly,3,6,1,1,2,4,-3,0
South Africa,2015,African Cup of Nations,3,6,0,2,1,3,-3,0
South Africa,2015,African Cup of Nations qualification,1,3,0,1,1,2,-2,0
South Africa,2015,COSAFA Cup,0,0,0,0,2,2,0,0
South Africa,2015,FIFA World Cup qualification,4,1,2,0,0,2,3,0
South Africa,2015,Friendly,13,5,5,0,4,9,8,0
South Africa,2016,African Cup of Nations qualification,7,3,1,0,3,4,4,0
South Africa,2016,COSAFA Cup,9,4,2,0,1,3,5,0
South Africa,2016,FIFA World Cup qualification,1,1,0,0,1,1,0,0
South Africa,2016,Friendly,3,2,1,0,2,3,1,0
South Africa,2017,African Cup of Nations qualification,2,0,1,0,0,1,2,0
South Africa,2017,COSAFA Cup,3,1,2,1,0,3,2,0
South Africa,2017,FIFA World Cup qualification,6,9,1,4,0,5,-3,0
South Africa,2017,Friendly,4,3,1,1,1,3,1,0
South Africa,2018,African Cup of Nations qualification,7,1,1,0,3,4,6,0
South Africa,2018,COSAFA Cup,7,1,2,0,1,3,6,0
South Africa,2018,Friendly,4,2,1,0,2,3,2,0
South Africa,2019,African Cup of Nations,3,4,2,3,0,5,-1,0
South Africa,2019,African Cup of Nations qualification,3,3,2,1,0,3,0,0
South Africa,2019,COSAFA Cup,3,3,0,0,3,3,0,0
South Africa,2019,Friendly,2,1,1,0,1,2,1,0
South Africa,2020,African Cup of Nations qualification,6,2,2,0,0,2,4,0
South Africa,2020,Friendly,2,3,0,1,1,2,-1,0
South Africa,2021,African Cup of Nations qualification,1,3,0,1,1,2,-2,0
South Africa,2021,COSAFA Cup,9,0,4,0,2,6,9,0
South Africa,2021,FIFA World Cup qualification,6,2,4,1,1,6,4,0
South Africa,2021,Friendly,3,2,1,0,0,1,1,0
South Africa,2022,African Cup of Nations qualification,1,2,0,1,0,1,-1,0
South Africa,2022,COSAFA Cup,4,2,2,0,1,3,2,0
South Africa,2022,Friendly,8,7,3,1,2,6,1,0
South Africa,2023,African Cup of Nations qualification,6,4,2,0,1,3,2,0
South Africa,2023,COSAFA Cup,6,5,2,1,2,5,1,0
South Africa,2023,FIFA World Cup qualification,2,3,1,1,0,2,-1,0
South Africa,2023,Friendly,2,1,1,0,3,4,1,0
South Africa,2024,African Cup of Nations,7,3,2,1,4,7,4,0
South Africa,2024,African Cup of Nations qualification,11,5,2,0,2,4,6,0
South Africa,2024,FIFA Series,4,4,0,0,2,2,0,0
South Africa,2024,FIFA World Cup qualification,4,2,1,0,1,2,2,0
South Africa,2024,Friendly,0,0,0,0,1,1,0,0
South Africa,2025,FIFA World Cup qualification,4,0,2,0,0,2,4,0
South Korea,1949,Friendly,10,7,1,1,1,3,3,0
South Korea,1950,Friendly,3,1,1,0,0,1,2,0
South Korea,1953,Friendly,15,17,4,3,1,8,-2,0
South Korea,1954,Asian Games,15,12,1,1,2,4,3,0
South Korea,1954,FIFA World Cup,0,16,0,2,0,2,-16,0
South Korea,1954,FIFA World Cup qualification,7,3,1,0,1,2,4,0
South Korea,1956,AFC Asian Cup,9,6,2,0,1,3,3,1
South Korea,1956,AFC Asian Cup qualification,7,0,3,0,0,3,7,1
South Korea,1956,Friendly,5,2,2,0,0,2,3,0
South Korea,1958,Asian Games,15,6,4,1,0,5,9,0
South Korea,1958,Friendly,3,4,0,1,1,2,-1,0
South Korea,1959,Friendly,12,5,3,0,1,4,7,0
South Korea,1959,Merdeka Tournament,9,5,2,1,1,4,4,1
South Korea,1960,AFC Asian Cup,9,1,3,0,0,3,8,0
South Korea,1960,FIFA World Cup qualification,2,1,1,0,0,1,1,0
South Korea,1960,Merdeka Tournament,5,3,1,0,3,4,2,0
South Korea,1961,FIFA World Cup qualification,4,8,1,2,0,3,-4,0
South Korea,1961,Friendly,1,5,0,2,1,3,-4,0
South Korea,1962,Asian Games,9,5,4,1,0,5,4,0
South Korea,1962,Friendly,4,0,2,0,0,2,4,0
South Korea,1963,Merdeka Tournament,9,7,2,2,1,5,2,0
South Korea,1964,AFC Asian Cup,2,4,1,2,0,3,-2,0
South Korea,1964,Friendly,2,1,1,0,0,1,1,0
South Korea,1965,Merdeka Tournament,7,4,3,1,2,6,3,0
South Korea,1966,Asian Games,0,4,0,2,0,2,-4,0
South Korea,1966,Friendly,3,1,1,0,0,1,2,0
South Korea,1966,Merdeka Tournament,7,5,4,2,0,6,2,0
South Korea,1967,AFC Asian Cup qualification,9,3,1,1,1,3,6,0
South Korea,1967,Merdeka Tournament,12,3,5,0,1,6,9,0
South Korea,1967,Vietnam Independence Cup,11,5,4,1,0,5,6,0
South Korea,1968,Friendly,3,4,0,1,0,1,-1,0
South Korea,1968,Merdeka Tournament,10,11,4,2,0,6,-1,0
South Korea,1969,FIFA World Cup qualification,6,5,1,1,2,4,1,0
South Korea,1969,King's Cup,8,0,4,0,1,5,8,0
South Korea,1969,Merdeka Tournament,9,10,3,2,0,5,-1,0
South Korea,1970,Asian Games,5,3,3,1,2,6,2,0
South Korea,1970,Indonesia Tournament,10,5,1,2,1,4,5,0
South Korea,1970,King's Cup,14,0,5,0,1,6,14,0
South Korea,1970,Merdeka Tournament,11,4,4,0,3,7,7,0
South Korea,1971,Friendly,2,2,1,1,0,2,0,0
South Korea,1971,Indonesia Tournament,4,6,1,3,0,4,-2,0
South Korea,1971,King's Cup,4,3,1,0,3,4,1,1
South Korea,1971,Korea Cup,11,1,4,0,2,6,10,0
South Korea,1972,AFC Asian Cup,7,6,1,2,2,5,1,0
South Korea,1972,Friendly,3,5,0,1,2,3,-2,0
South Korea,1972,King's Cup,7,3,2,1,2,5,4,0
South Korea,1972,Korea Cup,9,2,4,1,0,5,7,0
South Korea,1972,Merdeka Tournament,13,2,5,0,1,6,11,0
South Korea,1973,FIFA World Cup qualification,10,4,3,1,4,8,6,0
South Korea,1973,Friendly,2,0,1,0,0,1,2,0
South Korea,1973,King's Cup,9,1,3,0,1,4,8,0
South Korea,1973,Korea Cup,11,2,3,1,0,4,9,1
South Korea,1973,Merdeka Tournament,4,4,2,2,3,7,0,0
South Korea,1974,Asian Games,4,10,1,3,1,5,-6,0
South Korea,1974,Friendly,4,5,1,1,0,2,-1,0
South Korea,1974,Indonesia Tournament,0,0,0,0,1,1,0,0
South Korea,1974,King's Cup,7,4,2,0,2,4,3,1
South Korea,1974,Korea Cup,3,1,1,1,0,2,2,0
South Korea,1975,AFC Asian Cup qualification,3,3,2,2,0,4,0,0
South Korea,1975,Friendly,3,0,1,0,0,1,3,0
South Korea,1975,Indonesia Tournament,5,4,1,1,1,3,1,0
South Korea,1975,King's Cup,9,3,2,1,0,3,6,1
South Korea,1975,Korea Cup,2,0,2,0,0,2,2,1
South Korea,1975,Merdeka Tournament,26,5,8,0,0,8,21,1
South Korea,1976,Friendly,2,1,1,0,0,1,1,0
South Korea,1976,King's Cup,11,3,3,1,1,5,8,0
South Korea,1976,Korea Cup,17,4,3,0,1,4,13,1
South Korea,1976,Merdeka Tournament,15,5,3,1,2,6,10,0
South Korea,1977,FIFA World Cup qualification,16,9,5,1,6,12,7,0
South Korea,1977,Friendly,11,3,3,0,1,4,8,0
South Korea,1977,Korea Cup,11,1,3,0,0,3,10,0
South Korea,1977,Merdeka Tournament,15,3,4,0,2,6,12,1
South Korea,1978,AFC Asian Cup qualification,10,1,3,0,0,3,9,1
South Korea,1978,Asian Games,15,3,6,0,1,7,12,0
South Korea,1978,Indonesia Tournament,3,1,1,0,0,1,2,0
South Korea,1978,Korea Cup,5,3,1,0,1,2,2,1
South Korea,1978,Merdeka Tournament,20,1,8,0,0,8,19,1
South Korea,1979,Friendly,5,3,1,1,0,2,2,0
South Korea,1979,Korea Cup,28,1,4,0,0,4,27,0
South Korea,1980,AFC Asian Cup,12,6,4,1,1,6,6,0
South Korea,1980,Friendly,11,4,4,1,1,6,7,0
South Korea,1980,Korea Cup,16,0,5,0,0,5,16,1
South Korea,1980,Merdeka Tournament,8,5,2,1,4,7,3,0
South Korea,1981,FIFA World Cup qualification,7,4,2,1,0,3,3,0
South Korea,1981,Friendly,1,6,1,2,0,3,-5,0
South Korea,1981,Indonesia Tournament,1,0,1,0,0,1,1,1
South Korea,1981,Korea Cup,4,0,2,0,0,2,4,0
South Korea,1981,Merdeka Tournament,4,2,1,0,2,3,2,0
South Korea,1982,Asian Games,4,3,1,2,0,3,1,0
South Korea,1982,Friendly,4,4,1,1,1,3,0,0
South Korea,1982,King's Cup,8,0,2,0,1,3,8,0
South Korea,1982,Korea Cup,4,0,2,0,0,2,4,0
South Korea,1982,Merdeka Tournament,9,5,3,1,0,4,4,0
South Korea,1982,Nehru Cup,5,5,0,0,3,3,0,0
South Korea,1983,Friendly,4,5,0,1,3,4,-1,0
South Korea,1983,Korea Cup,9,0,4,0,0,4,9,1
South Korea,1984,AFC Asian Cup,1,3,0,2,2,4,-2,0
South Korea,1984,AFC Asian Cup qualification,13,0,3,0,1,4,13,0
South Korea,1984,Friendly,6,2,1,1,0,2,4,0
South Korea,1984,Korea Cup,2,0,1,0,0,1,2,1
South Korea,1985,FIFA World Cup qualification,17,3,7,1,0,8,14,0
South Korea,1985,Friendly,4,5,1,3,0,4,-1,0
South Korea,1985,Korea Cup,8,2,3,0,0,3,6,1
South Korea,1986,Asian Games,14,3,4,0,2,6,11,1
South Korea,1986,FIFA World Cup,4,7,0,2,1,3,-3,0
South Korea,1986,Friendly,14,4,4,1,1,6,10,0
South Korea,1986,Lunar New Year Cup,1,3,0,1,0,1,-2,0
South Korea,1987,Indonesia Tournament,1,3,0,1,1,2,-2,0
South Korea,1987,Korea Cup,6,3,2,0,2,4,3,0
South Korea,1987,Merdeka Tournament,1,0,1,0,0,1,1,1
South Korea,1988,AFC Asian Cup,11,3,5,0,1,6,8,0
South Korea,1988,AFC Asian Cup qualification,5,3,1,1,1,3,2,0
South Korea,1988,Friendly,2,1,1,0,1,2,1,0
South Korea,1988,King's Cup,0,0,0,0,1,1,0,0
South Korea,1988,Korea Cup,4,0,1,0,0,1,4,1
South Korea,1989,FIFA World Cup qualification,30,1,9,0,2,11,29,0
South Korea,1989,Friendly,1,1,1,1,0,2,0,0
South Korea,1989,Korea Cup,0,0,0,0,1,1,0,0
South Korea,1989,Marlboro Cup,4,5,1,1,0,2,-1,1
South Korea,1990,Asian Games,18,1,5,1,0,6,17,0
South Korea,1990,Dynasty Cup,5,1,3,0,1,4,4,0
South Korea,1990,FIFA World Cup,1,6,0,3,0,3,-5,0
South Korea,1990,Friendly,4,2,3,1,2,6,2,0
South Korea,1990,Malta International Tournament,4,4,1,1,0,2,0,1
South Korea,1991,Friendly,1,0,1,0,0,1,1,0
South Korea,1991,Korea Cup,6,1,2,0,3,5,5,1
South Korea,1992,AFC Asian Cup qualification,7,2,1,1,0,2,5,0
South Korea,1992,Dynasty Cup,5,3,1,0,3,4,2,0
South Korea,1992,Friendly,0,0,0,0,1,1,0,0
South Korea,1993,FIFA World Cup qualification,32,5,9,1,3,13,27,0
South Korea,1993,Friendly,7,6,2,1,3,6,1,0
South Korea,1993,Korea Cup,1,3,0,2,0,2,-2,0
South Korea,1994,Asian Games,17,7,3,3,0,6,10,0
South Korea,1994,FIFA World Cup,4,5,0,1,2,3,-1,0
South Korea,1994,Friendly,15,11,4,3,4,11,4,0
South Korea,1995,Dynasty Cup,6,5,1,0,3,4,1,0
South Korea,1995,Friendly,1,2,0,1,1,2,-1,0
South Korea,1995,Korea Cup,3,3,1,1,0,2,0,0
South Korea,1995,Lunar New Year Cup,1,1,1,1,0,2,0,0
South Korea,1996,AFC Asian Cup,7,11,1,2,1,4,-4,0
South Korea,1996,AFC Asian Cup qualification,17,0,3,0,0,3,17,0
South Korea,1996,Friendly,15,13,4,2,0,6,2,0
South Korea,1996,United Arab Emirates Friendship Tournament,5,6,0,1,2,3,-1,0
South Korea,1997,FIFA World Cup qualification,28,8,9,1,2,12,20,0
South Korea,1997,Friendly,13,7,4,2,2,8,6,0
South Korea,1997,Korea Cup,7,2,2,0,1,3,5,0
South Korea,1998,Asian Games,12,6,4,2,0,6,6,0
South Korea,1998,Dynasty Cup,4,3,2,1,0,3,1,1
South Korea,1998,FIFA World Cup,2,9,0,2,1,3,-7,0
South Korea,1998,Friendly,11,11,3,2,6,11,0,0
South Korea,1998,King's Cup,5,1,2,0,1,3,4,0
South Korea,1999,Friendly,2,2,1,1,0,2,0,0
South Korea,1999,Korea Cup,2,2,0,0,3,3,0,0
South Korea,2000,AFC Asian Cup,9,6,3,2,1,6,3,0
South Korea,2000,AFC Asian Cup qualification,19,0,3,0,0,3,19,0
South Korea,2000,Friendly,7,2,5,0,4,9,5,0
South Korea,2000,Gold Cup,2,2,0,0,2,2,0,0
South Korea,2000,United Arab Emirates Friendship Tournament,5,3,1,0,1,2,2,1
South Korea,2001,Confederations Cup,3,6,2,1,0,3,-3,0
South Korea,2001,Friendly,11,11,5,2,3,10,0,0
South Korea,2001,Lunar New Year Cup,3,4,0,1,1,2,-1,0
South Korea,2001,United Arab Emirates Friendship Tournament,5,2,1,0,1,2,3,0
South Korea,2002,FIFA World Cup,8,6,3,2,2,7,2,0
South Korea,2002,Friendly,14,10,3,3,5,11,4,0
South Korea,2002,Gold Cup,3,7,0,3,2,5,-4,0
South Korea,2003,AFC Asian Cup qualification,30,4,4,2,0,6,26,0
South Korea,2003,EAFF Championship,4,1,2,0,1,3,3,0
South Korea,2003,Friendly,1,5,1,4,1,6,-4,0
South Korea,2004,AFC Asian Cup,9,4,2,1,1,4,5,0
South Korea,2004,FIFA World Cup qualification,9,2,4,0,2,6,7,1
South Korea,2004,Friendly,13,4,4,1,2,7,9,0
South Korea,2005,EAFF Championship,1,2,0,1,2,3,-1,0
South Korea,2005,FIFA World Cup qualification,9,5,3,2,1,6,4,0
South Korea,2005,Friendly,13,7,4,2,3,9,6,0
South Korea,2006,AFC Asian Cup qualification,12,5,2,1,2,5,7,0
South Korea,2006,FIFA World Cup,3,4,1,1,1,3,-1,0
South Korea,2006,Friendly,9,10,4,4,3,11,-1,0
South Korea,2006,Lunar New Year Cup,2,0,1,0,0,1,2,0
South Korea,2007,AFC Asian Cup,3,3,1,1,4,6,0,0
South Korea,2007,Friendly,6,5,3,2,0,5,1,0
South Korea,2008,EAFF Championship,5,4,1,0,2,3,1,0
South Korea,2008,FIFA World Cup qualification,17,5,5,0,4,9,12,0
South Korea,2008,Friendly,4,1,2,1,0,3,3,0
South Korea,2009,FIFA World Cup qualification,5,2,2,0,3,5,3,0
South Korea,2009,Friendly,11,6,4,1,3,8,5,0
South Korea,2010,EAFF Championship,8,4,2,1,0,3,4,1
South Korea,2010,FIFA World Cup,6,8,1,2,1,4,-2,0
South Korea,2010,Friendly,14,8,7,4,1,12,6,0
South Korea,2011,AFC Asian Cup,13,7,4,0,2,6,6,0
South Korea,2011,FIFA World Cup qualification,12,4,3,1,1,5,8,0
South Korea,2011,Friendly,10,7,3,1,2,6,3,0
South Korea,2012,FIFA World Cup qualification,11,4,3,1,1,5,7,0
South Korea,2012,Friendly,8,9,2,2,0,4,-1,0
South Korea,2013,EAFF Championship,1,2,0,1,2,3,-1,0
South Korea,2013,FIFA World Cup qualification,4,3,2,1,1,4,1,0
South Korea,2013,Friendly,11,13,3,4,1,8,-2,0
South Korea,2014,FIFA World Cup,3,6,0,2,1,3,-3,0
South Korea,2014,Friendly,10,17,5,7,0,12,-7,0
South Korea,2015,AFC Asian Cup,8,2,5,1,0,6,6,0
South Korea,2015,EAFF Championship,3,1,1,0,2,3,2,0
South Korea,2015,FIFA World Cup qualification,23,0,6,0,0,6,23,0
South Korea,2015,Friendly,10,1,4,0,1,5,9,0
South Korea,2016,FIFA World Cup qualification,9,6,4,1,1,6,3,0
South Korea,2016,Friendly,6,7,3,1,0,4,-1,0
South Korea,2017,EAFF Championship,7,3,2,0,1,3,4,1
South Korea,2017,FIFA World Cup qualification,3,4,1,2,2,5,-1,0
South Korea,2017,Friendly,6,9,1,2,2,5,-3,0
South Korea,2018,FIFA World Cup,3,3,1,2,0,3,0,0
South Korea,2018,Friendly,21,16,6,4,6,16,5,0
South Korea,2019,AFC Asian Cup,6,2,4,1,0,5,4,0
South Korea,2019,EAFF Championship,4,0,3,0,0,3,4,1
South Korea,2019,FIFA World Cup qualification,10,0,2,0,2,4,10,0
South Korea,2019,Friendly,7,7,3,1,2,6,0,0
South Korea,2020,Friendly,4,4,1,1,0,2,0,0
South Korea,2021,FIFA World Cup qualification,20,3,7,0,2,9,17,0
South Korea,2021,Friendly,0,3,0,1,0,1,-3,0
South Korea,2022,EAFF Championship,6,3,2,1,0,3,3,0
South Korea,2022,FIFA World Cup,5,8,1,2,1,4,-3,0
South Korea,2022,FIFA World Cup qualification,5,1,3,1,0,4,4,0
South Korea,2022,Friendly,22,11,6,1,2,9,11,0
South Korea,2023,FIFA World Cup qualification,8,0,2,0,0,2,8,0
South Korea,2023,Friendly,15,6,3,2,3,8,9,0
South Korea,2024,AFC Asian Cup,11,10,2,1,3,6,1,0
South Korea,2024,FIFA World Cup qualification,24,6,7,0,3,10,18,0
South Korea,2024,Friendly,1,0,1,0,0,1,1,0
South Korea,2025,FIFA World Cup qualification,2,2,0,0,2,2,0,0
South Ossetia,2014,CONIFA World Football Cup,21,10,1,3,1,5,11,0
South Ossetia,2017,CONIFA European Football Cup,2,16,0,4,0,4,-14,0
South Ossetia,2019,CONIFA European Football Cup,7,4,3,0,2,5,3,1
South Ossetia,2019,Friendly,5,4,1,1,0,2,1,0
South Sudan,2012,CECAFA Cup,0,7,0,3,0,3,-7,0
South Sudan,2012,Friendly,2,2,0,0,1,1,0,0
South Sudan,2013,CECAFA Cup,2,7,0,3,0,3,-5,0
South Sudan,2014,African Cup of Nations qualification,0,5,0,1,1,2,-5,0
South Sudan,2014,Friendly,0,3,0,1,0,1,-3,0
South Sudan,2015,African Cup of Nations qualification,1,2,1,1,0,2,-1,0
South Sudan,2015,CECAFA Cup,4,0,2,0,2,4,4,0
South Sudan,2015,FIFA World Cup qualification,1,5,0,1,1,2,-4,0
South Sudan,2015,Friendly,0,2,0,1,0,1,-2,0
South Sudan,2016,African Cup of Nations qualification,2,13,0,4,0,4,-11,0
South Sudan,2017,African Cup of Nations qualification,6,5,1,2,0,3,1,0
South Sudan,2017,CECAFA Cup,1,8,0,2,1,3,-7,0
South Sudan,2018,African Cup of Nations qualification,2,12,0,4,0,4,-10,0
South Sudan,2019,African Cup of Nations qualification,4,7,2,3,0,5,-3,0
South Sudan,2019,FIFA World Cup qualification,1,2,0,1,1,2,-1,0
South Sudan,2020,African Cup of Nations qualification,1,1,1,1,0,2,0,0
South Sudan,2020,Friendly,0,0,0,0,1,1,0,0
South Sudan,2021,African Cup of Nations qualification,0,2,0,2,0,2,-2,0
South Sudan,2021,Friendly,2,4,0,2,1,3,-2,0
South Sudan,2022,African Cup of Nations qualification,6,6,2,2,0,4,0,0
South Sudan,2022,Friendly,0,3,0,1,0,1,-3,0
South Sudan,2023,African Cup of Nations qualification,4,9,1,3,0,4,-5,0
South Sudan,2023,FIFA World Cup qualification,0,4,0,1,1,2,-4,0
South Sudan,2023,Friendly,1,3,1,1,0,2,-2,0
South Sudan,2024,African Cup of Nations qualification,4,8,0,4,2,6,-4,0
South Sudan,2024,FIFA World Cup qualification,1,4,0,1,1,2,-3,0
South Sudan,2025,FIFA World Cup qualification,1,2,0,1,1,2,-1,0
South Yemen,1982,Asian Games,1,8,0,3,0,3,-7,0
Spain,1920,Olympic Games,9,5,4,1,0,5,4,1
Spain,1921,Friendly,3,1,1,0,0,1,2,1
Spain,1922,Friendly,6,1,2,0,0,2,5,1
Spain,1923,Friendly,6,1,2,1,0,3,5,1
Spain,1924,Friendly,9,1,2,0,1,3,8,1
Spain,1924,Olympic Games,0,1,0,1,0,1,-1,0
Spain,1925,Friendly,6,0,4,0,0,4,6,0
Spain,1926,Friendly,4,2,1,0,0,1,2,0
Spain,1927,Friendly,5,3,2,1,0,3,2,0
Spain,1928,Friendly,3,3,0,0,2,2,0,0
Spain,1928,Olympic Games,9,9,1,1,1,3,0,0
Spain,1929,Friendly,17,4,3,0,0,3,13,0
Spain,1930,Friendly,5,4,3,1,0,4,1,0
Spain,1931,Friendly,7,8,1,1,2,4,-1,1
Spain,1932,Friendly,2,1,1,0,0,1,1,0
Spain,1933,Friendly,17,2,2,1,1,4,15,0
Spain,1934,FIFA World Cup,4,3,1,1,1,3,1,0
Spain,1934,FIFA World Cup qualification,11,1,2,0,0,2,10,0
Spain,1934,Friendly,2,0,1,0,0,1,2,0
Spain,1935,Friendly,7,4,2,0,1,3,3,0
Spain,1936,Friendly,7,7,1,2,0,3,0,0
Spain,1937,Friendly,1,2,0,1,0,1,-1,0
Spain,1938,Friendly,0,1,0,1,0,1,-1,0
Spain,1941,Friendly,10,5,2,0,1,3,5,1
Spain,1942,Friendly,5,5,1,1,1,3,0,0
Spain,1945,Friendly,6,4,1,0,1,2,2,0
Spain,1946,Friendly,0,1,0,1,0,1,-1,0
Spain,1947,Friendly,4,10,0,3,0,3,-6,0
Spain,1948,Friendly,7,4,2,0,1,3,3,0
Spain,1949,Friendly,12,7,2,1,2,5,5,0
Spain,1950,FIFA World Cup,10,12,3,2,1,6,-2,0
Spain,1950,FIFA World Cup qualification,7,3,1,0,1,2,4,0
Spain,1951,Friendly,9,6,1,0,2,3,3,0
Spain,1952,Friendly,8,3,1,1,2,4,5,0
Spain,1953,Friendly,13,5,3,1,1,5,8,0
Spain,1954,FIFA World Cup qualification,6,4,1,1,1,3,2,0
Spain,1955,Friendly,8,9,1,2,2,5,-1,0
Spain,1956,Friendly,1,3,0,1,0,1,-2,0
Spain,1957,FIFA World Cup qualification,12,8,2,1,1,4,4,0
Spain,1957,Friendly,10,1,2,0,0,2,9,0
Spain,1958,Friendly,9,6,2,1,1,4,3,0
Spain,1959,Friendly,10,8,1,1,1,3,2,0
Spain,1959,UEFA Euro qualification,7,2,2,0,0,2,5,0
Spain,1960,Friendly,19,12,5,3,0,8,7,0
Spain,1961,FIFA World Cup qualification,7,4,3,0,1,4,3,0
Spain,1961,Friendly,5,1,2,0,1,3,4,0
Spain,1962,FIFA World Cup,2,3,1,2,0,3,-1,0
Spain,1962,Friendly,1,1,0,0,1,1,0,0
Spain,1962,UEFA Euro qualification,7,3,1,1,0,2,4,0
Spain,1963,Friendly,3,8,0,2,1,3,-5,0
Spain,1963,UEFA Euro qualification,2,1,1,0,1,2,1,0
Spain,1964,Friendly,1,2,0,1,0,1,-1,0
Spain,1964,UEFA Euro,4,2,2,0,0,2,2,1
Spain,1964,UEFA Euro qualification,7,1,2,0,0,2,6,0
Spain,1965,FIFA World Cup qualification,5,2,2,1,0,3,3,0
Spain,1965,Friendly,0,2,0,1,1,2,-2,0
Spain,1966,FIFA World Cup,4,5,1,2,0,3,-1,0
Spain,1966,Friendly,1,1,0,0,1,1,0,0
Spain,1966,UEFA Euro qualification,2,0,1,0,1,2,2,1
Spain,1967,Friendly,0,2,0,1,0,1,-2,0
Spain,1967,UEFA Euro qualification,4,2,2,1,1,4,2,0
Spain,1968,FIFA World Cup qualification,1,1,0,0,2,2,0,0
Spain,1968,Friendly,7,3,2,0,1,3,4,0
Spain,1968,UEFA Euro qualification,1,3,0,2,0,2,-2,0
Spain,1969,FIFA World Cup qualification,9,5,2,2,0,4,4,0
Spain,1969,Friendly,1,0,1,0,1,2,1,0
Spain,1970,Friendly,7,3,3,0,1,4,4,0
Spain,1970,UEFA Euro qualification,3,0,1,0,0,1,3,0
Spain,1971,Friendly,4,3,1,0,1,2,1,0
Spain,1971,UEFA Euro qualification,10,2,2,1,1,4,8,0
Spain,1972,FIFA World Cup qualification,2,2,0,0,1,1,0,0
Spain,1972,Friendly,4,0,3,0,1,4,4,0
Spain,1972,UEFA Euro qualification,1,1,0,0,1,1,0,0
Spain,1973,FIFA World Cup qualification,6,3,2,0,1,3,3,0
Spain,1973,Friendly,3,5,0,2,1,3,-2,0
Spain,1974,FIFA World Cup qualification,0,1,0,1,0,1,-1,0
Spain,1974,Friendly,2,1,1,0,1,2,1,0
Spain,1974,UEFA Euro qualification,4,2,2,0,0,2,2,0
Spain,1975,UEFA Euro qualification,6,4,1,0,3,4,2,0
Spain,1976,FIFA World Cup qualification,1,0,1,0,0,1,1,0
Spain,1976,UEFA Euro qualification,1,3,0,1,1,2,-2,0
Spain,1977,FIFA World Cup qualification,3,1,2,1,0,3,2,0
Spain,1977,Friendly,4,2,2,0,1,3,2,0
Spain,1978,FIFA World Cup,2,2,1,1,1,3,0,0
Spain,1978,Friendly,7,3,3,2,1,6,4,0
Spain,1978,UEFA Euro qualification,8,1,3,0,0,3,7,1
Spain,1979,Friendly,2,5,0,2,1,3,-3,0
Spain,1979,UEFA Euro qualification,5,4,1,1,1,3,1,0
Spain,1980,Friendly,8,11,1,3,4,8,-3,0
Spain,1980,UEFA Euro,2,4,0,2,1,3,-2,0
Spain,1981,Friendly,15,11,6,3,3,12,4,0
Spain,1982,FIFA World Cup,4,5,1,2,2,5,-1,0
Spain,1982,Friendly,6,1,2,0,1,3,5,0
Spain,1982,UEFA Euro qualification,4,3,1,0,1,2,1,0
Spain,1983,Friendly,1,1,0,0,1,1,0,0
Spain,1983,UEFA Euro qualification,20,5,5,1,0,6,15,0
Spain,1984,FIFA World Cup qualification,4,3,1,1,0,2,1,0
Spain,1984,Friendly,8,4,3,2,1,6,4,0
Spain,1984,UEFA Euro,4,5,1,1,3,5,-1,0
Spain,1985,FIFA World Cup qualification,5,5,3,1,0,4,0,0
Spain,1985,Friendly,5,1,2,0,3,5,4,0
Spain,1986,FIFA World Cup,11,4,3,1,1,5,7,0
Spain,1986,Friendly,13,3,4,0,1,5,10,0
Spain,1986,UEFA Euro qualification,3,1,2,0,0,2,2,0
Spain,1987,Friendly,5,5,1,1,1,3,0,0
Spain,1987,UEFA Euro qualification,11,5,3,1,0,4,6,0
Spain,1988,FIFA World Cup qualification,6,0,2,0,0,2,6,1
Spain,1988,Friendly,6,11,0,4,4,8,-5,0
Spain,1988,UEFA Euro,3,5,1,2,0,3,-2,0
Spain,1989,FIFA World Cup qualification,14,3,4,1,1,6,11,0
Spain,1989,Friendly,3,1,2,0,0,2,2,0
Spain,1990,FIFA World Cup,6,4,2,1,1,4,2,0
Spain,1990,Friendly,7,3,3,1,0,4,4,0
Spain,1990,UEFA Euro qualification,13,4,2,1,0,3,9,0
Spain,1991,Friendly,5,8,1,2,1,4,-3,0
Spain,1991,UEFA Euro qualification,4,8,1,3,0,4,-4,0
Spain,1992,FIFA World Cup qualification,8,0,2,0,3,5,8,0
Spain,1992,Friendly,4,1,2,0,2,4,3,0
Spain,1993,FIFA World Cup qualification,19,4,6,1,0,7,15,0
Spain,1993,Friendly,3,1,1,0,1,2,2,0
Spain,1994,FIFA World Cup,10,6,2,1,2,5,4,0
Spain,1994,Friendly,9,6,3,1,2,6,3,0
Spain,1994,UEFA Euro qualification,11,2,4,0,0,4,9,0
Spain,1995,Friendly,4,3,1,0,2,3,1,0
Spain,1995,UEFA Euro qualification,14,2,4,0,2,6,12,0
Spain,1996,FIFA World Cup qualification,15,3,4,0,1,5,12,0
Spain,1996,Friendly,1,0,1,0,1,2,1,0
Spain,1996,UEFA Euro,4,3,1,0,3,4,1,0
Spain,1997,FIFA World Cup qualification,11,3,4,0,1,5,8,0
Spain,1997,Friendly,1,1,0,0,1,1,0,0
Spain,1998,FIFA World Cup,8,4,1,1,1,3,4,0
Spain,1998,Friendly,11,4,3,1,1,5,7,0
Spain,1998,UEFA Euro qualification,4,4,1,1,0,2,0,0
Spain,1999,Friendly,5,4,2,1,1,4,1,0
Spain,1999,UEFA Euro qualification,38,1,6,0,0,6,37,0
Spain,2000,FIFA World Cup qualification,5,2,2,0,1,3,3,0
Spain,2000,Friendly,9,7,3,2,2,7,2,0
Spain,2000,UEFA Euro,7,7,2,2,0,4,0,0
Spain,2001,FIFA World Cup qualification,16,2,4,0,1,5,14,0
Spain,2001,Friendly,4,4,3,1,0,4,0,0
Spain,2002,FIFA World Cup,10,5,3,0,2,5,5,0
Spain,2002,Friendly,8,3,2,1,3,6,5,0
Spain,2002,UEFA Euro qualification,5,0,2,0,0,2,5,0
Spain,2003,Friendly,10,1,3,0,0,3,9,0
Spain,2003,UEFA Euro qualification,16,5,5,1,2,8,11,0
Spain,2004,FIFA World Cup qualification,3,1,1,0,2,3,2,0
Spain,2004,Friendly,14,5,5,0,2,7,9,0
Spain,2004,UEFA Euro,2,2,1,1,1,3,0,0
Spain,2005,FIFA World Cup qualification,22,4,5,0,4,9,18,0
Spain,2005,Friendly,7,1,3,0,0,3,6,0
Spain,2006,FIFA World Cup,9,4,3,1,0,4,5,0
Spain,2006,Friendly,9,5,4,1,2,7,4,0
Spain,2006,UEFA Euro qualification,6,5,1,2,0,3,1,0
Spain,2007,Friendly,4,2,2,0,1,3,2,0
Spain,2007,UEFA Euro qualification,17,3,8,0,1,9,14,0
Spain,2008,FIFA World Cup qualification,10,1,4,0,0,4,9,0
Spain,2008,Friendly,11,1,6,0,0,6,10,0
Spain,2008,UEFA Euro,12,3,5,0,1,6,9,1
Spain,2009,Confederations Cup,11,4,4,1,0,5,7,0
Spain,2009,FIFA World Cup qualification,18,4,6,0,0,6,14,0
Spain,2009,Friendly,18,4,5,0,0,5,14,0
Spain,2010,FIFA World Cup,8,2,6,1,0,7,6,1
Spain,2010,Friendly,14,11,4,2,1,7,3,0
Spain,2010,UEFA Euro qualification,10,3,3,0,0,3,7,0
Spain,2011,Friendly,14,7,4,2,1,7,7,0
Spain,2011,UEFA Euro qualification,16,3,5,0,0,5,13,0
Spain,2012,FIFA World Cup qualification,6,1,2,0,1,3,5,0
Spain,2012,Friendly,24,3,7,0,0,7,21,0
Spain,2012,UEFA Euro,12,1,4,0,2,6,11,1
Spain,2013,Confederations Cup,15,4,3,1,1,5,11,0
Spain,2013,FIFA World Cup qualification,8,2,4,0,1,5,6,0
Spain,2013,Friendly,13,6,5,1,1,7,7,0
Spain,2014,FIFA World Cup,4,7,1,2,0,3,-3,0
Spain,2014,Friendly,5,2,3,2,0,5,3,0
Spain,2014,UEFA Euro qualification,13,3,3,1,0,4,10,0
Spain,2015,Friendly,4,3,2,1,0,3,1,0
Spain,2015,UEFA Euro qualification,10,0,6,0,0,6,10,0
Spain,2016,FIFA World Cup qualification,15,1,3,0,1,4,14,0
Spain,2016,Friendly,14,6,3,1,3,7,8,0
Spain,2016,UEFA Euro,5,4,2,2,0,4,1,0
Spain,2017,FIFA World Cup qualification,21,2,6,0,0,6,19,0
Spain,2017,Friendly,12,5,2,0,2,4,7,0
Spain,2018,FIFA World Cup,7,6,1,0,3,4,1,0
Spain,2018,Friendly,14,4,4,0,2,6,10,0
Spain,2018,UEFA Nations League,12,7,2,2,0,4,5,0
Spain,2019,UEFA Euro qualification,31,5,8,0,2,10,26,0
Spain,2020,Friendly,1,1,0,0,2,2,0,0
Spain,2020,UEFA Nations League,13,3,3,1,2,6,10,0
Spain,2021,FIFA World Cup qualification,15,5,6,1,1,8,10,0
Spain,2021,Friendly,4,0,1,0,1,2,4,0
Spain,2021,UEFA Euro,13,6,2,0,4,6,7,0
Spain,2021,UEFA Nations League,3,3,1,1,0,2,0,0
Spain,2022,FIFA World Cup,9,3,1,1,2,4,6,0
Spain,2022,Friendly,10,2,3,0,0,3,8,0
Spain,2022,UEFA Nations League,8,5,3,1,2,6,3,1
Spain,2023,UEFA Euro qualification,25,5,7,1,0,8,20,0
Spain,2023,UEFA Nations League,2,1,1,0,1,2,1,0
Spain,2024,Friendly,13,5,2,1,1,4,8,0
Spain,2024,UEFA Euro,15,4,7,0,0,7,11,1
Spain,2024,UEFA Nations League,13,4,5,0,1,6,9,0
Spain,2025,UEFA Nations League,5,5,0,0,2,2,0,0
Sri Lanka,1952,Friendly,1,4,0,2,0,2,-3,0
Sri Lanka,1953,Friendly,2,5,0,2,0,2,-3,0
Sri Lanka,1954,Friendly,4,4,1,1,1,3,0,1
Sri Lanka,1955,Friendly,4,7,0,2,0,2,-3,0
Sri Lanka,1964,Friendly,5,25,0,3,0,3,-20,0
Sri Lanka,1965,Friendly,0,5,0,1,0,1,-5,0
Sri Lanka,1971,AFC Asian Cup qualification,1,10,0,3,0,3,-9,0
Sri Lanka,1972,Friendly,5,15,0,5,0,5,-10,0
Sri Lanka,1972,Indonesia Tournament,5,5,1,1,0,2,0,0
Sri Lanka,1972,Merdeka Tournament,4,25,0,5,0,5,-21,0
Sri Lanka,1979,King's Cup,1,5,0,1,1,2,-4,0
Sri Lanka,1979,Korea Cup,0,7,0,2,0,2,-7,0
Sri Lanka,1983,Friendly,0,4,0,1,0,1,-4,0
Sri Lanka,1984,AFC Asian Cup qualification,6,11,1,2,1,4,-5,0
Sri Lanka,1986,Friendly,2,10,0,3,1,4,-8,0
Sri Lanka,1989,South Asian Games,1,5,0,2,0,2,-4,0
Sri Lanka,1991,South Asian Games,2,3,0,1,1,2,-1,0
Sri Lanka,1993,FIFA World Cup qualification,0,26,0,8,0,8,-26,0
Sri Lanka,1993,South Asian Games,5,4,2,1,0,3,1,0
Sri Lanka,1995,Friendly,0,3,0,2,0,2,-3,0
Sri Lanka,1995,SAFF Cup,5,3,2,0,1,3,2,1
Sri Lanka,1995,South Asian Games,0,1,0,1,2,3,-1,0
Sri Lanka,1996,AFC Asian Cup qualification,5,25,2,4,0,6,-20,0
Sri Lanka,1996,FIFA World Cup qualification,4,4,1,1,1,3,0,0
Sri Lanka,1997,SAFF Cup,6,4,2,2,0,4,2,0
Sri Lanka,1998,Friendly,2,2,0,0,1,1,0,0
Sri Lanka,1999,AFC Asian Cup qualification,2,18,0,4,0,4,-16,0
Sri Lanka,1999,SAFF Cup,2,3,0,1,1,2,-1,0
Sri Lanka,1999,South Asian Games,0,5,0,2,0,2,-5,0
Sri Lanka,2000,Friendly,7,13,2,3,3,8,-6,0
Sri Lanka,2001,FIFA World Cup qualification,8,20,1,4,1,6,-12,0
Sri Lanka,2001,Friendly,1,0,1,0,0,1,1,0
Sri Lanka,2002,Friendly,10,8,3,1,5,9,2,0
Sri Lanka,2003,AFC Asian Cup qualification,6,26,2,6,0,8,-20,0
Sri Lanka,2003,FIFA World Cup qualification,3,0,1,0,1,2,3,0
Sri Lanka,2003,SAFF Cup,3,3,1,1,1,3,0,0
Sri Lanka,2004,FIFA World Cup qualification,4,11,0,4,2,6,-7,0
Sri Lanka,2004,Friendly,0,0,0,0,1,1,0,0
Sri Lanka,2005,SAFF Cup,1,5,0,3,0,3,-4,0
Sri Lanka,2006,AFC Challenge Cup,7,6,3,1,2,6,1,0
Sri Lanka,2007,FIFA World Cup qualification,0,6,0,2,0,2,-6,0
Sri Lanka,2008,AFC Challenge Cup,1,9,0,3,0,3,-8,0
Sri Lanka,2008,AFC Challenge Cup qualification,14,4,2,0,1,3,10,0
Sri Lanka,2008,SAFF Cup,5,3,2,1,1,4,2,0
Sri Lanka,2009,AFC Challenge Cup qualification,7,3,1,0,1,2,4,0
Sri Lanka,2009,Friendly,3,5,0,1,1,2,-2,0
Sri Lanka,2009,Nehru Cup,6,14,1,3,0,4,-8,0
Sri Lanka,2009,SAFF Cup,9,7,2,2,0,4,2,0
Sri Lanka,2010,AFC Challenge Cup,4,7,1,2,0,3,-3,0
Sri Lanka,2011,AFC Challenge Cup qualification,0,5,0,2,1,3,-5,0
Sri Lanka,2011,FIFA World Cup qualification,1,5,0,1,1,2,-4,0
Sri Lanka,2011,Friendly,2,4,0,1,1,2,-2,0
Sri Lanka,2011,SAFF Cup,4,6,1,2,0,3,-2,0
Sri Lanka,2012,Friendly,0,6,0,1,0,1,-6,0
Sri Lanka,2013,AFC Challenge Cup qualification,5,5,1,2,0,3,0,0
Sri Lanka,2013,SAFF Cup,6,15,1,2,0,3,-9,0
Sri Lanka,2014,Friendly,3,6,1,2,1,4,-3,0
Sri Lanka,2015,FIFA World Cup qualification,1,3,0,2,0,2,-2,0
Sri Lanka,2015,Friendly,0,1,0,1,0,1,-1,0
Sri Lanka,2015,SAFF Cup,1,7,1,2,0,3,-6,0
Sri Lanka,2016,AFC Challenge Cup,2,5,0,2,1,3,-3,0
Sri Lanka,2016,Friendly,2,9,0,3,0,3,-7,0
Sri Lanka,2018,Friendly,2,4,1,1,0,2,-2,0
Sri Lanka,2018,SAFF Cup,0,2,0,1,1,2,-2,0
Sri Lanka,2019,FIFA World Cup qualification,3,17,1,6,0,7,-14,0
Sri Lanka,2019,Friendly,4,15,0,3,1,4,-11,0
Sri Lanka,2021,FIFA World Cup qualification,2,8,0,2,0,2,-6,0
Sri Lanka,2021,Mahinda Rajapaksa Cup,9,9,1,1,2,4,0,0
Sri Lanka,2021,SAFF Cup,2,5,0,3,1,4,-3,0
Sri Lanka,2022,AFC Asian Cup qualification,0,6,0,3,0,3,-6,0
Sri Lanka,2023,FIFA World Cup qualification,1,4,0,1,1,2,-3,0
Sri Lanka,2024,AFC Asian Cup qualification,2,2,0,0,2,2,0,0
Sri Lanka,2024,FIFA Series,2,0,1,0,1,2,2,0
Sri Lanka,2024,Friendly,1,6,1,4,1,6,-5,0
Sri Lanka,2025,AFC Asian Cup qualification,0,1,0,1,0,1,-1,0
Sri Lanka,2025,Friendly,2,1,1,0,0,1,1,0
Sudan,1956,Friendly,1,2,0,1,0,1,-1,0
Sudan,1957,African Cup of Nations,1,2,0,1,0,1,-1,0
Sudan,1957,FIFA World Cup qualification,2,1,1,0,1,2,1,0
Sudan,1957,Friendly,4,8,0,2,0,2,-4,0
Sudan,1959,African Cup of Nations,2,2,1,1,0,2,0,0
Sudan,1963,African Cup of Nations,6,5,1,1,1,3,1,0
Sudan,1963,African Cup of Nations qualification,6,0,2,0,0,2,6,0
Sudan,1963,Friendly,1,5,0,1,1,2,-4,0
Sudan,1965,African Cup of Nations qualification,9,4,3,1,0,4,5,0
Sudan,1966,Friendly,6,5,2,1,1,4,1,0
Sudan,1967,African Cup of Nations qualification,4,5,1,2,0,3,-1,0
Sudan,1967,Friendly,12,11,2,2,3,7,1,0
Sudan,1968,FIFA World Cup qualification,6,6,1,1,0,2,0,0
Sudan,1968,Friendly,1,1,0,0,1,1,0,0
Sudan,1969,FIFA World Cup qualification,9,10,1,1,4,6,-1,0
Sudan,1969,Friendly,6,3,3,1,0,4,3,0
Sudan,1970,African Cup of Nations,8,3,4,1,0,5,5,0
Sudan,1970,Friendly,0,3,0,1,0,1,-3,0
Sudan,1971,Friendly,10,8,1,0,2,3,2,0
Sudan,1972,African Cup of Nations,4,6,0,1,2,3,-2,0
Sudan,1972,FIFA World Cup qualification,1,2,1,1,0,2,-1,0
Sudan,1972,Friendly,0,7,0,2,0,2,-7,0
Sudan,1973,African Cup of Nations qualification,2,3,0,1,1,2,-1,0
Sudan,1973,Friendly,1,0,1,0,0,1,1,0
Sudan,1974,Kuneitra Cup,13,7,3,2,0,5,6,0
Sudan,1975,African Cup of Nations qualification,7,4,3,1,0,4,3,0
Sudan,1975,Palestine Cup,3,3,2,1,1,4,0,1
Sudan,1976,African Cup of Nations,3,4,0,1,2,3,-1,0
Sudan,1976,Friendly,0,1,0,1,0,1,-1,0
Sudan,1978,Friendly,5,1,2,0,0,2,4,0
Sudan,1979,African Cup of Nations qualification,2,4,1,1,0,2,-2,0
Sudan,1979,CECAFA Cup,1,5,0,1,1,2,-4,0
Sudan,1979,Korea Cup,5,9,2,1,0,3,-4,1
Sudan,1980,CECAFA Cup,3,1,2,1,0,3,2,1
Sudan,1980,FIFA World Cup qualification,1,3,0,1,1,2,-2,0
Sudan,1981,CECAFA Cup,2,4,0,1,2,3,-2,0
Sudan,1981,Friendly,1,3,0,1,1,2,-2,0
Sudan,1982,CECAFA Cup,0,3,0,2,0,2,-3,0
Sudan,1983,African Cup of Nations qualification,4,6,2,1,1,4,-2,0
Sudan,1983,CECAFA Cup,4,3,2,2,0,4,1,0
Sudan,1983,Friendly,1,5,0,2,0,2,-4,0
Sudan,1983,Korea Cup,2,4,0,1,1,2,-2,0
Sudan,1984,FIFA World Cup qualification,1,1,0,0,2,2,0,0
Sudan,1985,FIFA World Cup qualification,0,4,0,1,1,2,-4,0
Sudan,1987,African Cup of Nations qualification,3,3,2,1,1,4,0,0
Sudan,1988,FIFA World Cup qualification,1,2,0,1,1,2,-1,0
Sudan,1989,African Cup of Nations qualification,1,1,1,1,0,2,0,0
Sudan,1990,African Cup of Nations qualification,1,0,1,0,0,1,1,0
Sudan,1990,CECAFA Cup,5,5,2,1,1,4,0,0
Sudan,1991,African Cup of Nations qualification,2,3,1,2,0,3,-1,0
Sudan,1991,CECAFA Cup,4,9,0,3,1,4,-5,0
Sudan,1991,Friendly,2,1,1,0,1,2,1,0
Sudan,1992,African Cup of Nations qualification,0,3,0,1,1,2,-3,0
Sudan,1992,Friendly,3,6,1,1,1,3,-3,0
Sudan,1992,Jordan International Tournament,5,5,1,2,0,3,0,0
Sudan,1993,African Cup of Nations qualification,2,6,1,2,1,4,-4,0
Sudan,1993,Friendly,1,1,0,0,1,1,0,0
Sudan,1994,African Cup of Nations qualification,1,3,0,1,2,3,-2,0
Sudan,1994,Friendly,1,1,0,0,1,1,0,0
Sudan,1995,African Cup of Nations qualification,9,11,3,4,0,7,-2,0
Sudan,1996,CECAFA Cup,4,3,1,0,1,2,1,0
Sudan,1996,FIFA World Cup qualification,2,3,1,1,0,2,-1,0
Sudan,1996,Friendly,4,3,2,1,3,6,1,0
Sudan,1998,Arab Cup,1,4,0,1,0,1,-3,0
Sudan,1998,Friendly,5,5,1,1,1,3,0,0
Sudan,1998,United Arab Emirates Friendship Tournament,4,6,0,2,1,3,-2,0
Sudan,1999,CECAFA Cup,1,4,0,1,2,3,-3,0
Sudan,2000,African Cup of Nations qualification,6,5,1,3,0,4,1,0
Sudan,2000,FIFA World Cup qualification,4,2,2,1,0,3,2,0
Sudan,2000,Friendly,0,4,0,2,0,2,-4,0
Sudan,2001,African Cup of Nations qualification,3,5,1,2,1,4,-2,0
Sudan,2001,FIFA World Cup qualification,6,10,3,4,0,7,-4,0
Sudan,2001,Friendly,2,1,1,0,1,2,1,0
Sudan,2002,African Cup of Nations qualification,2,2,1,1,0,2,0,0
Sudan,2002,Arab Cup,3,5,0,2,1,3,-2,0
Sudan,2002,CECAFA Cup,4,5,1,2,1,4,-1,0
Sudan,2002,Friendly,7,4,3,1,1,5,3,0
Sudan,2003,African Cup of Nations qualification,7,4,2,1,1,4,3,0
Sudan,2003,CECAFA Cup,8,2,2,1,1,4,6,0
Sudan,2003,FIFA World Cup qualification,3,0,1,0,1,2,3,0
Sudan,2003,Friendly,6,8,1,2,2,5,-2,0
Sudan,2004,CECAFA Cup,11,6,3,1,1,5,5,1
Sudan,2004,FIFA World Cup qualification,2,11,0,3,2,5,-9,0
Sudan,2004,Friendly,3,5,1,2,1,4,-2,0
Sudan,2005,CECAFA Cup,9,7,2,2,0,4,2,0
Sudan,2005,FIFA World Cup qualification,4,11,1,3,1,5,-7,0
Sudan,2005,Friendly,9,8,2,1,1,4,1,0
Sudan,2006,African Cup of Nations qualification,3,1,1,1,0,2,2,0
Sudan,2006,Arab Cup qualification,8,1,2,0,1,3,7,0
Sudan,2006,CECAFA Cup,7,4,2,1,3,6,3,0
Sudan,2006,Friendly,0,2,0,2,0,2,-2,0
Sudan,2007,African Cup of Nations qualification,10,3,4,0,0,4,7,0
Sudan,2007,CECAFA Cup,8,6,2,0,3,5,2,0
Sudan,2007,Friendly,4,2,3,1,1,5,2,0
Sudan,2008,African Cup of Nations,0,9,0,3,0,3,-9,0
Sudan,2008,CECAFA Cup,0,0,0,0,1,1,0,0
Sudan,2008,FIFA World Cup qualification,9,9,3,3,0,6,0,0
Sudan,2008,Friendly,5,11,1,3,1,5,-6,0
Sudan,2009,CECAFA Cup,3,2,1,1,1,3,1,0
Sudan,2009,FIFA World Cup qualification,2,9,0,5,1,6,-7,0
Sudan,2009,Friendly,0,6,0,2,0,2,-6,0
Sudan,2010,African Cup of Nations qualification,2,0,1,0,1,2,2,0
Sudan,2010,CECAFA Cup,0,2,0,1,1,2,-2,0
Sudan,2010,Friendly,3,7,0,1,1,2,-4,0
Sudan,2011,African Cup of Nations qualification,6,3,3,1,0,4,3,0
Sudan,2011,CECAFA Cup,6,3,3,1,2,6,3,1
Sudan,2011,Friendly,10,7,4,2,1,7,3,0
Sudan,2011,Nile Basin Tournament,3,3,1,2,0,3,0,0
Sudan,2012,African Cup of Nations,4,7,1,2,1,4,-3,0
Sudan,2012,African Cup of Nations qualification,5,5,1,1,0,2,0,0
Sudan,2012,Arab Cup,3,1,1,0,1,2,2,0
Sudan,2012,CECAFA Cup,1,3,1,2,0,3,-2,0
Sudan,2012,FIFA World Cup qualification,0,3,0,1,1,2,-3,0
Sudan,2012,Friendly,0,7,0,3,1,4,-7,0
Sudan,2013,CECAFA Cup,8,4,4,2,0,6,4,0
Sudan,2013,FIFA World Cup qualification,3,11,0,3,1,4,-8,0
Sudan,2013,Friendly,0,2,0,1,1,2,-2,0
Sudan,2014,African Cup of Nations qualification,3,11,1,5,0,6,-8,0
Sudan,2014,Friendly,1,3,0,1,0,1,-2,0
Sudan,2015,African Cup of Nations qualification,1,0,1,0,0,1,1,0
Sudan,2015,CECAFA Cup,7,4,1,1,4,6,3,0
Sudan,2015,FIFA World Cup qualification,0,3,0,2,0,2,-3,0
Sudan,2015,Friendly,0,4,0,1,0,1,-4,0
Sudan,2016,African Cup of Nations qualification,1,3,0,2,1,3,-2,0
Sudan,2016,Friendly,2,3,0,1,1,2,-1,0
Sudan,2017,African Cup of Nations qualification,1,3,0,1,0,1,-2,0
Sudan,2017,Friendly,1,2,0,1,0,1,-1,0
Sudan,2018,African Cup of Nations qualification,3,6,1,3,0,4,-3,0
Sudan,2019,African Cup of Nations qualification,5,5,1,2,0,3,0,0
Sudan,2019,FIFA World Cup qualification,3,1,1,0,1,2,2,0
Sudan,2020,African Cup of Nations qualification,1,2,1,1,0,2,-1,0
Sudan,2020,Friendly,3,6,0,1,2,3,-3,0
Sudan,2021,African Cup of Nations qualification,4,0,2,0,0,2,4,0
Sudan,2021,Arab Cup,0,10,0,3,0,3,-10,0
Sudan,2021,Arab Cup qualification,1,0,1,0,0,1,1,0
Sudan,2021,FIFA World Cup qualification,5,12,0,3,3,6,-7,0
Sudan,2021,Friendly,6,6,1,3,0,4,0,0
Sudan,2022,African Cup of Nations,1,4,0,2,1,3,-3,0
Sudan,2022,African Cup of Nations qualification,2,4,1,1,0,2,-2,0
Sudan,2022,Friendly,3,4,0,1,5,6,-1,0
Sudan,2023,African Cup of Nations qualification,1,6,1,3,0,4,-5,0
Sudan,2023,FIFA World Cup qualification,2,1,1,0,1,2,1,0
Sudan,2023,Friendly,2,1,1,0,1,2,1,0
Sudan,2024,African Cup of Nations qualification,4,2,2,1,1,4,2,0
Sudan,2024,FIFA World Cup qualification,5,0,2,0,0,2,5,0
Sudan,2025,FIFA World Cup qualification,1,1,0,0,2,2,0,0
Sudan,2025,Friendly,0,0,0,0,1,1,0,0
Suriname,1921,Friendly,1,2,0,1,0,1,-1,0
Suriname,1923,Friendly,2,1,1,0,0,1,1,0
Suriname,1934,Friendly,9,12,0,2,3,5,-3,0
Suriname,1935,Friendly,6,6,2,2,0,4,0,0
Suriname,1936,Friendly,3,1,1,0,0,1,2,0
Suriname,1937,Friendly,14,6,1,0,3,4,8,0
Suriname,1938,Friendly,7,14,2,5,0,7,-7,0
Suriname,1943,Friendly,5,2,2,1,0,3,3,0
Suriname,1944,Friendly,8,7,1,3,0,4,1,0
Suriname,1945,Friendly,13,2,3,0,0,3,11,0
Suriname,1946,Friendly,6,17,2,3,0,5,-11,0
Suriname,1947,Friendly,14,1,3,0,1,4,13,0
Suriname,1948,Friendly,11,8,3,2,1,6,3,0
Suriname,1949,Friendly,7,2,2,1,0,3,5,0
Suriname,1950,Friendly,11,13,3,3,1,7,-2,0
Suriname,1951,Friendly,15,1,3,0,0,3,14,0
Suriname,1952,Friendly,10,2,1,1,0,2,8,0
Suriname,1953,Friendly,6,6,0,0,2,2,0,0
Suriname,1954,Friendly,3,6,0,2,0,2,-3,0
Suriname,1955,Friendly,11,3,3,0,0,3,8,0
Suriname,1956,Friendly,4,4,1,1,1,3,0,0
Suriname,1959,Friendly,10,13,2,3,1,6,-3,0
Suriname,1960,CCCF Championship,0,1,0,1,0,1,-1,0
Suriname,1960,FIFA World Cup qualification,1,2,0,1,1,2,-1,0
Suriname,1960,Friendly,3,4,0,1,0,1,-1,0
Suriname,1962,Friendly,13,11,2,2,4,8,2,0
Suriname,1963,Friendly,10,9,2,2,0,4,1,0
Suriname,1964,Friendly,4,6,0,1,1,2,-2,0
Suriname,1965,FIFA World Cup qualification,8,9,1,3,0,4,-1,0
Suriname,1965,Friendly,12,0,2,0,0,2,12,0
Suriname,1966,Friendly,22,11,4,1,2,7,11,0
Suriname,1967,Friendly,14,3,4,0,1,5,11,0
Suriname,1968,FIFA World Cup qualification,10,9,2,2,0,4,1,0
Suriname,1968,Friendly,16,5,4,1,2,7,11,0
Suriname,1969,Friendly,19,8,4,1,1,6,11,0
Suriname,1970,Friendly,11,5,3,0,0,3,6,0
Suriname,1971,CONCACAF Championship qualification,7,3,2,0,0,2,4,0
Suriname,1972,CONCACAF Championship qualification,11,4,2,1,1,4,7,0
Suriname,1973,Friendly,7,3,2,0,2,4,4,0
Suriname,1974,Friendly,8,7,2,2,1,5,1,0
Suriname,1975,Friendly,12,8,2,2,0,4,4,0
Suriname,1976,CONCACAF Championship qualification,9,7,2,1,2,5,2,0
Suriname,1977,CONCACAF Championship,6,17,0,5,0,5,-11,0
Suriname,1977,Friendly,2,1,1,0,0,1,1,0
Suriname,1978,CFU Caribbean Cup,8,0,3,0,0,3,8,0
Suriname,1978,CFU Caribbean Cup qualification,9,1,4,0,0,4,8,1
Suriname,1979,CFU Caribbean Cup,5,4,1,2,0,3,1,0
Suriname,1980,CONCACAF Championship qualification,5,3,2,1,1,4,2,0
Suriname,1981,CFU Caribbean Cup qualification,12,13,2,3,2,7,-1,0
Suriname,1982,Friendly,3,2,1,0,0,1,1,0
Suriname,1983,CFU Caribbean Cup qualification,0,1,0,1,1,2,-1,0
Suriname,1984,CONCACAF Championship qualification,2,1,1,0,1,2,1,0
Suriname,1984,Friendly,12,5,2,0,2,4,7,0
Suriname,1985,CFU Caribbean Cup,2,4,0,1,2,3,-2,0
Suriname,1985,CFU Caribbean Cup qualification,3,1,3,1,0,4,2,1
Suriname,1985,CONCACAF Championship,2,9,0,3,1,4,-7,0
Suriname,1987,CFU Caribbean Cup qualification,2,1,1,0,1,2,1,0
Suriname,1988,CFU Caribbean Cup qualification,3,1,1,0,1,2,2,0
Suriname,1990,CFU Caribbean Cup qualification,7,4,1,1,1,3,3,0
Suriname,1990,Friendly,0,5,0,1,0,1,-5,0
Suriname,1991,CFU Caribbean Cup qualification,2,1,1,0,1,2,1,0
Suriname,1991,Friendly,3,0,1,0,0,1,3,0
Suriname,1992,CFU Caribbean Cup,1,1,0,0,1,1,0,0
Suriname,1992,CFU Caribbean Cup qualification,3,2,1,0,0,1,1,1
Suriname,1992,FIFA World Cup qualification,4,4,1,1,2,4,0,0
Suriname,1994,CFU Caribbean Cup,5,8,1,3,1,5,-3,0
Suriname,1994,CFU Caribbean Cup qualification,3,0,2,0,0,2,3,0
Suriname,1994,Friendly,1,2,0,1,0,1,-1,0
Suriname,1995,CFU Caribbean Cup qualification,3,6,1,1,1,3,-3,0
Suriname,1996,CFU Caribbean Cup,5,10,1,2,2,5,-5,0
Suriname,1996,CFU Caribbean Cup qualification,6,5,2,1,1,4,1,0
Suriname,1996,FIFA World Cup qualification,0,2,0,2,0,2,-2,0
Suriname,1998,CFU Caribbean Cup qualification,8,8,0,0,3,3,0,0
Suriname,1999,CFU Caribbean Cup qualification,1,1,0,0,2,2,0,0
Suriname,1999,Friendly,2,1,1,0,0,1,1,0
Suriname,2000,FIFA World Cup qualification,1,2,1,2,1,4,-1,0
Suriname,2001,CFU Caribbean Cup,4,9,0,2,1,3,-5,0
Suriname,2001,CFU Caribbean Cup qualification,10,3,2,0,1,3,7,0
Suriname,2002,Friendly,2,1,1,0,1,2,1,0
Suriname,2002,Gold Cup qualification,8,0,2,0,0,2,8,0
Suriname,2004,CFU Caribbean Cup qualification,3,4,0,1,2,3,-1,0
Suriname,2004,FIFA World Cup qualification,12,6,2,1,1,4,6,0
Suriname,2004,Friendly,2,5,0,2,1,3,-3,0
Suriname,2006,CFU Caribbean Cup qualification,4,10,2,3,1,6,-6,0
Suriname,2008,CFU Caribbean Cup qualification,8,12,2,2,1,5,-4,0
Suriname,2008,FIFA World Cup qualification,14,21,3,4,2,9,-7,0
Suriname,2008,Friendly,3,3,1,1,0,2,0,0
Suriname,2009,Friendly,5,1,1,0,2,3,4,0
Suriname,2010,ABCS Tournament,6,4,1,0,1,2,2,0
Suriname,2010,CFU Caribbean Cup qualification,13,9,3,2,1,6,4,1
Suriname,2010,Friendly,2,1,1,0,0,1,1,0
Suriname,2011,ABCS Tournament,2,0,1,0,1,2,2,1
Suriname,2011,FIFA World Cup qualification,5,11,2,3,1,6,-6,0
Suriname,2011,Friendly,4,2,1,0,1,2,2,0
Suriname,2012,ABCS Tournament,8,1,1,1,0,2,7,0
Suriname,2012,CFU Caribbean Cup qualification,13,11,2,2,1,5,2,0
Suriname,2012,Friendly,1,2,0,1,0,1,-1,0
Suriname,2013,ABCS Tournament,5,1,2,0,0,2,4,0
Suriname,2014,CFU Caribbean Cup qualification,2,3,0,1,0,1,-1,0
Suriname,2014,Friendly,2,0,2,0,1,3,2,0
Suriname,2015,ABCS Tournament,4,0,2,0,0,2,4,0
Suriname,2015,FIFA World Cup qualification,1,4,0,2,0,2,-3,0
Suriname,2016,CFU Caribbean Cup qualification,6,6,2,2,1,5,0,0
Suriname,2016,Friendly,3,4,1,1,0,2,-1,0
Suriname,2017,CFU Caribbean Cup qualification,4,5,1,1,0,2,-1,0
Suriname,2018,CONCACAF Nations League qualification,6,2,1,1,1,3,4,0
Suriname,2019,CONCACAF Nations League,16,5,4,1,1,6,11,0
Suriname,2019,CONCACAF Nations League qualification,2,0,1,0,0,1,2,0
Suriname,2021,FIFA World Cup qualification,15,4,3,1,0,4,11,0
Suriname,2021,Gold Cup,3,5,1,2,0,3,-2,0
Suriname,2022,CONCACAF Nations League,2,7,0,2,1,3,-5,0
Suriname,2022,Friendly,5,3,3,1,0,4,2,0
Suriname,2023,CONCACAF Nations League,6,5,1,2,2,5,1,0
Suriname,2023,Gold Cup qualification,0,0,0,0,1,1,0,0
Suriname,2024,CONCACAF Nations League,9,8,2,3,1,6,1,0
Suriname,2024,FIFA World Cup qualification,8,1,2,0,0,2,7,0
Suriname,2024,Friendly,1,1,0,0,1,1,0,0
Suriname,2025,Gold Cup qualification,2,0,2,0,0,2,2,0
Surrey,2018,Friendly,3,1,1,0,0,1,2,0
Sweden,1908,Friendly,15,10,1,2,0,3,5,0
Sweden,1908,Olympic Games,0,2,0,1,0,1,-2,0
Sweden,1910,Friendly,4,0,1,0,0,1,4,0
Sweden,1911,Friendly,14,8,3,1,0,4,6,0
Sweden,1912,Friendly,15,6,3,0,1,4,9,0
Sweden,1912,Olympic Games,3,5,0,2,0,2,-2,0
Sweden,1913,Friendly,14,22,2,3,1,6,-8,0
Sweden,1914,Friendly,15,6,3,0,2,5,9,0
Sweden,1915,Friendly,6,7,1,2,1,4,-1,0
Sweden,1916,Friendly,12,5,2,2,1,5,7,0
Sweden,1917,Friendly,7,6,1,1,2,4,1,0
Sweden,1918,Friendly,4,7,1,3,0,4,-3,0
Sweden,1919,Friendly,16,19,3,4,1,8,-3,0
Sweden,1920,Friendly,7,4,2,3,1,6,3,0
Sweden,1920,Olympic Games,14,7,1,2,0,3,7,0
Sweden,1921,Friendly,8,20,0,5,4,9,-12,0
Sweden,1922,Friendly,13,7,3,2,2,7,6,0
Sweden,1923,Friendly,21,23,4,4,1,9,-2,0
Sweden,1924,Friendly,29,12,5,0,2,7,17,0
Sweden,1924,Nordic Championship,9,3,2,0,0,2,6,1
Sweden,1924,Olympic Games,18,5,3,1,1,5,13,0
Sweden,1925,Friendly,19,8,4,1,0,5,11,0
Sweden,1925,Nordic Championship,7,5,1,1,0,2,2,1
Sweden,1926,Friendly,28,26,4,4,2,10,2,0
Sweden,1926,Nordic Championship,3,4,1,1,0,2,-1,0
Sweden,1927,Friendly,31,8,4,2,1,7,23,0
Sweden,1927,Nordic Championship,5,3,1,0,1,2,2,0
Sweden,1928,Friendly,13,7,4,2,0,6,6,0
Sweden,1928,Nordic Championship,7,4,1,1,0,2,3,0
Sweden,1929,Friendly,20,6,3,1,0,4,14,0
Sweden,1929,Nordic Championship,7,5,2,1,0,3,2,0
Sweden,1930,Friendly,14,10,3,2,1,6,4,0
Sweden,1930,Nordic Championship,11,13,1,1,1,3,-2,0
Sweden,1931,Friendly,10,4,2,1,1,4,6,0
Sweden,1931,Nordic Championship,12,5,2,1,0,3,7,0
Sweden,1932,Friendly,28,16,4,4,1,9,12,0
Sweden,1932,Nordic Championship,5,8,1,2,0,3,-3,0
Sweden,1933,FIFA World Cup qualification,8,2,2,0,0,2,6,0
Sweden,1933,Friendly,6,3,1,0,1,2,3,0
Sweden,1933,Nordic Championship,5,3,2,1,0,3,2,0
Sweden,1934,FIFA World Cup,4,4,1,1,0,2,0,0
Sweden,1934,Friendly,7,3,2,0,0,2,4,0
Sweden,1934,Nordic Championship,12,11,1,1,1,3,1,0
Sweden,1935,Friendly,16,10,4,2,0,6,6,0
Sweden,1935,Nordic Championship,7,3,2,0,1,3,4,0
Sweden,1936,Friendly,8,6,1,1,0,2,2,0
Sweden,1936,Nordic Championship,7,5,2,1,0,3,2,1
Sweden,1937,FIFA World Cup qualification,11,7,2,1,0,3,4,0
Sweden,1937,Friendly,3,9,0,2,1,3,-6,0
Sweden,1937,Nordic Championship,3,5,0,2,0,2,-2,0
Sweden,1938,FIFA World Cup,11,9,1,2,0,3,2,0
Sweden,1938,Friendly,8,11,1,2,1,4,-3,0
Sweden,1938,Nordic Championship,7,5,2,1,0,3,2,0
Sweden,1939,Friendly,10,3,2,1,0,3,7,0
Sweden,1939,Nordic Championship,12,4,3,0,0,3,8,0
Sweden,1940,Friendly,12,6,2,0,2,4,6,0
Sweden,1941,Friendly,7,6,1,1,1,3,1,0
Sweden,1942,Friendly,9,6,3,1,0,4,3,0
Sweden,1943,Friendly,13,9,2,2,1,5,4,0
Sweden,1945,Friendly,33,11,6,1,0,7,22,0
Sweden,1946,Friendly,21,8,3,1,1,5,13,0
Sweden,1947,Friendly,18,10,3,1,0,4,8,0
Sweden,1947,Nordic Championship,15,2,3,0,0,3,13,0
Sweden,1948,Friendly,7,5,2,2,0,4,2,0
Sweden,1948,Nordic Championship,8,5,2,0,1,3,3,1
Sweden,1949,FIFA World Cup qualification,6,2,2,0,0,2,4,0
Sweden,1949,Friendly,5,8,1,1,1,3,-3,0
Sweden,1949,Nordic Championship,13,7,1,1,1,3,6,0
Sweden,1950,FIFA World Cup,11,15,2,2,1,5,-4,1
Sweden,1950,Friendly,7,7,1,2,0,3,0,0
Sweden,1950,Nordic Championship,8,1,3,0,0,3,7,1
Sweden,1951,Friendly,8,9,1,3,2,6,-1,0
Sweden,1951,Nordic Championship,7,9,1,2,0,3,-2,0
Sweden,1952,Friendly,8,5,3,1,2,6,3,0
Sweden,1952,Nordic Championship,14,5,3,0,0,3,9,0
Sweden,1953,FIFA World Cup qualification,9,8,1,2,1,4,1,0
Sweden,1953,Friendly,9,9,2,1,2,5,0,0
Sweden,1953,Nordic Championship,3,1,1,0,1,2,2,0
Sweden,1954,Friendly,20,11,5,1,0,6,9,0
Sweden,1954,Nordic Championship,16,4,2,0,1,3,12,0
Sweden,1955,Friendly,15,22,2,4,0,6,-7,0
Sweden,1955,Nordic Championship,7,4,1,0,2,3,3,0
Sweden,1956,Friendly,4,2,1,0,2,3,2,0
Sweden,1956,Nordic Championship,5,5,1,1,1,3,0,0
Sweden,1957,Friendly,5,3,1,2,2,5,2,0
Sweden,1957,Nordic Championship,12,4,3,0,0,3,8,0
Sweden,1958,FIFA World Cup,12,7,4,1,1,6,5,0
Sweden,1958,Friendly,3,2,1,0,0,1,1,0
Sweden,1958,Nordic Championship,13,5,2,0,1,3,8,0
Sweden,1959,Friendly,9,8,2,2,0,4,1,0
Sweden,1959,Nordic Championship,15,3,3,0,0,3,12,1
Sweden,1960,FIFA World Cup qualification,2,0,1,0,0,1,2,0
Sweden,1960,Friendly,5,1,2,0,0,2,4,0
Sweden,1960,Nordic Championship,6,3,2,1,0,3,3,1
Sweden,1961,FIFA World Cup qualification,9,5,2,2,0,4,4,0
Sweden,1961,Friendly,1,2,0,1,0,1,-1,0
Sweden,1961,Nordic Championship,8,1,3,0,0,3,7,1
Sweden,1962,Friendly,9,4,4,1,0,5,5,0
Sweden,1962,Nordic Championship,8,4,2,1,0,3,4,1
Sweden,1962,UEFA Euro qualification,3,1,1,0,1,2,2,0
Sweden,1963,Friendly,5,2,3,0,0,3,3,0
Sweden,1963,Nordic Championship,2,2,0,0,3,3,0,0
Sweden,1963,UEFA Euro qualification,3,2,1,0,1,2,1,0
Sweden,1964,FIFA World Cup qualification,1,1,0,0,1,1,0,0
Sweden,1964,Friendly,4,3,1,0,1,2,1,0
Sweden,1964,Nordic Championship,5,3,1,1,1,3,2,0
Sweden,1964,UEFA Euro qualification,2,4,0,1,1,2,-2,0
Sweden,1965,FIFA World Cup qualification,9,2,2,1,0,3,7,0
Sweden,1965,Friendly,4,6,0,2,1,3,-2,0
Sweden,1965,Nordic Championship,3,4,0,1,2,3,-1,0
Sweden,1966,Friendly,9,10,1,2,2,5,-1,0
Sweden,1966,Nordic Championship,6,4,2,1,0,3,2,1
Sweden,1966,UEFA Euro qualification,2,1,1,0,0,1,1,0
Sweden,1967,Friendly,0,1,0,1,0,1,-1,0
Sweden,1967,Nordic Championship,3,1,1,0,1,2,2,0
Sweden,1967,UEFA Euro qualification,7,11,1,3,1,5,-4,0
Sweden,1968,FIFA World Cup qualification,5,0,1,0,0,1,5,0
Sweden,1968,Friendly,8,9,1,2,2,5,-1,0
Sweden,1968,Nordic Championship,6,2,2,0,1,3,4,0
Sweden,1969,FIFA World Cup qualification,7,5,2,1,0,3,2,0
Sweden,1969,Friendly,8,3,4,1,0,5,5,0
Sweden,1969,Nordic Championship,9,2,3,0,0,3,7,0
Sweden,1970,FIFA World Cup,2,2,1,1,1,3,0,0
Sweden,1970,Friendly,3,1,2,0,1,3,2,0
Sweden,1970,Nordic Championship,3,2,1,0,1,2,1,0
Sweden,1970,UEFA Euro qualification,2,1,1,0,1,2,1,0
Sweden,1971,Friendly,1,0,1,0,0,1,1,0
Sweden,1971,Nordic Championship,10,2,3,0,0,3,8,0
Sweden,1971,UEFA Euro qualification,1,4,1,2,1,4,-3,0
Sweden,1972,FIFA World Cup qualification,7,2,1,1,1,3,5,0
Sweden,1972,Friendly,6,7,0,1,2,3,-1,0
Sweden,1972,Nordic Championship,5,1,2,0,0,2,4,1
Sweden,1973,FIFA World Cup qualification,10,7,3,0,1,4,3,0
Sweden,1973,Friendly,4,3,3,1,1,5,1,0
Sweden,1973,Nordic Championship,3,2,1,0,1,2,1,0
Sweden,1974,FIFA World Cup,7,6,2,2,2,6,1,0
Sweden,1974,Friendly,1,11,0,3,1,4,-10,0
Sweden,1974,Nordic Championship,4,1,2,0,0,2,3,0
Sweden,1974,UEFA Euro qualification,0,2,0,1,0,1,-2,0
Sweden,1975,Friendly,5,1,1,0,1,2,4,0
Sweden,1975,Nordic Championship,0,0,0,0,1,1,0,0
Sweden,1975,UEFA Euro qualification,8,7,3,2,0,5,1,0
Sweden,1976,FIFA World Cup qualification,4,1,2,0,0,2,3,0
Sweden,1976,Friendly,5,5,1,2,2,5,0,0
Sweden,1976,Nordic Championship,10,3,2,1,0,3,7,0
Sweden,1977,FIFA World Cup qualification,3,3,1,1,0,2,0,0
Sweden,1977,Friendly,4,9,2,4,0,6,-5,0
Sweden,1977,Nordic Championship,2,2,1,1,0,2,0,0
Sweden,1978,FIFA World Cup,1,3,0,2,1,3,-2,0
Sweden,1978,Friendly,4,1,2,0,1,3,3,0
Sweden,1978,Nordic Championship,3,3,1,1,0,2,0,0
Sweden,1978,UEFA Euro qualification,3,5,0,1,1,2,-2,0
Sweden,1979,Friendly,10,6,2,2,2,6,4,0
Sweden,1979,Nordic Championship,2,2,1,1,0,2,0,0
Sweden,1979,UEFA Euro qualification,6,8,1,2,1,4,-2,0
Sweden,1980,FIFA World Cup qualification,1,5,0,2,2,4,-4,0
Sweden,1980,Friendly,5,10,1,2,1,4,-5,0
Sweden,1980,Nordic Championship,2,1,1,1,0,2,1,0
Sweden,1981,FIFA World Cup qualification,6,3,3,1,0,4,3,0
Sweden,1981,Friendly,9,7,3,2,0,5,2,0
Sweden,1981,Nordic Championship,2,2,1,1,0,2,0,0
Sweden,1982,Friendly,6,7,0,1,3,4,-1,0
Sweden,1982,Nordic Championship,1,2,0,1,1,2,-1,0
Sweden,1982,UEFA Euro qualification,3,4,1,1,1,3,-1,0
Sweden,1983,Friendly,19,5,4,1,1,6,14,0
Sweden,1983,Nordic Championship,3,0,1,0,0,1,3,1
Sweden,1983,UEFA Euro qualification,11,1,4,1,0,5,10,0
Sweden,1984,FIFA World Cup qualification,7,4,2,2,0,4,3,0
Sweden,1984,Friendly,1,3,0,2,2,4,-2,0
Sweden,1985,FIFA World Cup qualification,7,5,2,1,1,4,2,0
Sweden,1985,Friendly,6,1,3,0,1,4,5,0
Sweden,1986,Friendly,4,2,2,1,2,5,2,0
Sweden,1986,UEFA Euro qualification,8,1,2,0,1,3,7,0
Sweden,1987,Friendly,5,2,2,0,2,4,3,0
Sweden,1987,UEFA Euro qualification,4,4,2,2,1,5,0,0
Sweden,1988,FIFA World Cup qualification,2,1,1,0,1,2,1,0
Sweden,1988,Four Nations Tournament,3,1,1,0,1,2,2,1
Sweden,1988,Friendly,13,5,4,1,1,6,8,0
Sweden,1989,FIFA World Cup qualification,7,2,3,0,1,4,5,0
Sweden,1989,Friendly,8,11,3,2,0,5,-3,0
Sweden,1990,FIFA World Cup,3,6,0,3,0,3,-3,0
Sweden,1990,Friendly,19,10,5,3,2,10,9,0
Sweden,1991,Friendly,17,13,3,2,2,7,4,0
Sweden,1991,Scania 100 Tournament,6,3,1,1,0,2,3,0
Sweden,1992,FIFA World Cup qualification,6,1,3,0,0,3,5,0
Sweden,1992,Friendly,10,5,3,2,2,7,5,0
Sweden,1992,UEFA Euro,6,5,2,1,1,4,1,0
Sweden,1993,FIFA World Cup qualification,13,7,3,1,3,7,6,0
Sweden,1993,Friendly,3,2,1,1,0,2,1,0
Sweden,1994,FIFA World Cup,15,8,3,1,3,7,7,0
Sweden,1994,Friendly,13,7,4,2,1,7,6,0
Sweden,1994,Joe Robbie Cup,3,1,1,0,1,2,2,1
Sweden,1994,UEFA Euro qualification,5,4,2,1,0,3,1,0
Sweden,1995,Friendly,11,9,2,1,3,6,2,0
Sweden,1995,UEFA Euro qualification,4,6,0,2,3,5,-2,0
Sweden,1996,FIFA World Cup qualification,7,4,2,2,0,4,3,0
Sweden,1996,Friendly,8,3,4,1,1,6,5,0
Sweden,1996,Lunar New Year Cup,1,1,0,0,1,1,0,0
Sweden,1997,FIFA World Cup qualification,9,5,5,1,0,6,4,0
Sweden,1997,Friendly,4,3,2,1,1,4,1,0
Sweden,1997,King's Cup,4,1,2,0,1,3,3,1
Sweden,1998,Friendly,5,5,3,2,2,7,0,0
Sweden,1998,UEFA Euro qualification,3,1,2,0,0,2,2,0
Sweden,1999,Friendly,3,4,2,2,1,5,-1,0
Sweden,1999,UEFA Euro qualification,7,0,5,0,1,6,7,0
Sweden,2000,FIFA World Cup qualification,2,1,1,0,2,3,1,0
Sweden,2000,Friendly,3,3,1,1,2,4,0,0
Sweden,2000,Nordic Championship,2,3,0,1,1,2,-1,0
Sweden,2000,UEFA Euro,2,4,0,2,1,3,-2,0
Sweden,2001,FIFA World Cup qualification,18,2,7,0,0,7,16,0
Sweden,2001,Friendly,9,1,3,0,1,4,8,0
Sweden,2001,King's Cup,9,3,2,0,2,4,6,1
Sweden,2001,Nordic Championship,0,1,0,1,1,2,-1,0
Sweden,2002,FIFA World Cup,5,5,1,1,2,4,0,0
Sweden,2002,Friendly,11,13,0,2,6,8,-2,0
Sweden,2002,UEFA Euro qualification,1,1,0,0,2,2,0,0
Sweden,2003,Friendly,2,6,0,4,0,4,-4,0
Sweden,2003,King's Cup,12,4,3,0,1,4,8,1
Sweden,2003,UEFA Euro qualification,18,2,5,1,0,6,16,0
Sweden,2004,FIFA World Cup qualification,14,2,3,1,0,4,12,0
Sweden,2004,Friendly,16,9,4,1,2,7,7,0
Sweden,2004,Lunar New Year Cup,0,3,0,1,0,1,-3,0
Sweden,2004,UEFA Euro,8,3,1,0,3,4,5,0
Sweden,2005,FIFA World Cup qualification,16,2,5,1,0,6,14,0
Sweden,2005,Friendly,8,8,1,1,4,6,0,0
Sweden,2006,FIFA World Cup,3,4,1,1,2,4,-1,0
Sweden,2006,Friendly,2,9,0,3,4,7,-7,0
Sweden,2006,UEFA Euro qualification,8,2,4,0,0,4,6,0
Sweden,2007,Friendly,5,8,2,3,1,6,-3,0
Sweden,2007,UEFA Euro qualification,15,7,4,2,2,8,8,0
Sweden,2008,FIFA World Cup qualification,2,1,1,0,2,3,1,0
Sweden,2008,Friendly,5,10,2,5,1,8,-5,0
Sweden,2008,UEFA Euro,3,4,1,2,0,3,-1,0
Sweden,2009,FIFA World Cup qualification,11,4,4,2,1,7,7,0
Sweden,2009,Friendly,6,6,3,3,0,6,0,0
Sweden,2010,Friendly,11,3,5,0,2,7,8,0
Sweden,2010,UEFA Euro qualification,9,4,2,1,0,3,5,0
Sweden,2011,Cyprus International Tournament,3,1,1,0,1,2,2,0
Sweden,2011,Friendly,3,4,2,2,0,4,-1,0
Sweden,2011,UEFA Euro qualification,22,7,6,1,0,7,15,0
Sweden,2012,FIFA World Cup qualification,8,5,2,0,1,3,3,0
Sweden,2012,Friendly,15,9,6,1,0,7,6,0
Sweden,2012,UEFA Euro,5,5,1,2,0,3,0,0
Sweden,2013,FIFA World Cup qualification,13,13,4,4,1,9,0,0
Sweden,2013,Friendly,7,5,2,1,1,4,2,0
Sweden,2013,King's Cup,4,1,1,0,1,2,3,0
Sweden,2014,Friendly,7,7,3,4,0,7,0,0
Sweden,2014,UEFA Euro qualification,5,3,1,0,3,4,2,0
Sweden,2015,Friendly,5,2,2,1,1,4,3,0
Sweden,2015,UEFA Euro qualification,14,9,5,2,1,8,5,0
Sweden,2016,FIFA World Cup qualification,6,3,2,1,1,4,3,0
Sweden,2016,Friendly,9,4,2,1,3,6,5,0
Sweden,2016,UEFA Euro,1,3,0,2,1,3,-2,0
Sweden,2017,FIFA World Cup qualification,21,6,5,2,1,8,15,0
Sweden,2017,Friendly,5,5,1,1,1,3,0,0
Sweden,2018,FIFA World Cup,6,4,3,2,0,5,2,0
Sweden,2018,Friendly,4,7,1,3,4,8,-3,0
Sweden,2018,UEFA Nations League,5,3,2,1,1,4,2,0
Sweden,2019,Friendly,2,3,0,1,1,2,-1,0
Sweden,2019,UEFA Euro qualification,23,9,6,1,3,10,14,0
Sweden,2020,Friendly,4,3,3,1,0,4,1,0
Sweden,2020,UEFA Nations League,5,13,1,5,0,6,-8,0
Sweden,2021,FIFA World Cup qualification,12,6,5,3,0,8,6,0
Sweden,2021,Friendly,8,2,4,0,0,4,6,0
Sweden,2021,UEFA Euro,5,4,2,1,1,4,1,0
Sweden,2022,FIFA World Cup qualification,1,2,1,1,0,2,-1,0
Sweden,2022,Friendly,4,1,2,0,0,2,3,0
Sweden,2022,UEFA Nations League,7,11,1,4,1,6,-4,0
Sweden,2023,Friendly,11,3,4,0,0,4,8,0
Sweden,2023,UEFA Euro qualification,14,12,3,4,1,8,2,0
Sweden,2024,Friendly,6,11,2,3,0,5,-5,0
Sweden,2024,UEFA Nations League,19,4,5,0,1,6,15,0
Sweden,2025,Friendly,5,2,1,1,0,2,3,0
Switzerland,1905,Friendly,0,1,0,1,0,1,-1,0
Switzerland,1908,Friendly,6,5,1,1,0,2,1,0
Switzerland,1909,Friendly,0,1,0,1,0,1,-1,0
Switzerland,1910,Friendly,2,3,0,1,0,1,-1,0
Switzerland,1911,Friendly,14,19,3,2,1,6,-5,0
Switzerland,1912,Friendly,4,15,0,3,0,3,-11,0
Switzerland,1913,Friendly,4,9,1,3,0,4,-5,0
Switzerland,1914,Friendly,3,4,0,1,2,3,-1,0
Switzerland,1915,Friendly,1,3,0,1,0,1,-2,0
Switzerland,1917,Friendly,3,3,1,1,0,2,0,1
Switzerland,1918,Friendly,2,7,0,2,0,2,-5,0
Switzerland,1920,Friendly,10,4,4,1,0,5,6,0
Switzerland,1921,Friendly,4,5,0,1,2,3,-1,0
Switzerland,1922,Friendly,11,12,1,1,3,5,-1,0
Switzerland,1923,Friendly,11,19,1,4,2,7,-8,0
Switzerland,1924,Friendly,10,3,3,0,1,4,7,0
Switzerland,1924,Olympic Games,15,6,4,1,1,6,9,0
Switzerland,1925,Friendly,6,15,2,4,1,7,-9,0
Switzerland,1926,Friendly,7,19,1,4,1,6,-12,0
Switzerland,1927,Friendly,4,12,0,3,1,4,-8,0
Switzerland,1928,Central European International Cup,5,11,0,4,0,4,-6,0
Switzerland,1928,Friendly,11,13,2,2,0,4,-2,0
Switzerland,1928,Olympic Games,0,4,0,1,0,1,-4,0
Switzerland,1929,Central European International Cup,6,17,0,4,0,4,-11,0
Switzerland,1929,Friendly,3,10,0,2,0,2,-7,0
Switzerland,1930,Friendly,13,21,1,4,2,7,-8,0
Switzerland,1931,Central European International Cup,7,22,0,3,1,4,-15,0
Switzerland,1931,Friendly,3,7,0,3,0,3,-4,0
Switzerland,1932,Central European International Cup,9,8,2,2,0,4,1,0
Switzerland,1932,Friendly,5,6,1,1,1,3,-1,0
Switzerland,1933,Central European International Cup,2,11,0,3,0,3,-9,0
Switzerland,1933,FIFA World Cup qualification,4,4,0,0,2,2,0,0
Switzerland,1933,Friendly,9,10,2,2,1,5,-1,0
Switzerland,1934,Central European International Cup,4,8,0,2,1,3,-4,0
Switzerland,1934,FIFA World Cup,5,5,1,1,0,2,0,0
Switzerland,1934,Friendly,3,4,1,1,0,2,-1,0
Switzerland,1935,Central European International Cup,7,5,1,1,0,2,2,0
Switzerland,1935,Friendly,8,13,3,2,1,6,-5,0
Switzerland,1936,Central European International Cup,3,7,0,2,0,2,-4,0
Switzerland,1936,Friendly,6,12,1,4,1,6,-6,0
Switzerland,1937,Central European International Cup,9,18,0,4,1,5,-9,0
Switzerland,1937,Friendly,4,7,1,4,0,5,-3,0
Switzerland,1938,Central European International Cup,4,0,1,0,0,1,4,1
Switzerland,1938,FIFA World Cup,5,5,1,1,1,3,0,0
Switzerland,1938,FIFA World Cup qualification,2,1,1,0,0,1,1,1
Switzerland,1938,Friendly,7,14,2,3,2,7,-7,0
Switzerland,1939,Friendly,15,7,5,0,1,6,8,0
Switzerland,1940,Friendly,1,9,0,3,1,4,-8,0
Switzerland,1941,Friendly,7,10,1,3,0,4,-3,0
Switzerland,1942,Friendly,10,13,3,3,0,6,-3,0
Switzerland,1943,Friendly,2,4,1,2,0,3,-2,0
Switzerland,1945,Friendly,12,5,4,0,1,5,7,0
Switzerland,1946,Friendly,7,17,1,4,0,5,-10,0
Switzerland,1947,Friendly,12,15,2,3,1,6,-3,0
Switzerland,1948,Central European International Cup,5,8,0,1,1,2,-3,0
Switzerland,1948,Friendly,7,13,2,2,1,5,-6,0
Switzerland,1949,Central European International Cup,1,2,0,1,0,1,-1,0
Switzerland,1949,FIFA World Cup qualification,8,4,2,0,0,2,4,0
Switzerland,1949,Friendly,6,7,1,2,0,3,-1,0
Switzerland,1950,Central European International Cup,3,3,0,0,1,1,0,0
Switzerland,1950,FIFA World Cup,4,6,1,1,1,3,-2,0
Switzerland,1950,Friendly,12,15,2,3,0,5,-3,0
Switzerland,1951,Central European International Cup,1,1,0,0,1,1,0,0
Switzerland,1951,Friendly,11,21,0,5,0,5,-10,0
Switzerland,1952,Central European International Cup,2,6,0,2,0,2,-4,0
Switzerland,1952,Friendly,7,10,1,2,1,4,-3,0
Switzerland,1953,Central European International Cup,0,5,0,1,0,1,-5,0
Switzerland,1953,Friendly,10,11,2,2,1,5,-1,0
Switzerland,1954,FIFA World Cup,11,11,2,2,0,4,0,0
Switzerland,1954,Friendly,10,13,1,2,2,5,-3,0
Switzerland,1955,Central European International Cup,6,8,0,2,1,3,-2,0
Switzerland,1955,Friendly,2,9,0,3,0,3,-7,0
Switzerland,1956,Central European International Cup,2,7,0,1,1,2,-5,0
Switzerland,1956,Friendly,10,7,2,1,2,5,3,0
Switzerland,1957,Central European International Cup,0,4,0,1,0,1,-4,0
Switzerland,1957,FIFA World Cup qualification,6,11,0,3,1,4,-5,0
Switzerland,1958,Central European International Cup,1,2,0,1,0,1,-1,0
Switzerland,1958,Friendly,2,7,0,3,1,4,-5,0
Switzerland,1959,Central European International Cup,1,13,0,2,0,2,-12,0
Switzerland,1959,Friendly,4,7,1,1,0,2,-3,0
Switzerland,1960,Central European International Cup,0,3,0,1,0,1,-3,0
Switzerland,1960,FIFA World Cup qualification,4,2,1,0,0,1,2,0
Switzerland,1960,Friendly,14,8,3,1,0,4,6,0
Switzerland,1961,FIFA World Cup qualification,7,8,3,1,0,4,-1,0
Switzerland,1962,FIFA World Cup,2,8,0,3,0,3,-6,0
Switzerland,1962,Friendly,2,8,0,2,0,2,-6,0
Switzerland,1962,UEFA Euro qualification,1,3,0,1,0,1,-2,0
Switzerland,1963,Friendly,3,13,0,3,1,4,-10,0
Switzerland,1963,UEFA Euro qualification,1,1,0,0,1,1,0,0
Switzerland,1964,FIFA World Cup qualification,2,2,1,1,0,2,0,0
Switzerland,1964,Friendly,7,11,1,4,0,5,-4,0
Switzerland,1965,FIFA World Cup qualification,5,1,3,0,1,4,4,0
Switzerland,1965,Friendly,0,1,0,1,1,2,-1,0
Switzerland,1966,FIFA World Cup,1,9,0,3,0,3,-8,0
Switzerland,1966,Friendly,4,7,0,2,2,4,-3,0
Switzerland,1966,UEFA Euro qualification,2,4,0,1,0,1,-2,0
Switzerland,1967,Friendly,5,7,1,2,1,4,-2,0
Switzerland,1967,UEFA Euro qualification,14,7,2,1,1,4,7,0
Switzerland,1968,FIFA World Cup qualification,1,2,1,1,0,2,-1,0
Switzerland,1968,Friendly,2,2,1,1,1,3,0,0
Switzerland,1968,UEFA Euro qualification,1,2,0,1,0,1,-1,0
Switzerland,1969,FIFA World Cup qualification,4,6,1,2,1,4,-2,0
Switzerland,1969,Friendly,0,4,0,2,0,2,-4,0
Switzerland,1970,Friendly,3,4,1,2,1,4,-1,0
Switzerland,1970,UEFA Euro qualification,3,1,2,0,0,2,2,1
Switzerland,1971,Friendly,6,4,1,1,0,2,2,0
Switzerland,1971,UEFA Euro qualification,9,4,2,1,1,4,5,0
Switzerland,1972,FIFA World Cup qualification,0,0,0,0,1,1,0,0
Switzerland,1972,Friendly,3,7,0,1,3,4,-4,0
Switzerland,1973,FIFA World Cup qualification,2,4,2,2,1,5,-2,0
Switzerland,1973,Friendly,1,0,1,0,0,1,1,0
Switzerland,1974,Friendly,4,5,1,4,1,6,-1,0
Switzerland,1974,UEFA Euro qualification,1,2,0,1,0,1,-1,0
Switzerland,1975,Friendly,2,3,0,1,1,2,-1,0
Switzerland,1975,UEFA Euro qualification,4,8,1,3,1,5,-4,0
Switzerland,1976,FIFA World Cup qualification,1,3,0,2,0,2,-2,0
Switzerland,1976,Friendly,5,9,1,4,1,6,-4,0
Switzerland,1977,FIFA World Cup qualification,2,2,1,1,0,2,0,0
Switzerland,1977,Friendly,5,11,2,4,1,7,-6,0
Switzerland,1978,Friendly,3,4,1,2,0,3,-1,0
Switzerland,1978,UEFA Euro qualification,1,5,0,2,0,2,-4,0
Switzerland,1979,Friendly,0,2,0,1,0,1,-2,0
Switzerland,1979,UEFA Euro qualification,6,13,2,4,0,6,-7,0
Switzerland,1980,FIFA World Cup qualification,2,4,0,2,0,2,-2,0
Switzerland,1980,Friendly,7,17,2,5,1,8,-10,0
Switzerland,1981,FIFA World Cup qualification,7,8,2,1,3,6,-1,0
Switzerland,1981,Friendly,3,1,2,0,0,2,2,0
Switzerland,1982,Friendly,12,8,5,1,2,8,4,0
Switzerland,1982,UEFA Euro qualification,2,3,1,1,0,2,-1,0
Switzerland,1983,Friendly,7,8,2,4,2,8,-1,0
Switzerland,1983,UEFA Euro qualification,5,6,1,1,2,4,-1,0
Switzerland,1984,FIFA World Cup qualification,2,0,2,0,0,2,2,0
Switzerland,1984,Friendly,2,11,0,3,3,6,-9,0
Switzerland,1985,FIFA World Cup qualification,3,10,0,2,4,6,-7,0
Switzerland,1985,Friendly,7,5,2,1,3,6,2,0
Switzerland,1986,Friendly,5,3,2,2,1,5,2,0
Switzerland,1986,UEFA Euro qualification,3,6,0,2,1,3,-3,0
Switzerland,1987,Friendly,6,4,2,1,1,4,2,0
Switzerland,1987,UEFA Euro qualification,6,3,1,0,4,5,3,0
Switzerland,1988,FIFA World Cup qualification,4,2,1,1,0,2,2,0
Switzerland,1988,Friendly,4,6,1,3,1,5,-2,0
Switzerland,1988,Tournoi de France,3,3,1,1,0,2,0,0
Switzerland,1989,FIFA World Cup qualification,6,12,1,4,1,6,-6,0
Switzerland,1989,Friendly,2,5,1,2,0,3,-3,0
Switzerland,1990,Friendly,8,9,3,2,1,6,-1,0
Switzerland,1990,UEFA Euro qualification,7,2,2,1,0,3,5,0
Switzerland,1991,Friendly,10,2,2,0,1,3,8,0
Switzerland,1991,Miami Cup,4,2,2,0,0,2,2,1
Switzerland,1991,UEFA Euro qualification,12,5,2,1,2,5,7,0
Switzerland,1992,FIFA World Cup qualification,14,3,3,0,1,4,11,0
Switzerland,1992,Friendly,3,5,1,2,0,3,-2,0
Switzerland,1993,FIFA World Cup qualification,9,3,3,1,2,6,6,0
Switzerland,1993,Friendly,4,2,2,0,1,3,2,0
Switzerland,1994,FIFA World Cup,5,7,1,2,1,4,-2,0
Switzerland,1994,Friendly,14,4,5,1,2,8,10,0
Switzerland,1994,UEFA Euro qualification,7,3,3,0,0,3,4,0
Switzerland,1995,Friendly,3,7,0,3,1,4,-4,0
Switzerland,1995,UEFA Euro qualification,8,4,2,1,2,5,4,0
Switzerland,1996,FIFA World Cup qualification,3,4,1,2,0,3,-1,0
Switzerland,1996,Friendly,4,4,1,2,1,4,0,0
Switzerland,1996,UEFA Euro,1,4,0,2,1,3,-3,0
Switzerland,1997,FIFA World Cup qualification,8,8,2,2,1,5,0,0
Switzerland,1997,Friendly,1,1,1,1,0,2,0,0
Switzerland,1997,Lunar New Year Cup,1,2,0,1,0,1,-1,0
Switzerland,1998,Friendly,3,6,0,2,3,5,-3,0
Switzerland,1998,UEFA Euro qualification,1,3,0,1,1,2,-2,0
Switzerland,1999,Friendly,7,9,2,2,1,5,-2,0
Switzerland,1999,UEFA Euro qualification,8,2,4,1,1,6,6,0
Switzerland,2000,FIFA World Cup qualification,7,4,1,1,1,3,3,0
Switzerland,2000,Friendly,10,8,1,1,4,6,2,0
Switzerland,2001,FIFA World Cup qualification,11,8,3,3,1,7,3,0
Switzerland,2001,Friendly,2,7,1,2,0,3,-5,0
Switzerland,2002,Cyprus International Tournament,3,2,1,0,1,2,1,0
Switzerland,2002,Friendly,5,6,1,1,1,3,-1,0
Switzerland,2002,UEFA Euro qualification,7,3,2,0,1,3,4,0
Switzerland,2003,Friendly,6,5,1,2,0,3,1,0
Switzerland,2003,UEFA Euro qualification,8,8,2,1,2,5,0,0
Switzerland,2004,FIFA World Cup qualification,9,3,1,0,2,3,6,0
Switzerland,2004,Friendly,4,6,2,3,1,6,-2,0
Switzerland,2004,UEFA Euro,1,6,0,2,1,3,-5,0
Switzerland,2005,FIFA World Cup qualification,13,8,4,1,4,9,5,0
Switzerland,2005,Friendly,4,1,2,0,0,2,3,0
Switzerland,2006,FIFA World Cup,4,0,2,0,2,4,4,0
Switzerland,2006,Friendly,17,8,5,2,2,9,9,0
Switzerland,2007,Friendly,15,16,4,5,1,10,-1,0
Switzerland,2008,FIFA World Cup qualification,7,6,2,1,1,4,1,0
Switzerland,2008,Friendly,11,7,4,2,0,6,4,0
Switzerland,2008,UEFA Euro,3,3,1,2,0,3,0,0
Switzerland,2009,FIFA World Cup qualification,11,2,4,0,2,6,9,0
Switzerland,2009,Friendly,1,2,0,1,2,3,-1,0
Switzerland,2010,FIFA World Cup,1,1,1,1,1,3,0,0
Switzerland,2010,Friendly,5,7,1,2,3,6,-2,0
Switzerland,2010,UEFA Euro qualification,5,5,1,2,0,3,0,0
Switzerland,2011,Friendly,3,1,2,0,2,4,2,0
Switzerland,2011,UEFA Euro qualification,7,5,2,1,2,5,2,0
Switzerland,2012,FIFA World Cup qualification,7,1,3,0,1,4,6,0
Switzerland,2012,Friendly,12,10,3,2,0,5,2,0
Switzerland,2013,FIFA World Cup qualification,10,5,4,0,2,6,5,0
Switzerland,2013,Friendly,2,2,1,1,1,3,0,0
Switzerland,2014,FIFA World Cup,7,7,2,2,0,4,0,0
Switzerland,2014,Friendly,7,4,2,0,2,4,3,0
Switzerland,2014,UEFA Euro qualification,8,3,2,2,0,4,5,0
Switzerland,2015,Friendly,8,5,2,1,1,4,3,0
Switzerland,2015,UEFA Euro qualification,16,5,5,1,0,6,11,0
Switzerland,2016,FIFA World Cup qualification,9,3,4,0,0,4,6,0
Switzerland,2016,Friendly,3,6,1,3,0,4,-3,0
Switzerland,2016,UEFA Euro,3,2,1,0,3,4,1,0
Switzerland,2017,FIFA World Cup qualification,15,4,6,1,1,8,11,0
Switzerland,2017,Friendly,1,0,1,0,0,1,1,0
Switzerland,2018,FIFA World Cup,5,5,1,1,2,4,0,0
Switzerland,2018,Friendly,10,3,3,2,1,6,7,0
Switzerland,2018,UEFA Nations League,14,5,3,1,0,4,9,0
Switzerland,2019,UEFA Euro qualification,19,6,5,1,2,8,13,0
Switzerland,2019,UEFA Nations League,1,3,0,1,1,2,-2,0
Switzerland,2020,Friendly,2,4,0,2,0,2,-2,0
Switzerland,2020,UEFA Nations League,9,8,1,2,3,6,1,0
Switzerland,2021,FIFA World Cup qualification,15,2,5,0,3,8,13,0
Switzerland,2021,Friendly,14,4,4,0,0,4,10,0
Switzerland,2021,UEFA Euro,8,9,1,1,3,5,-1,0
Switzerland,2022,FIFA World Cup,5,9,2,2,0,4,-4,0
Switzerland,2022,Friendly,2,5,0,2,1,3,-3,0
Switzerland,2022,UEFA Nations League,6,9,3,3,0,6,-3,0
Switzerland,2023,UEFA Euro qualification,22,11,4,1,5,10,11,0
Switzerland,2024,Friendly,6,1,2,0,2,4,5,0
Switzerland,2024,UEFA Euro,8,4,2,0,3,5,4,0
Switzerland,2024,UEFA Nations League,6,14,0,4,2,6,-8,0
Switzerland,2025,Friendly,4,2,1,0,1,2,2,1
Syria,1949,FIFA World Cup qualification,0,7,0,1,0,1,-7,0
Syria,1949,Friendly,0,8,0,1,0,1,-8,0
Syria,1957,FIFA World Cup qualification,1,2,0,1,1,2,-1,0
Syria,1963,Arab Cup,11,3,3,1,0,4,8,1
Syria,1966,Arab Cup,9,4,3,1,1,5,5,0
Syria,1966,Friendly,0,6,0,1,0,1,-6,0
Syria,1971,AFC Asian Cup qualification,4,5,0,1,2,3,-1,0
Syria,1971,Friendly,1,3,0,2,0,2,-2,0
Syria,1972,Palestine Cup,11,10,4,2,0,6,1,0
Syria,1973,FIFA World Cup qualification,6,6,3,2,1,6,0,0
Syria,1973,Palestine Cup,11,10,2,2,2,6,1,0
Syria,1974,Kuneitra Cup,9,1,2,0,1,3,8,0
Syria,1975,Palestine Cup,3,8,1,3,0,4,-5,0
Syria,1976,FIFA World Cup qualification,2,3,1,1,0,2,-1,0
Syria,1977,FIFA World Cup qualification,0,1,0,1,0,1,-1,0
Syria,1977,Friendly,0,2,0,1,0,1,-2,0
Syria,1978,Friendly,2,2,1,1,0,2,0,0
Syria,1978,Merdeka Tournament,7,20,0,7,0,7,-13,0
Syria,1980,AFC Asian Cup,3,2,2,1,1,4,1,0
Syria,1981,FIFA World Cup qualification,2,7,0,4,0,4,-5,0
Syria,1981,Friendly,0,3,0,1,0,1,-3,0
Syria,1982,Asian Games,3,5,0,1,2,3,-2,0
Syria,1983,Friendly,2,2,0,0,1,1,0,0
Syria,1983,Kirin Cup,0,1,0,1,0,1,-1,0
Syria,1984,AFC Asian Cup,3,5,1,2,1,4,-2,0
Syria,1984,AFC Asian Cup qualification,9,8,3,2,0,5,1,0
Syria,1984,Friendly,1,3,0,2,0,2,-2,0
Syria,1985,FIFA World Cup qualification,8,4,4,1,3,8,4,0
Syria,1985,Friendly,2,5,1,1,0,2,-3,0
Syria,1986,Merdeka Tournament,1,2,0,1,0,1,-1,0
Syria,1987,Friendly,2,3,0,1,1,2,-1,0
Syria,1987,Nehru Cup,0,1,0,1,0,1,-1,0
Syria,1988,AFC Asian Cup,2,5,2,2,0,4,-3,0
Syria,1988,AFC Asian Cup qualification,8,2,3,0,1,4,6,0
Syria,1988,Arab Cup,3,4,1,1,2,4,-1,0
Syria,1988,Friendly,0,2,0,1,0,1,-2,0
Syria,1989,FIFA World Cup qualification,7,5,2,1,1,4,2,0
Syria,1992,AFC Asian Cup qualification,2,4,0,1,0,1,-2,0
Syria,1992,Arab Cup,2,3,0,1,3,4,-1,0
Syria,1992,Friendly,0,2,0,1,2,3,-2,0
Syria,1993,FIFA World Cup qualification,14,4,3,0,3,6,10,0
Syria,1993,Friendly,2,3,0,1,1,2,-1,0
Syria,1995,Friendly,1,2,0,1,1,2,-1,0
Syria,1996,AFC Asian Cup,3,6,1,2,0,3,-3,0
Syria,1996,AFC Asian Cup qualification,6,2,3,1,0,4,4,0
Syria,1996,Friendly,7,14,1,5,2,8,-7,0
Syria,1997,FIFA World Cup qualification,27,5,2,2,1,5,22,0
Syria,1997,Friendly,1,4,0,1,1,2,-3,0
Syria,1998,Arab Cup,0,4,0,1,0,1,-4,0
Syria,1998,Arab Cup qualification,6,1,3,0,0,3,5,1
Syria,1998,Friendly,5,3,2,1,1,4,2,0
Syria,1998,United Arab Emirates Friendship Tournament,6,6,1,1,1,3,0,0
Syria,1999,Friendly,0,5,0,2,0,2,-5,0
Syria,2000,AFC Asian Cup qualification,11,3,4,1,1,6,8,0
Syria,2000,Friendly,8,10,3,3,4,10,-2,0
Syria,2000,WAFF Championship,5,2,2,2,1,5,3,0
Syria,2001,FIFA World Cup qualification,40,6,4,1,1,6,34,0
Syria,2001,Friendly,4,10,0,4,3,7,-6,0
Syria,2002,Arab Cup,8,6,2,2,0,4,2,0
Syria,2002,Friendly,1,4,0,2,0,2,-3,0
Syria,2002,Prime Minister's Cup,4,8,1,2,0,3,-4,0
Syria,2002,WAFF Championship,5,6,1,2,1,4,-1,0
Syria,2003,AFC Asian Cup qualification,16,7,2,2,1,5,9,0
Syria,2003,Friendly,9,4,1,1,2,4,5,0
Syria,2004,FIFA World Cup qualification,7,7,2,2,2,6,0,0
Syria,2004,Friendly,15,10,6,1,4,11,5,0
Syria,2004,WAFF Championship,6,13,1,2,1,4,-7,0
Syria,2005,Friendly,9,14,1,3,3,7,-5,0
Syria,2006,AFC Asian Cup qualification,6,4,1,1,2,4,2,0
Syria,2006,Friendly,10,16,2,5,2,9,-6,0
Syria,2007,FIFA World Cup qualification,16,2,4,0,0,4,14,0
Syria,2007,Friendly,1,2,0,1,0,1,-1,0
Syria,2007,Nehru Cup,14,5,4,1,0,5,9,0
Syria,2007,WAFF Championship,2,3,2,1,0,3,-1,0
Syria,2008,FIFA World Cup qualification,7,8,2,2,2,6,-1,0
Syria,2008,Friendly,12,16,3,4,3,10,-4,0
Syria,2008,WAFF Championship,2,3,1,1,1,3,-1,0
Syria,2009,AFC Asian Cup qualification,6,2,3,0,1,4,4,0
Syria,2009,Friendly,14,13,3,3,2,8,1,0
Syria,2009,Nehru Cup,9,1,4,0,1,5,8,0
Syria,2010,AFC Asian Cup qualification,4,0,1,0,1,2,4,0
Syria,2010,Friendly,13,11,3,5,2,10,2,0
Syria,2010,WAFF Championship,2,3,0,1,1,2,-1,0
Syria,2011,AFC Asian Cup,4,5,1,2,0,3,-1,0
Syria,2011,FIFA World Cup qualification,0,6,0,2,0,2,-6,0
Syria,2011,Friendly,10,8,3,1,2,6,2,0
Syria,2012,Friendly,3,4,0,1,2,3,-1,0
Syria,2012,Nehru Cup,6,6,1,2,1,4,0,0
Syria,2012,WAFF Championship,5,3,2,0,2,4,2,0
Syria,2013,AFC Asian Cup qualification,6,5,1,3,1,5,1,0
Syria,2013,Friendly,1,4,0,2,0,2,-3,0
Syria,2014,AFC Asian Cup qualification,1,2,0,1,0,1,-1,0
Syria,2014,Friendly,2,0,1,0,0,1,2,0
Syria,2015,FIFA World Cup qualification,20,6,5,1,0,6,14,0
Syria,2015,Friendly,9,7,3,1,1,5,2,0
Syria,2016,FIFA World Cup qualification,7,7,2,3,2,7,0,0
Syria,2016,Friendly,3,2,2,1,1,4,1,0
Syria,2016,King's Cup,3,2,1,0,1,2,1,0
Syria,2017,FIFA World Cup qualification,10,9,2,2,3,7,1,0
Syria,2017,Friendly,5,4,1,0,3,4,1,0
Syria,2017,Kirin Challenge Cup,1,1,0,0,1,1,0,0
Syria,2018,Friendly,10,10,3,2,4,9,0,0
Syria,2019,AFC Asian Cup,2,5,0,2,1,3,-3,0
Syria,2019,FIFA World Cup qualification,14,4,5,0,0,5,10,0
Syria,2019,Friendly,0,7,0,2,1,3,-7,0
Syria,2019,Intercontinental Cup,6,5,1,1,1,3,1,0
Syria,2019,WAFF Championship,5,7,0,2,2,4,-2,0
Syria,2020,Friendly,1,1,1,1,0,2,0,0
Syria,2021,Arab Cup,4,4,1,2,0,3,0,0
Syria,2021,FIFA World Cup qualification,13,14,2,5,2,9,-1,0
Syria,2021,Friendly,1,6,0,2,0,2,-5,0
Syria,2022,FIFA World Cup qualification,4,5,1,2,1,4,-1,0
Syria,2022,Friendly,3,7,1,5,0,6,-4,0
Syria,2022,Jordan International Tournament,0,3,0,2,0,2,-3,0
Syria,2023,FIFA World Cup qualification,1,5,1,1,0,2,-4,0
Syria,2023,Friendly,7,7,2,3,1,6,0,0
Syria,2024,AFC Asian Cup,2,2,1,1,2,4,0,0
Syria,2024,FIFA World Cup qualification,8,7,1,2,1,4,1,0
Syria,2024,Friendly,3,7,0,1,2,3,-4,0
Syria,2024,Intercontinental Cup,5,0,2,0,0,2,5,1
Syria,2025,AFC Asian Cup qualification,2,0,1,0,0,1,2,0
Székely Land,2014,Friendly,3,0,1,0,0,1,3,0
Székely Land,2015,CONIFA European Football Cup,5,10,0,3,0,3,-5,0
Székely Land,2016,CONIFA World Football Cup,7,11,1,3,0,4,-4,0
Székely Land,2016,Hungary Heritage Cup,1,3,0,1,0,1,-2,0
Székely Land,2017,CONIFA European Football Cup,9,7,2,2,1,5,2,0
Székely Land,2018,CONIFA World Football Cup,16,7,3,2,1,6,9,0
Székely Land,2019,CONIFA European Football Cup,5,16,0,4,1,5,-11,0
Székely Land,2023,CONIFA World Football Cup qualification,10,2,2,0,0,2,8,0
Sápmi,2006,Viva World Cup,45,1,4,0,0,4,44,0
Sápmi,2008,Viva World Cup,9,8,2,2,1,5,1,0
Sápmi,2009,Viva World Cup,12,12,1,2,1,4,0,0
Sápmi,2012,Friendly,2,3,0,1,0,1,-1,0
Sápmi,2014,CONIFA World Football Cup,6,10,1,3,0,4,-4,0
Sápmi,2016,CONIFA World Football Cup,10,4,3,2,0,5,6,0
Sápmi,2019,CONIFA European Football Cup,5,14,1,4,0,5,-9,0
Sápmi,2023,CONIFA World Football Cup qualification,1,2,0,1,0,1,-1,0
São Tomé and Príncipe,1976,Friendly,3,9,0,2,0,2,-6,0
São Tomé and Príncipe,1978,Friendly,3,3,0,0,1,1,0,0
São Tomé and Príncipe,1979,Friendly,1,2,0,1,0,1,-1,0
São Tomé and Príncipe,1981,Friendly,1,1,0,0,1,1,0,0
São Tomé and Príncipe,1985,Friendly,2,3,0,1,0,1,-1,0
São Tomé and Príncipe,1987,Friendly,1,3,0,1,1,2,-2,0
São Tomé and Príncipe,1998,African Cup of Nations qualification,0,6,0,2,0,2,-6,0
São Tomé and Príncipe,1999,UNIFFAC Cup,2,10,1,4,0,5,-8,1
São Tomé and Príncipe,2000,African Cup of Nations qualification,2,5,0,1,1,2,-3,0
São Tomé and Príncipe,2000,FIFA World Cup qualification,2,4,1,1,0,2,-2,0
São Tomé and Príncipe,2003,FIFA World Cup qualification,0,9,0,2,0,2,-9,0
São Tomé and Príncipe,2003,Friendly,1,3,0,1,0,1,-2,0
São Tomé and Príncipe,2011,FIFA World Cup qualification,1,6,0,1,1,2,-5,0
São Tomé and Príncipe,2012,African Cup of Nations qualification,5,5,2,1,1,4,0,0
São Tomé and Príncipe,2014,African Cup of Nations qualification,0,4,0,2,0,2,-4,0
São Tomé and Príncipe,2015,African Cup of Nations qualification,1,10,0,2,0,2,-9,0
São Tomé and Príncipe,2015,FIFA World Cup qualification,1,3,1,1,0,2,-2,0
São Tomé and Príncipe,2016,African Cup of Nations qualification,3,9,1,3,0,4,-6,0
São Tomé and Príncipe,2017,African Cup of Nations qualification,2,4,0,2,0,2,-2,0
São Tomé and Príncipe,2018,Friendly,1,3,0,1,0,1,-2,0
São Tomé and Príncipe,2019,African Cup of Nations qualification,5,7,2,2,0,4,-2,0
São Tomé and Príncipe,2019,FIFA World Cup qualification,1,3,0,2,0,2,-2,0
São Tomé and Príncipe,2020,African Cup of Nations qualification,2,6,0,2,0,2,-4,0
São Tomé and Príncipe,2021,African Cup of Nations qualification,1,5,0,2,0,2,-4,0
São Tomé and Príncipe,2022,African Cup of Nations qualification,4,21,0,3,1,4,-17,0
São Tomé and Príncipe,2023,African Cup of Nations qualification,2,11,0,3,1,4,-9,0
São Tomé and Príncipe,2023,FIFA World Cup qualification,0,6,0,2,0,2,-6,0
São Tomé and Príncipe,2024,African Cup of Nations qualification,1,1,0,0,2,2,0,0
São Tomé and Príncipe,2024,FIFA World Cup qualification,1,4,0,2,0,2,-3,0
São Tomé and Príncipe,2025,FIFA World Cup qualification,1,4,0,2,0,2,-3,0
Tahiti,1952,Friendly,5,7,0,1,1,2,-2,0
Tahiti,1953,Friendly,10,17,2,3,0,5,-7,0
Tahiti,1955,Friendly,1,1,0,0,1,1,0,0
Tahiti,1957,Friendly,7,7,2,2,0,4,0,0
Tahiti,1959,Friendly,5,5,1,1,0,2,0,0
Tahiti,1960,Friendly,2,7,0,2,0,2,-5,0
Tahiti,1961,Friendly,3,7,0,2,1,3,-4,0
Tahiti,1963,South Pacific Games,19,2,1,1,0,2,17,0
Tahiti,1964,Friendly,4,3,1,1,0,2,1,0
Tahiti,1965,Friendly,2,6,0,2,0,2,-4,0
Tahiti,1966,South Pacific Games,14,3,4,0,0,4,11,0
Tahiti,1968,Friendly,2,1,1,0,1,2,1,0
Tahiti,1969,South Pacific Games,16,6,3,1,1,5,10,0
Tahiti,1970,Friendly,3,3,1,1,0,2,0,0
Tahiti,1971,Friendly,5,2,1,0,0,1,3,0
Tahiti,1971,South Pacific Games,41,5,2,1,1,4,36,1
Tahiti,1973,Friendly,1,10,0,1,0,1,-9,0
Tahiti,1973,Oceania Nations Cup,8,4,3,1,1,5,4,0
Tahiti,1974,Friendly,5,5,1,1,1,3,0,0
Tahiti,1975,South Pacific Games,12,6,4,1,0,5,6,1
Tahiti,1978,Friendly,8,7,2,1,0,3,1,0
Tahiti,1979,South Pacific Games,33,2,5,0,0,5,31,1
Tahiti,1980,Friendly,2,2,1,1,1,3,0,0
Tahiti,1980,Oceania Nations Cup,23,9,3,1,0,4,14,0
Tahiti,1981,Friendly,3,1,2,0,0,2,2,0
Tahiti,1981,South Pacific Mini Games,31,2,6,0,1,7,29,1
Tahiti,1983,Friendly,12,3,2,0,1,3,9,0
Tahiti,1983,South Pacific Games,25,2,5,0,0,5,23,0
Tahiti,1985,Friendly,4,1,3,0,0,3,3,0
Tahiti,1987,Friendly,0,0,0,0,1,1,0,0
Tahiti,1987,South Pacific Games,9,4,3,1,1,5,5,0
Tahiti,1991,South Pacific Games,22,5,2,1,1,4,17,0
Tahiti,1992,FIFA World Cup qualification,5,8,1,2,1,4,-3,0
Tahiti,1992,Friendly,5,2,3,0,0,3,3,0
Tahiti,1993,Friendly,3,0,1,0,0,1,3,0
Tahiti,1993,South Pacific Mini Games,20,1,5,0,0,5,19,1
Tahiti,1994,Friendly,2,4,0,1,1,2,-2,0
Tahiti,1994,Oceania Nations Cup qualification,10,1,3,0,0,3,9,0
Tahiti,1995,Friendly,8,4,2,0,1,3,4,0
Tahiti,1995,Oceania Nations Cup,1,0,1,0,0,1,1,1
Tahiti,1995,South Pacific Games,35,2,6,0,0,6,33,1
Tahiti,1996,Oceania Nations Cup,2,12,1,2,0,3,-10,0
Tahiti,1997,FIFA World Cup qualification,2,12,0,3,1,4,-10,0
Tahiti,1998,Oceania Nations Cup,8,10,1,3,0,4,-2,0
Tahiti,1998,Oceania Nations Cup qualification,27,1,4,0,0,4,26,0
Tahiti,2000,Oceania Nations Cup,2,5,0,2,0,2,-3,0
Tahiti,2001,FIFA World Cup qualification,14,6,3,1,0,4,8,0
Tahiti,2002,Oceania Nations Cup,8,9,3,2,0,5,-1,0
Tahiti,2003,South Pacific Games,25,7,3,3,0,6,18,0
Tahiti,2004,FIFA World Cup qualification,5,1,2,0,2,4,4,0
Tahiti,2004,Oceania Nations Cup,2,24,1,3,1,5,-22,0
Tahiti,2007,South Pacific Games,2,6,1,2,1,4,-4,0
Tahiti,2008,Coupe de l'Outre-Mer,0,3,0,3,0,3,-3,0
Tahiti,2010,Coupe de l'Outre-Mer,3,6,0,1,2,3,-3,0
Tahiti,2011,Friendly,2,3,1,1,0,2,-1,0
Tahiti,2011,Pacific Games,28,9,3,2,1,6,19,1
Tahiti,2012,Coupe de l'Outre-Mer,6,7,2,2,0,4,-1,0
Tahiti,2012,FIFA World Cup qualification,0,11,0,4,0,4,-11,0
Tahiti,2012,Oceania Nations Cup,20,5,5,0,0,5,15,0
Tahiti,2013,Confederations Cup,1,24,0,3,0,3,-23,0
Tahiti,2013,FIFA World Cup qualification,2,1,1,1,0,2,1,0
Tahiti,2016,FIFA World Cup qualification,3,1,1,1,0,2,2,0
Tahiti,2016,Oceania Nations Cup,7,3,1,0,2,3,4,0
Tahiti,2017,FIFA World Cup qualification,4,3,1,1,0,2,1,0
Tahiti,2018,Friendly,4,3,1,0,1,2,1,0
Tahiti,2019,Friendly,1,3,0,1,1,2,-2,0
Tahiti,2019,Pacific Games,19,6,3,2,0,5,13,0
Tahiti,2022,FIFA World Cup qualification,1,4,0,2,0,2,-3,0
Tahiti,2023,Friendly,14,4,3,1,0,4,10,0
Tahiti,2023,Pacific Games,9,1,3,0,1,4,8,0
Tahiti,2024,FIFA World Cup qualification,5,3,2,1,0,3,2,0
Tahiti,2024,Oceania Nations Cup,5,8,2,2,1,5,-3,0
Tahiti,2025,FIFA World Cup qualification,0,3,0,1,0,1,-3,0
Taiwan,1950,Friendly,1,3,0,1,0,1,-2,0
Taiwan,1953,Friendly,4,2,1,0,0,1,2,0
Taiwan,1954,Asian Games,16,6,4,0,0,4,10,1
Taiwan,1954,Friendly,2,2,0,0,1,1,0,0
Taiwan,1956,AFC Asian Cup qualification,0,2,0,1,0,1,-2,0
Taiwan,1958,Asian Games,11,4,5,0,0,5,7,1
Taiwan,1958,Friendly,1,2,0,1,0,1,-1,0
Taiwan,1959,AFC Asian Cup qualification,7,4,1,0,0,1,3,0
Taiwan,1959,Friendly,3,1,1,0,0,1,2,0
Taiwan,1960,AFC Asian Cup,2,2,1,2,0,3,0,0
Taiwan,1962,Friendly,3,7,0,1,2,3,-4,0
Taiwan,1963,Friendly,7,0,1,0,0,1,7,0
Taiwan,1963,Merdeka Tournament,9,5,3,0,2,5,4,1
Taiwan,1964,Friendly,4,6,0,1,0,1,-2,0
Taiwan,1964,Merdeka Tournament,10,7,2,1,1,4,3,0
Taiwan,1965,Friendly,1,3,0,1,0,1,-2,0
Taiwan,1965,Merdeka Tournament,11,11,2,2,1,5,0,0
Taiwan,1966,Asian Games,5,8,0,2,1,3,-3,0
Taiwan,1966,Merdeka Tournament,5,14,1,4,0,5,-9,0
Taiwan,1967,Merdeka Tournament,12,11,2,2,2,6,1,0
Taiwan,1968,AFC Asian Cup,3,10,0,2,2,4,-7,0
Taiwan,1968,Merdeka Tournament,6,15,1,3,0,4,-9,0
Taiwan,1970,Merdeka Tournament,8,11,2,3,1,6,-3,0
Taiwan,1971,Korea Cup,0,2,0,1,0,1,-2,0
Taiwan,1971,Merdeka Tournament,7,3,2,1,1,4,4,0
Taiwan,1974,Vietnam Independence Cup,3,2,1,0,2,3,1,0
Taiwan,1977,FIFA World Cup qualification,1,17,0,4,0,4,-16,0
Taiwan,1979,Friendly,3,0,1,0,0,1,3,0
Taiwan,1981,FIFA World Cup qualification,5,8,1,4,1,6,-3,0
Taiwan,1983,Friendly,2,0,1,0,0,1,2,0
Taiwan,1985,FIFA World Cup qualification,1,36,0,6,0,6,-35,0
Taiwan,1988,FIFA World Cup qualification,1,8,0,2,0,2,-7,0
Taiwan,1992,AFC Asian Cup qualification,0,8,0,2,1,3,-8,0
Taiwan,1993,FIFA World Cup qualification,3,31,0,6,0,6,-28,0
Taiwan,1996,AFC Asian Cup qualification,1,8,0,2,0,2,-7,0
Taiwan,1997,FIFA World Cup qualification,4,13,1,4,0,5,-9,0
Taiwan,2000,AFC Asian Cup qualification,3,8,1,3,0,4,-5,0
Taiwan,2000,Friendly,0,4,0,2,0,2,-4,0
Taiwan,2001,FIFA World Cup qualification,0,25,0,6,0,6,-25,0
Taiwan,2002,Friendly,2,5,0,1,0,1,-3,0
Taiwan,2002,SKN Football Festival,0,3,0,1,0,1,-3,0
Taiwan,2003,AFC Asian Cup qualification,1,2,0,1,0,1,-1,0
Taiwan,2003,EAFF Championship,9,3,2,1,0,3,6,0
Taiwan,2003,FIFA World Cup qualification,6,1,2,0,0,2,5,0
Taiwan,2004,FIFA World Cup qualification,3,26,0,6,0,6,-23,0
Taiwan,2006,AFC Asian Cup qualification,0,15,0,3,0,3,-15,0
Taiwan,2006,AFC Challenge Cup,2,5,0,1,1,2,-3,0
Taiwan,2006,Friendly,1,10,1,1,0,2,-9,0
Taiwan,2007,EAFF Championship,11,1,1,0,1,2,10,0
Taiwan,2007,FIFA World Cup qualification,0,11,0,2,0,2,-11,0
Taiwan,2008,AFC Challenge Cup qualification,6,3,1,0,1,2,3,0
Taiwan,2008,Friendly,2,5,0,1,1,2,-3,0
Taiwan,2009,AFC Challenge Cup qualification,1,1,0,0,1,1,0,0
Taiwan,2010,Friendly,0,2,0,1,0,1,-2,0
Taiwan,2011,AFC Challenge Cup qualification,1,4,0,1,1,2,-3,0
Taiwan,2011,FIFA World Cup qualification,4,4,1,1,0,2,0,0
Taiwan,2011,Friendly,2,3,0,1,0,1,-1,0
Taiwan,2012,EAFF Championship,0,10,0,2,0,2,-10,0
Taiwan,2012,Friendly,2,8,0,2,0,2,-6,0
Taiwan,2013,AFC Challenge Cup qualification,1,2,0,1,0,1,-1,0
Taiwan,2013,Friendly,2,1,1,0,0,1,1,0
Taiwan,2014,Friendly,4,12,0,2,0,2,-8,0
Taiwan,2015,FIFA World Cup qualification,6,16,1,6,0,7,-10,0
Taiwan,2016,AFC Asian Cup qualification,2,3,1,1,0,2,-1,0
Taiwan,2016,EAFF Championship,4,6,1,2,0,3,-2,0
Taiwan,2016,FIFA World Cup qualification,1,4,0,1,0,1,-3,0
Taiwan,2017,AFC Asian Cup qualification,5,9,2,2,0,4,-4,0
Taiwan,2017,Friendly,13,4,4,0,1,5,9,0
Taiwan,2018,AFC Asian Cup qualification,1,0,1,0,0,1,1,0
Taiwan,2018,EAFF Championship,3,5,1,2,0,3,-2,0
Taiwan,2018,Friendly,2,0,1,0,0,1,2,0
Taiwan,2018,Intercontinental Cup,0,10,0,3,0,3,-10,0
Taiwan,2019,FIFA World Cup qualification,2,25,0,5,0,5,-23,0
Taiwan,2019,Friendly,6,2,2,1,2,5,4,0
Taiwan,2021,AFC Asian Cup qualification,1,5,0,2,0,2,-4,0
Taiwan,2021,FIFA World Cup qualification,2,9,0,3,0,3,-7,0
Taiwan,2022,Friendly,1,0,1,0,0,1,1,0
Taiwan,2023,FIFA World Cup qualification,7,4,2,2,0,4,3,0
Taiwan,2023,Friendly,7,8,1,1,2,4,-1,0
Taiwan,2024,EAFF Championship qualification,5,2,1,1,0,2,3,0
Taiwan,2024,FIFA World Cup qualification,2,13,0,4,0,4,-11,0
Taiwan,2024,Friendly,5,5,1,1,0,2,0,0
Taiwan,2025,AFC Asian Cup qualification,1,2,0,1,0,1,-1,0
Tajikistan,1992,Friendly,5,5,0,0,2,2,0,0
Tajikistan,1993,Friendly,1,10,0,3,1,4,-9,0
Tajikistan,1994,Friendly,2,4,1,2,1,4,-2,0
Tajikistan,1996,AFC Asian Cup qualification,4,5,1,1,0,2,-1,0
Tajikistan,1997,FIFA World Cup qualification,15,2,4,1,1,6,13,0
Tajikistan,1997,Friendly,1,4,0,1,0,1,-3,0
Tajikistan,1998,Asian Games,8,13,1,3,1,5,-5,0
Tajikistan,1999,AFC Asian Cup qualification,6,5,2,1,0,3,1,0
Tajikistan,2000,FIFA World Cup qualification,16,2,1,1,0,2,14,0
Tajikistan,2003,AFC Asian Cup qualification,3,5,2,2,2,6,-2,0
Tajikistan,2003,FIFA World Cup qualification,4,0,2,0,0,2,4,0
Tajikistan,2004,FIFA World Cup qualification,5,9,2,3,1,6,-4,0
Tajikistan,2004,Friendly,0,3,0,1,0,1,-3,0
Tajikistan,2005,Friendly,4,3,1,1,0,2,1,0
Tajikistan,2006,AFC Challenge Cup,18,2,5,1,0,6,16,1
Tajikistan,2006,ELF Cup,5,7,1,2,0,3,-2,0
Tajikistan,2006,Friendly,1,6,0,2,0,2,-5,0
Tajikistan,2007,FIFA World Cup qualification,7,4,1,1,2,4,3,0
Tajikistan,2007,Friendly,5,8,0,2,1,3,-3,0
Tajikistan,2008,AFC Challenge Cup,7,5,2,1,2,5,2,0
Tajikistan,2008,AFC Challenge Cup qualification,7,1,2,0,1,3,6,0
Tajikistan,2008,Friendly,0,5,0,1,0,1,-5,0
Tajikistan,2009,Friendly,1,2,0,1,0,1,-1,0
Tajikistan,2010,AFC Challenge Cup,8,5,3,2,0,5,3,1
Tajikistan,2010,Friendly,2,4,2,1,0,3,-2,0
Tajikistan,2011,AFC Challenge Cup qualification,4,0,2,0,1,3,4,0
Tajikistan,2011,FIFA World Cup qualification,6,17,2,5,0,7,-11,0
Tajikistan,2011,Friendly,4,2,1,0,1,2,2,0
Tajikistan,2012,AFC Challenge Cup,3,4,1,2,0,3,-1,0
Tajikistan,2012,FIFA World Cup qualification,1,1,0,0,1,1,0,0
Tajikistan,2012,Friendly,3,7,1,1,0,2,-4,0
Tajikistan,2013,AFC Challenge Cup qualification,4,1,2,1,0,3,3,0
Tajikistan,2013,Friendly,10,3,3,0,0,3,7,0
Tajikistan,2014,Friendly,7,11,1,3,0,4,-4,0
Tajikistan,2015,FIFA World Cup qualification,9,12,1,3,2,6,-3,0
Tajikistan,2015,Friendly,4,3,1,1,0,2,1,0
Tajikistan,2016,AFC Asian Cup qualification,6,0,2,0,0,2,6,0
Tajikistan,2016,FIFA World Cup qualification,0,8,0,2,0,2,-8,0
Tajikistan,2016,Friendly,8,4,2,0,3,5,4,0
Tajikistan,2017,AFC Asian Cup qualification,9,7,2,2,1,5,2,0
Tajikistan,2017,Friendly,1,1,0,0,1,1,0,0
Tajikistan,2018,AFC Asian Cup qualification,1,2,0,1,0,1,-1,0
Tajikistan,2018,Friendly,1,8,0,3,0,3,-7,0
Tajikistan,2019,FIFA World Cup qualification,6,8,2,2,1,5,-2,0
Tajikistan,2019,Friendly,1,3,0,2,1,3,-2,0
Tajikistan,2019,Intercontinental Cup,6,4,2,2,0,4,2,0
Tajikistan,2020,Friendly,2,4,0,2,0,2,-2,0
Tajikistan,2021,FIFA World Cup qualification,8,4,2,1,0,3,4,0
Tajikistan,2021,Friendly,3,5,1,2,2,5,-2,0
Tajikistan,2022,AFC Asian Cup qualification,5,0,2,0,1,3,5,0
Tajikistan,2022,Friendly,0,1,0,1,1,2,-1,0
Tajikistan,2022,King's Cup,2,1,1,0,1,2,1,0
Tajikistan,2022,Navruz Cup,2,1,1,0,1,2,1,0
Tajikistan,2023,CAFA Nations Cup,3,7,0,1,2,3,-4,0
Tajikistan,2023,FIFA World Cup qualification,7,2,1,0,1,2,5,0
Tajikistan,2023,Friendly,3,2,1,1,1,3,1,0
Tajikistan,2024,AFC Asian Cup,3,4,1,2,2,5,-1,0
Tajikistan,2024,FIFA World Cup qualification,4,5,1,2,1,4,-1,0
Tajikistan,2024,Friendly,9,2,3,0,0,3,7,0
Tajikistan,2024,Merdeka Tournament,0,1,0,1,1,2,-1,0
Tajikistan,2025,AFC Asian Cup qualification,1,0,1,0,0,1,1,0
Tajikistan,2025,Friendly,0,5,0,1,0,1,-5,0
Tamil Eelam,2012,Viva World Cup,4,11,1,3,0,4,-7,1
Tamil Eelam,2013,Tynwald Hill Tournament,10,8,2,1,0,3,2,0
Tamil Eelam,2014,CONIFA World Football Cup,12,15,1,3,0,4,-3,0
Tamil Eelam,2016,ConIFA Challenger Cup,4,1,1,0,0,1,3,1
Tamil Eelam,2016,World Unity Cup,10,1,2,0,0,2,9,1
Tamil Eelam,2017,Friendly,5,0,1,0,0,1,5,0
Tamil Eelam,2018,CONIFA World Football Cup,4,22,1,5,0,6,-18,0
Tamil Eelam,2023,CONIFA Asia Cup,9,2,3,0,0,3,7,1
Tanzania,1945,Friendly,0,14,0,2,0,2,-14,0
Tanzania,1946,Friendly,0,3,0,1,0,1,-3,0
Tanzania,1947,Friendly,5,5,1,1,0,2,0,0
Tanzania,1948,Friendly,0,6,0,1,0,1,-6,0
Tanzania,1949,Friendly,2,0,1,0,0,1,2,0
Tanzania,1950,Friendly,7,2,2,0,1,3,5,0
Tanzania,1951,Friendly,4,2,2,0,0,2,2,0
Tanzania,1952,Friendly,1,7,0,2,0,2,-6,0
Tanzania,1953,Friendly,1,7,0,1,0,1,-6,0
Tanzania,1954,Friendly,3,5,0,1,0,1,-2,0
Tanzania,1955,Friendly,1,5,0,1,0,1,-4,0
Tanzania,1956,Friendly,2,12,0,2,0,2,-10,0
Tanzania,1957,Friendly,5,7,0,1,1,2,-2,0
Tanzania,1958,Friendly,4,7,1,2,0,3,-3,0
Tanzania,1959,Friendly,4,6,0,1,2,3,-2,0
Tanzania,1960,Friendly,4,8,1,2,0,3,-4,0
Tanzania,1961,Friendly,7,4,2,1,1,4,3,0
Tanzania,1962,Friendly,20,13,3,2,0,5,7,0
Tanzania,1963,Friendly,6,19,1,4,1,6,-13,0
Tanzania,1964,Friendly,7,4,3,1,0,4,3,0
Tanzania,1965,Friendly,8,5,2,1,1,4,3,0
Tanzania,1966,Friendly,10,16,1,3,0,4,-6,0
Tanzania,1967,African Cup of Nations qualification,2,3,1,2,1,4,-1,0
Tanzania,1967,Friendly,10,23,1,6,2,9,-13,0
Tanzania,1968,Friendly,8,14,1,3,1,5,-6,0
Tanzania,1969,African Cup of Nations qualification,3,10,1,2,1,4,-7,0
Tanzania,1969,Friendly,7,8,2,3,0,5,-1,0
Tanzania,1970,African Cup of Nations qualification,2,6,0,1,1,2,-4,0
Tanzania,1970,Friendly,6,6,2,1,1,4,0,0
Tanzania,1971,Friendly,15,14,2,3,4,9,1,0
Tanzania,1972,FIFA World Cup qualification,1,4,0,1,2,3,-3,0
Tanzania,1972,Friendly,10,8,2,2,3,7,2,0
Tanzania,1973,African Cup of Nations qualification,6,4,1,1,2,4,2,0
Tanzania,1973,All-African Games,3,7,0,3,0,3,-4,0
Tanzania,1973,CECAFA Cup,4,3,2,1,0,3,1,0
Tanzania,1973,Friendly,3,11,1,1,0,2,-8,0
Tanzania,1974,CECAFA Cup,1,1,0,0,1,1,0,0
Tanzania,1974,Friendly,6,12,0,2,2,4,-6,0
Tanzania,1975,CECAFA Cup,7,6,1,2,0,3,1,0
Tanzania,1975,Friendly,8,6,2,2,1,5,2,0
Tanzania,1976,CECAFA Cup,2,2,0,0,2,2,0,0
Tanzania,1976,Friendly,2,3,0,1,1,2,-1,0
Tanzania,1977,CECAFA Cup,2,4,0,1,1,2,-2,0
Tanzania,1977,Friendly,2,2,1,1,1,3,0,0
Tanzania,1978,Friendly,1,0,1,0,1,2,1,0
Tanzania,1979,African Cup of Nations qualification,8,4,2,1,1,4,4,0
Tanzania,1979,CECAFA Cup,10,11,2,1,3,6,-1,0
Tanzania,1979,Friendly,5,7,2,3,0,5,-2,0
Tanzania,1980,African Cup of Nations,3,6,0,2,1,3,-3,0
Tanzania,1980,CECAFA Cup,3,2,2,1,1,4,1,0
Tanzania,1980,FIFA World Cup qualification,7,6,1,2,1,4,1,0
Tanzania,1980,Friendly,4,5,1,2,2,5,-1,0
Tanzania,1981,CECAFA Cup,8,5,3,1,1,5,3,0
Tanzania,1981,Friendly,5,8,2,2,1,5,-3,0
Tanzania,1982,African Cup of Nations qualification,3,4,0,1,1,2,-1,0
Tanzania,1982,CECAFA Cup,0,6,0,3,0,3,-6,0
Tanzania,1982,Friendly,3,2,2,1,1,4,1,0
Tanzania,1983,CECAFA Cup,2,3,0,1,3,4,-1,0
Tanzania,1983,Friendly,2,1,1,0,2,3,1,0
Tanzania,1984,African Cup of Nations qualification,3,2,1,1,0,2,1,0
Tanzania,1984,CECAFA Cup,4,5,0,1,2,3,-1,0
Tanzania,1984,FIFA World Cup qualification,1,1,0,0,2,2,0,0
Tanzania,1984,Friendly,1,1,0,0,1,1,0,0
Tanzania,1985,CECAFA Cup,2,4,0,2,0,2,-2,0
Tanzania,1985,Friendly,0,2,0,1,2,3,-2,0
Tanzania,1986,African Cup of Nations qualification,2,4,0,1,0,1,-2,0
Tanzania,1986,Friendly,0,1,0,1,0,1,-1,0
Tanzania,1987,African Cup of Nations qualification,1,2,0,1,1,2,-1,0
Tanzania,1987,CECAFA Cup,2,5,0,2,1,3,-3,0
Tanzania,1988,African Cup of Nations qualification,2,2,0,0,2,2,0,0
Tanzania,1988,CECAFA Cup,0,3,0,2,1,3,-3,0
Tanzania,1988,Friendly,1,1,0,0,1,1,0,0
Tanzania,1989,CECAFA Cup,2,10,0,3,0,3,-8,0
Tanzania,1990,African Cup of Nations qualification,0,2,0,1,1,2,-2,0
Tanzania,1990,CECAFA Cup,4,2,2,1,1,4,2,0
Tanzania,1990,Friendly,6,9,1,2,6,9,-3,0
Tanzania,1991,African Cup of Nations qualification,4,5,1,2,1,4,-1,0
Tanzania,1991,CECAFA Cup,1,6,0,1,1,2,-5,0
Tanzania,1991,Friendly,2,3,0,1,1,2,-1,0
Tanzania,1992,CECAFA Cup,4,5,1,2,1,4,-1,0
Tanzania,1992,FIFA World Cup qualification,2,2,1,1,1,3,0,0
Tanzania,1993,FIFA World Cup qualification,1,3,0,1,0,1,-2,0
Tanzania,1993,Friendly,3,7,1,3,0,4,-4,0
Tanzania,1994,African Cup of Nations qualification,7,5,2,1,0,3,2,0
Tanzania,1994,CECAFA Cup,9,0,4,0,0,4,9,0
Tanzania,1994,Friendly,2,2,0,0,1,1,0,0
Tanzania,1995,African Cup of Nations qualification,7,10,2,5,0,7,-3,0
Tanzania,1995,CECAFA Cup,9,2,1,0,1,2,7,0
Tanzania,1996,African Cup of Nations qualification,1,2,0,1,0,1,-1,0
Tanzania,1996,CECAFA Cup,2,4,0,2,0,2,-2,0
Tanzania,1996,FIFA World Cup qualification,1,2,0,1,1,2,-1,0
Tanzania,1996,Friendly,5,9,0,4,4,8,-4,0
Tanzania,1997,African Cup of Nations qualification,4,5,1,2,2,5,-1,0
Tanzania,1997,COSAFA Cup,4,7,0,1,3,4,-3,0
Tanzania,1997,Friendly,4,7,1,3,1,5,-3,0
Tanzania,1998,African Cup of Nations qualification,0,2,0,2,0,2,-2,0
Tanzania,1998,Friendly,2,15,0,3,1,4,-13,0
Tanzania,1999,CECAFA Cup,2,2,1,1,1,3,0,0
Tanzania,2000,African Cup of Nations qualification,2,4,0,2,0,2,-2,0
Tanzania,2000,FIFA World Cup qualification,2,4,0,2,0,2,-2,0
Tanzania,2000,Friendly,6,7,2,1,1,4,-1,0
Tanzania,2001,CECAFA Cup,7,2,3,0,0,3,5,0
Tanzania,2001,Friendly,5,3,1,0,1,2,2,0
Tanzania,2002,African Cup of Nations qualification,1,6,0,2,0,2,-5,0
Tanzania,2002,CECAFA Cup,10,5,3,1,2,6,5,0
Tanzania,2002,Friendly,2,11,0,4,2,6,-9,0
Tanzania,2003,African Cup of Nations qualification,0,7,0,4,0,4,-7,0
Tanzania,2003,FIFA World Cup qualification,0,3,0,1,1,2,-3,0
Tanzania,2003,Friendly,1,7,0,3,1,4,-6,0
Tanzania,2004,CECAFA Cup,3,13,0,4,0,4,-10,0
Tanzania,2005,CECAFA Cup,5,5,2,1,1,4,0,0
Tanzania,2005,Friendly,2,0,2,0,0,2,2,0
Tanzania,2006,African Cup of Nations qualification,2,1,1,0,1,2,1,0
Tanzania,2006,CECAFA Cup,8,4,3,1,0,4,4,0
Tanzania,2006,Friendly,10,6,4,1,3,8,4,0
Tanzania,2007,African Cup of Nations qualification,2,6,1,2,1,4,-4,0
Tanzania,2007,CECAFA Cup,4,3,2,1,1,4,1,0
Tanzania,2007,Friendly,4,2,2,0,2,4,2,0
Tanzania,2008,FIFA World Cup qualification,9,6,2,2,2,6,3,0
Tanzania,2008,Friendly,4,4,1,1,2,4,0,0
Tanzania,2009,CECAFA Cup,16,13,6,6,0,12,3,0
Tanzania,2009,Friendly,7,12,2,3,2,7,-5,0
Tanzania,2010,African Cup of Nations qualification,1,2,0,1,1,2,-1,0
Tanzania,2010,CECAFA Cup,4,1,2,1,1,4,3,0
Tanzania,2010,Friendly,5,10,1,3,1,5,-5,0
Tanzania,2011,African Cup of Nations qualification,5,7,1,2,1,4,-2,0
Tanzania,2011,CECAFA Cup,6,7,2,4,0,6,-1,0
Tanzania,2011,FIFA World Cup qualification,2,2,1,1,0,2,0,0
Tanzania,2011,Friendly,1,3,1,2,0,3,-2,0
Tanzania,2011,Nile Basin Tournament,3,9,0,2,2,4,-6,0
Tanzania,2012,African Cup of Nations qualification,2,2,0,0,2,2,0,0
Tanzania,2012,CECAFA Cup,12,5,3,2,1,6,7,0
Tanzania,2012,FIFA World Cup qualification,2,3,1,1,0,2,-1,0
Tanzania,2012,Friendly,5,3,2,0,3,5,2,0
Tanzania,2013,CECAFA Cup,6,5,2,1,3,6,1,0
Tanzania,2013,FIFA World Cup qualification,6,9,1,3,0,4,-3,0
Tanzania,2013,Friendly,2,2,1,1,2,4,0,0
Tanzania,2014,African Cup of Nations qualification,6,6,1,1,2,4,0,0
Tanzania,2014,Friendly,7,8,2,2,2,6,-1,0
Tanzania,2015,African Cup of Nations qualification,0,3,0,1,1,2,-3,0
Tanzania,2015,CECAFA Cup,8,3,2,0,2,4,5,0
Tanzania,2015,COSAFA Cup,0,4,0,3,0,3,-4,0
Tanzania,2015,FIFA World Cup qualification,4,10,1,2,1,4,-6,0
Tanzania,2015,Friendly,2,5,0,2,1,3,-3,0
Tanzania,2016,African Cup of Nations qualification,0,3,0,2,0,2,-3,0
Tanzania,2016,Friendly,1,4,0,1,1,2,-3,0
Tanzania,2017,African Cup of Nations qualification,1,1,0,0,1,1,0,0
Tanzania,2017,CECAFA Cup,2,5,0,3,1,4,-3,0
Tanzania,2017,COSAFA Cup,6,5,2,1,3,6,1,0
Tanzania,2017,Friendly,6,3,2,0,2,4,3,0
Tanzania,2018,African Cup of Nations qualification,2,4,1,2,1,4,-2,0
Tanzania,2018,Friendly,3,4,1,1,0,2,-1,0
Tanzania,2019,African Cup of Nations,2,8,0,3,0,3,-6,0
Tanzania,2019,African Cup of Nations qualification,6,3,2,1,0,3,3,0
Tanzania,2019,FIFA World Cup qualification,2,2,0,0,2,2,0,0
Tanzania,2019,Friendly,1,2,0,1,2,3,-1,0
Tanzania,2020,African Cup of Nations qualification,1,2,0,1,1,2,-1,0
Tanzania,2020,Friendly,0,1,0,1,0,1,-1,0
Tanzania,2021,African Cup of Nations qualification,1,1,1,1,0,2,0,0
Tanzania,2021,FIFA World Cup qualification,6,8,2,2,2,6,-2,0
Tanzania,2021,Friendly,3,4,1,2,0,3,-1,0
Tanzania,2022,African Cup of Nations qualification,1,3,0,1,1,2,-2,0
Tanzania,2022,Friendly,6,4,2,1,1,4,2,0
Tanzania,2023,African Cup of Nations qualification,2,1,2,1,1,4,1,0
Tanzania,2023,FIFA World Cup qualification,1,2,1,1,0,2,-1,0
Tanzania,2023,Friendly,1,1,0,0,1,1,0,0
Tanzania,2024,African Cup of Nations,1,4,0,1,2,3,-3,0
Tanzania,2024,African Cup of Nations qualification,2,4,1,2,1,4,-2,0
Tanzania,2024,FIFA Series,3,1,1,1,0,2,2,0
Tanzania,2024,FIFA World Cup qualification,1,0,1,0,0,1,1,0
Tanzania,2024,Friendly,0,2,0,1,1,2,-2,0
Tanzania,2025,FIFA World Cup qualification,0,2,0,1,0,1,-2,0
Tanzania,2025,Mapinduzi Cup,0,5,0,3,0,3,-5,0
Thailand,1954,Friendly,1,7,0,1,0,1,-6,0
Thailand,1956,Friendly,2,5,0,2,0,2,-3,0
Thailand,1957,Merdeka Tournament,5,15,1,3,0,4,-10,0
Thailand,1959,Southeast Asian Peninsular Games,9,10,2,2,0,4,-1,0
Thailand,1960,Merdeka Tournament,3,18,0,3,0,3,-15,0
Thailand,1961,Friendly,1,2,0,1,0,1,-1,0
Thailand,1961,Merdeka Tournament,5,9,0,3,0,3,-4,0
Thailand,1961,Southeast Asian Peninsular Games,8,5,1,0,3,4,3,0
Thailand,1962,Asian Games,4,10,0,3,0,3,-6,0
Thailand,1962,Friendly,5,2,1,1,0,2,3,0
Thailand,1962,Vietnam Independence Cup,3,11,1,2,0,3,-8,0
Thailand,1963,AFC Asian Cup qualification,4,9,0,2,1,3,-5,0
Thailand,1963,Merdeka Tournament,8,16,0,3,2,5,-8,0
Thailand,1964,Merdeka Tournament,3,6,1,2,1,4,-3,0
Thailand,1965,Friendly,0,7,0,1,0,1,-7,0
Thailand,1965,Merdeka Tournament,7,7,1,1,3,5,0,0
Thailand,1965,Southeast Asian Peninsular Games,6,3,2,0,1,3,3,0
Thailand,1965,Vietnam Independence Cup,0,4,0,1,0,1,-4,0
Thailand,1966,Asian Games,5,8,1,2,1,4,-3,0
Thailand,1966,Merdeka Tournament,4,9,0,3,2,5,-5,0
Thailand,1966,Vietnam Independence Cup,2,5,0,1,1,2,-3,0
Thailand,1967,AFC Asian Cup qualification,0,1,0,1,0,1,-1,0
Thailand,1967,Merdeka Tournament,4,11,0,4,1,5,-7,0
Thailand,1967,Southeast Asian Peninsular Games,9,8,2,2,0,4,1,0
Thailand,1967,Vietnam Independence Cup,8,7,1,2,0,3,1,0
Thailand,1968,Friendly,2,13,0,2,0,2,-11,0
Thailand,1968,King's Cup,13,2,4,1,0,5,11,0
Thailand,1968,Merdeka Tournament,5,9,1,3,2,6,-4,0
Thailand,1969,King's Cup,5,6,0,1,2,3,-1,0
Thailand,1969,Merdeka Tournament,2,10,1,4,0,5,-8,0
Thailand,1969,Southeast Asian Peninsular Games,4,4,1,1,1,3,0,0
Thailand,1970,Asian Games,6,7,1,2,2,5,-1,0
Thailand,1970,King's Cup,8,4,4,1,1,6,4,0
Thailand,1970,Merdeka Tournament,10,12,2,2,2,6,-2,0
Thailand,1970,Vietnam Independence Cup,6,3,2,1,0,3,3,0
Thailand,1971,AFC Asian Cup qualification,16,4,3,1,1,5,12,0
Thailand,1971,Friendly,5,8,2,2,0,4,-3,0
Thailand,1971,Indonesia Tournament,2,3,2,1,1,4,-1,0
Thailand,1971,King's Cup,3,2,2,2,0,4,1,0
Thailand,1971,Korea Cup,5,8,1,2,0,3,-3,0
Thailand,1971,Merdeka Tournament,5,11,1,3,0,4,-6,0
Thailand,1971,Southeast Asian Peninsular Games,7,8,1,2,2,5,-1,0
Thailand,1971,Vietnam Independence Cup,2,6,1,2,0,3,-4,0
Thailand,1972,AFC Asian Cup,6,9,0,2,3,5,-3,0
Thailand,1972,Indonesia Tournament,0,3,0,2,0,2,-3,0
Thailand,1972,King's Cup,8,3,3,2,0,5,5,0
Thailand,1972,Korea Cup,5,5,1,1,2,4,0,0
Thailand,1972,Merdeka Tournament,10,7,2,2,1,5,3,1
Thailand,1973,FIFA World Cup qualification,0,13,0,4,0,4,-13,0
Thailand,1973,King's Cup,11,2,4,1,0,5,9,1
Thailand,1973,Korea Cup,3,7,0,1,1,2,-4,0
Thailand,1973,Merdeka Tournament,10,7,2,1,3,6,3,0
Thailand,1973,Southeast Asian Peninsular Games,1,2,0,1,1,2,-1,0
Thailand,1974,Asian Games,2,4,0,2,0,2,-2,0
Thailand,1974,King's Cup,14,8,4,2,0,6,6,0
Thailand,1974,Korea Cup,1,2,0,1,0,1,-1,0
Thailand,1974,Merdeka Tournament,7,10,1,3,1,5,-3,0
Thailand,1974,Vietnam Independence Cup,4,5,0,1,1,2,-1,0
Thailand,1975,AFC Asian Cup qualification,8,2,3,1,0,4,6,0
Thailand,1975,Friendly,3,3,0,0,2,2,0,0
Thailand,1975,Indonesia Tournament,0,6,0,2,0,2,-6,0
Thailand,1975,King's Cup,3,2,2,1,0,3,1,0
Thailand,1975,Korea Cup,1,4,0,1,0,1,-3,0
Thailand,1975,Merdeka Tournament,2,18,0,6,1,7,-16,0
Thailand,1975,Southeast Asian Peninsular Games,5,4,1,0,2,3,1,1
Thailand,1976,King's Cup,9,2,2,0,2,4,7,0
Thailand,1976,Korea Cup,1,5,0,2,0,2,-4,0
Thailand,1976,Merdeka Tournament,10,7,2,2,2,6,3,0
Thailand,1977,FIFA World Cup qualification,8,12,1,3,0,4,-4,0
Thailand,1977,Friendly,5,8,0,1,1,2,-3,0
Thailand,1977,King's Cup,4,3,1,1,1,3,1,0
Thailand,1977,Korea Cup,6,6,1,1,1,3,0,0
Thailand,1977,Merdeka Tournament,4,15,0,3,2,5,-11,0
Thailand,1977,Southeast Asian Games,4,5,2,2,0,4,-1,0
Thailand,1978,Asian Games,6,12,2,3,0,5,-6,0
Thailand,1978,Indonesia Tournament,7,6,1,1,2,4,1,0
Thailand,1978,King's Cup,2,2,0,0,1,1,0,0
Thailand,1978,Kirin Cup,0,3,0,1,0,1,-3,0
Thailand,1978,Korea Cup,2,0,1,0,0,1,2,0
Thailand,1978,Merdeka Tournament,8,12,3,4,0,7,-4,0
Thailand,1979,AFC Asian Cup qualification,0,1,0,1,0,1,-1,0
Thailand,1979,King's Cup,8,1,2,0,0,2,7,0
Thailand,1979,Korea Cup,2,0,1,0,0,1,2,0
Thailand,1979,Merdeka Tournament,4,11,0,4,1,5,-7,0
Thailand,1979,Southeast Asian Games,6,4,2,1,2,5,2,0
Thailand,1980,Friendly,0,1,0,1,0,1,-1,0
Thailand,1980,Korea Cup,6,7,2,2,0,4,-1,0
Thailand,1980,Merdeka Tournament,8,7,2,1,4,7,1,0
Thailand,1981,FIFA World Cup qualification,3,13,0,2,1,3,-10,0
Thailand,1981,King's Cup,5,1,3,0,0,3,4,0
Thailand,1981,Korea Cup,5,3,2,1,0,3,2,0
Thailand,1981,Merdeka Tournament,5,9,1,1,1,3,-4,0
Thailand,1981,Southeast Asian Games,9,7,2,0,2,4,2,1
Thailand,1982,Asian Games,3,5,1,2,0,3,-2,0
Thailand,1982,Friendly,1,2,0,1,1,2,-1,0
Thailand,1982,King's Cup,4,6,1,1,3,5,-2,0
Thailand,1982,Korea Cup,1,1,0,0,1,1,0,0
Thailand,1982,Merdeka Tournament,1,6,0,2,1,3,-5,0
Thailand,1983,Great Wall Cup,2,3,0,1,1,2,-1,0
Thailand,1983,Korea Cup,3,4,1,1,1,3,-1,0
Thailand,1983,Merdeka Tournament,1,2,0,1,0,1,-1,0
Thailand,1983,Southeast Asian Games,10,4,3,1,1,5,6,1
Thailand,1984,AFC Asian Cup qualification,9,10,3,2,0,5,-1,0
Thailand,1984,Friendly,4,3,1,1,0,2,1,0
Thailand,1985,FIFA World Cup qualification,4,4,1,3,2,6,0,0
Thailand,1985,Friendly,1,2,0,1,0,1,-1,0
Thailand,1985,Indonesia Tournament,2,1,1,0,0,1,1,1
Thailand,1985,Korea Cup,2,3,0,1,0,1,-1,0
Thailand,1985,Southeast Asian Games,17,1,3,0,1,4,16,1
Thailand,1986,Asian Games,8,4,1,2,1,4,4,0
Thailand,1986,Friendly,0,4,0,1,0,1,-4,0
Thailand,1986,King's Cup,1,1,0,0,1,1,0,0
Thailand,1986,Merdeka Tournament,1,5,0,2,0,2,-4,0
Thailand,1987,King's Cup,2,0,1,0,0,1,2,0
Thailand,1987,Korea Cup,3,6,0,2,1,3,-3,0
Thailand,1987,Southeast Asian Games,3,3,1,1,1,3,0,0
Thailand,1988,AFC Asian Cup qualification,5,12,1,2,2,5,-7,0
Thailand,1988,Indonesia Tournament,0,1,0,1,0,1,-1,0
Thailand,1988,King's Cup,6,4,1,0,1,2,2,0
Thailand,1988,Merdeka Tournament,0,0,0,0,2,2,0,0
Thailand,1989,FIFA World Cup qualification,2,14,1,5,0,6,-12,0
Thailand,1989,King's Cup,6,0,3,0,0,3,6,1
Thailand,1989,Southeast Asian Games,5,3,1,1,2,4,2,0
Thailand,1990,Asian Games,5,3,3,2,1,6,2,0
Thailand,1990,King's Cup,3,2,1,0,1,2,1,0
Thailand,1991,Kirin Cup,0,1,0,1,0,1,-1,0
Thailand,1991,Southeast Asian Games,10,2,2,0,2,4,8,0
Thailand,1992,AFC Asian Cup,1,5,0,1,2,3,-4,0
Thailand,1992,AFC Asian Cup qualification,3,1,2,0,0,2,2,1
Thailand,1993,FIFA World Cup qualification,13,7,4,4,0,8,6,0
Thailand,1993,Friendly,0,7,0,2,0,2,-7,0
Thailand,1993,King's Cup,1,4,1,1,0,2,-3,0
Thailand,1993,Merdeka Tournament,2,2,0,0,2,2,0,0
Thailand,1993,Southeast Asian Games,18,6,6,0,0,6,12,1
Thailand,1994,Asian Games,8,12,0,3,1,4,-4,0
Thailand,1994,Friendly,3,3,0,0,2,2,0,0
Thailand,1995,King's Cup,3,2,1,0,0,1,1,1
Thailand,1995,Nehru Cup,6,4,1,2,0,3,2,0
Thailand,1995,Southeast Asian Games,19,2,5,0,1,6,17,1
Thailand,1996,AFC Asian Cup,2,13,0,3,0,3,-11,0
Thailand,1996,AFC Asian Cup qualification,31,5,4,0,2,6,26,0
Thailand,1996,AFF Championship,18,3,5,0,1,6,15,0
Thailand,1996,Friendly,4,5,1,1,0,2,-1,0
Thailand,1996,King's Cup,6,2,2,0,0,2,4,1
Thailand,1997,FIFA World Cup qualification,5,6,1,2,1,4,-1,0
Thailand,1997,Friendly,6,2,2,0,1,3,4,0
Thailand,1997,King's Cup,2,4,0,1,2,3,-2,0
Thailand,1997,Southeast Asian Games,15,3,4,0,2,6,12,0
Thailand,1998,AFF Championship,10,10,2,1,2,5,0,0
Thailand,1998,Asian Games,12,10,4,3,1,8,2,0
Thailand,1998,Friendly,9,7,2,1,1,4,2,0
Thailand,1998,King's Cup,1,3,0,1,1,2,-2,0
Thailand,1999,Four Nations' Cup,2,2,0,0,1,1,0,0
Thailand,1999,Friendly,1,0,1,0,0,1,1,0
Thailand,1999,King's Cup,2,2,0,0,1,1,0,0
Thailand,1999,Southeast Asian Games,24,1,5,0,1,6,23,1
Thailand,2000,AFC Asian Cup,2,4,0,1,2,3,-2,0
Thailand,2000,AFC Asian Cup qualification,13,8,4,1,1,6,5,0
Thailand,2000,AFF Championship,15,3,5,0,0,5,12,0
Thailand,2000,Friendly,13,15,2,4,1,7,-2,0
Thailand,2000,King's Cup,7,9,2,1,1,4,-2,1
Thailand,2001,FIFA World Cup qualification,25,20,5,4,5,14,5,0
Thailand,2001,Friendly,16,6,4,0,1,5,10,0
Thailand,2001,King's Cup,5,12,1,3,0,4,-7,0
Thailand,2002,AFF Championship,13,7,2,1,2,5,6,0
Thailand,2002,Friendly,2,1,1,0,0,1,1,0
Thailand,2002,King's Cup,5,1,2,1,1,4,4,0
Thailand,2003,AFC Asian Cup qualification,10,7,3,3,0,6,3,0
Thailand,2003,Friendly,2,0,1,0,0,1,2,0
Thailand,2003,King's Cup,7,8,1,1,2,4,-1,0
Thailand,2004,AFC Asian Cup,1,9,0,3,0,3,-8,0
Thailand,2004,AFF Championship,13,4,2,1,1,4,9,0
Thailand,2004,FIFA World Cup qualification,9,10,2,3,1,6,-1,0
Thailand,2004,Friendly,7,14,1,4,1,6,-7,0
Thailand,2004,King's Cup,1,1,0,0,2,2,0,0
Thailand,2005,King's Cup,1,3,0,1,1,2,-2,0
Thailand,2006,Friendly,9,3,2,0,1,3,6,0
Thailand,2006,King's Cup,9,4,3,0,1,4,5,1
Thailand,2007,AFC Asian Cup,3,5,1,1,1,3,-2,0
Thailand,2007,AFF Championship,10,4,3,1,3,7,6,0
Thailand,2007,FIFA World Cup qualification,15,3,3,0,1,4,12,0
Thailand,2007,Friendly,6,5,2,1,2,5,1,0
Thailand,2007,King's Cup,4,2,2,0,0,2,2,1
Thailand,2008,AFF Championship,14,3,4,1,1,6,11,0
Thailand,2008,FIFA World Cup qualification,5,14,0,5,1,6,-9,0
Thailand,2008,Friendly,12,5,2,1,1,4,7,0
Thailand,2008,VFF Cup,3,2,1,0,1,2,1,0
Thailand,2009,AFC Asian Cup qualification,3,2,1,1,2,4,1,0
Thailand,2009,Friendly,8,4,2,1,1,4,4,0
Thailand,2009,King's Cup,2,1,1,0,0,1,1,0
Thailand,2010,AFC Asian Cup qualification,0,1,0,1,1,2,-1,0
Thailand,2010,AFF Championship,3,4,0,1,2,3,-1,0
Thailand,2010,Friendly,4,5,3,1,0,4,-1,0
Thailand,2010,King's Cup,2,3,1,1,0,2,-1,0
Thailand,2011,FIFA World Cup qualification,7,8,2,3,2,7,-1,0
Thailand,2011,Friendly,2,1,1,0,3,4,1,0
Thailand,2012,AFF Championship,14,6,5,1,1,7,8,1
Thailand,2012,FIFA World Cup qualification,0,2,0,1,0,1,-2,0
Thailand,2012,Friendly,17,1,5,0,0,5,16,0
Thailand,2012,King's Cup,0,1,0,1,0,1,-1,0
Thailand,2013,AFC Asian Cup qualification,5,16,0,5,0,5,-11,0
Thailand,2013,Friendly,6,2,2,1,0,3,4,0
Thailand,2013,King's Cup,3,5,0,1,1,2,-2,0
Thailand,2014,AFC Asian Cup qualification,2,5,0,1,0,1,-3,0
Thailand,2014,AFF Championship,14,6,5,1,1,7,8,0
Thailand,2014,Friendly,6,4,2,1,1,4,2,0
Thailand,2015,FIFA World Cup qualification,12,4,4,0,1,5,8,0
Thailand,2015,Friendly,8,5,3,2,1,6,3,0
Thailand,2016,AFF Championship,15,4,6,1,0,7,11,1
Thailand,2016,FIFA World Cup qualification,5,14,0,4,2,6,-9,0
Thailand,2016,Friendly,0,1,0,1,0,1,-1,0
Thailand,2016,King's Cup,4,2,1,0,1,2,2,1
Thailand,2017,FIFA World Cup qualification,3,12,0,4,1,5,-9,0
Thailand,2017,Friendly,4,3,2,1,0,3,1,0
Thailand,2017,King's Cup,3,0,1,0,1,2,3,0
Thailand,2018,AFF Championship,17,5,3,0,3,6,12,0
Thailand,2018,Friendly,4,5,2,2,1,5,-1,0
Thailand,2019,AFC Asian Cup,4,7,1,2,1,4,-3,0
Thailand,2019,FIFA World Cup qualification,6,3,2,1,2,5,3,0
Thailand,2019,Friendly,1,3,0,1,1,2,-2,0
Thailand,2021,AFF Championship,16,1,6,0,1,7,15,1
Thailand,2021,FIFA World Cup qualification,3,6,0,2,1,3,-3,0
Thailand,2021,Friendly,2,3,0,1,1,2,-1,0
Thailand,2022,AFC Asian Cup qualification,5,2,2,1,0,3,3,0
Thailand,2022,AFF Championship,12,3,2,0,2,4,9,0
Thailand,2022,Friendly,14,4,5,2,0,7,10,0
Thailand,2022,King's Cup,3,2,1,0,1,2,1,1
Thailand,2023,AFF Championship,9,4,3,1,1,5,5,1
Thailand,2023,FIFA World Cup qualification,4,3,1,1,0,2,1,0
Thailand,2023,Friendly,5,16,1,3,2,6,-11,0
Thailand,2023,King's Cup,4,3,1,0,1,2,1,0
Thailand,2024,AFC Asian Cup,3,2,1,1,2,4,1,0
Thailand,2024,ASEAN Championship,22,7,5,1,0,6,15,1
Thailand,2024,FIFA World Cup qualification,5,6,1,1,2,4,-1,0
Thailand,2024,Friendly,3,7,1,1,2,4,-4,0
Thailand,2025,AFC Asian Cup qualification,1,0,1,0,0,1,1,0
Thailand,2025,ASEAN Championship,3,5,0,2,0,2,-2,0
Thailand,2025,Friendly,2,0,1,0,0,1,2,0
Tibet,2001,Friendly,2,6,0,2,0,2,-4,0
Tibet,2006,ELF Cup,0,14,0,3,0,3,-14,0
Tibet,2006,FIFI Wild Cup,0,12,0,2,0,2,-12,0
Tibet,2007,Friendly,0,3,0,1,0,1,-3,0
Tibet,2018,CONIFA World Football Cup,4,20,0,4,1,5,-16,0
Tibet,2022,Friendly,3,3,0,0,1,1,0,0
Tibet,2023,CONIFA Asia Cup,5,8,0,2,0,2,-3,0
Ticino,2023,CONIFA World Football Cup qualification,1,8,0,1,0,1,-7,0
Ticino,2023,Friendly,1,5,0,1,0,1,-4,0
Timor-Leste,2003,AFC Asian Cup qualification,2,3,0,1,0,1,-1,0
Timor-Leste,2004,AFF Championship,2,18,0,4,0,4,-16,0
Timor-Leste,2006,AFF Championship qualification,5,17,0,4,0,4,-12,0
Timor-Leste,2007,FIFA World Cup qualification,3,11,0,2,0,2,-8,0
Timor-Leste,2008,AFF Championship qualification,4,9,0,3,1,4,-5,0
Timor-Leste,2010,AFF Championship qualification,3,15,0,3,0,3,-12,0
Timor-Leste,2010,Friendly,0,6,0,1,0,1,-6,0
Timor-Leste,2011,FIFA World Cup qualification,1,7,0,2,0,2,-6,0
Timor-Leste,2012,AFF Championship qualification,10,6,2,2,0,4,4,0
Timor-Leste,2012,Friendly,0,1,0,1,0,1,-1,0
Timor-Leste,2014,AFF Championship qualification,6,7,1,2,1,4,-1,0
Timor-Leste,2015,FIFA World Cup qualification,0,43,0,9,0,9,-43,0
Timor-Leste,2016,AFC Asian Cup qualification,1,8,0,3,0,3,-7,0
Timor-Leste,2016,AFC Challenge Cup,0,4,0,1,1,2,-4,0
Timor-Leste,2016,AFF Championship qualification,4,7,0,3,0,3,-3,0
Timor-Leste,2016,FIFA World Cup qualification,0,7,0,1,0,1,-7,0
Timor-Leste,2016,Friendly,0,2,0,1,0,1,-2,0
Timor-Leste,2017,Friendly,3,5,1,2,0,3,-2,0
Timor-Leste,2018,AFF Championship,4,19,0,4,0,4,-15,0
Timor-Leste,2018,AFF Championship qualification,3,2,1,1,0,2,1,0
Timor-Leste,2018,Friendly,2,2,0,0,1,1,0,0
Timor-Leste,2019,FIFA World Cup qualification,2,12,0,2,0,2,-10,0
Timor-Leste,2021,AFF Championship,0,13,0,4,0,4,-13,0
Timor-Leste,2022,AFF Championship qualification,3,6,1,1,0,2,-3,1
Timor-Leste,2022,Friendly,2,9,0,3,0,3,-7,0
Timor-Leste,2023,FIFA World Cup qualification,0,7,0,2,0,2,-7,0
Timor-Leste,2024,AFC Asian Cup qualification,4,3,1,1,0,2,1,0
Timor-Leste,2024,ASEAN Championship,3,18,0,4,0,4,-15,0
Timor-Leste,2024,ASEAN Championship qualification,1,0,1,0,1,2,1,0
Timor-Leste,2025,AFC Asian Cup qualification,0,1,0,1,0,1,-1,0
Timor-Leste,2025,Friendly,0,4,0,1,0,1,-4,0
Togo,1956,Friendly,2,2,0,0,2,2,0,0
Togo,1958,Friendly,2,5,0,1,0,1,-3,0
Togo,1960,Friendly,3,4,0,1,1,2,-1,0
Togo,1962,Friendly,2,1,1,0,0,1,1,0
Togo,1963,Friendly,1,2,0,1,0,1,-1,0
Togo,1965,All-African Games,7,14,2,2,1,5,-7,0
Togo,1965,Friendly,0,3,0,1,0,1,-3,0
Togo,1966,Friendly,10,16,1,3,4,8,-6,0
Togo,1967,African Cup of Nations qualification,3,9,1,3,0,4,-6,0
Togo,1967,Friendly,2,4,0,1,0,1,-2,0
Togo,1968,Friendly,1,1,0,0,1,1,0,0
Togo,1969,African Cup of Nations qualification,1,5,0,1,1,2,-4,0
Togo,1970,African Cup of Nations qualification,2,1,1,0,1,2,1,0
Togo,1970,Friendly,3,0,1,0,0,1,3,0
Togo,1971,African Cup of Nations qualification,1,0,1,0,1,2,1,0
Togo,1971,Friendly,3,3,2,1,0,3,0,0
Togo,1972,African Cup of Nations,4,6,0,1,2,3,-2,0
Togo,1972,FIFA World Cup qualification,0,4,0,1,1,2,-4,0
Togo,1972,Friendly,6,2,1,0,1,2,4,0
Togo,1974,African Cup of Nations qualification,3,0,2,0,0,2,3,0
Togo,1974,Friendly,2,6,0,2,0,2,-4,0
Togo,1975,African Cup of Nations qualification,6,7,1,2,1,4,-1,0
Togo,1975,Friendly,3,1,1,1,0,2,2,0
Togo,1976,FIFA World Cup qualification,2,1,1,0,1,2,1,0
Togo,1976,Friendly,0,4,0,1,0,1,-4,0
Togo,1977,African Cup of Nations qualification,1,3,0,2,0,2,-2,0
Togo,1977,FIFA World Cup qualification,1,4,0,2,0,2,-3,0
Togo,1977,Friendly,0,4,0,2,0,2,-4,0
Togo,1979,African Cup of Nations qualification,4,9,2,2,0,4,-5,0
Togo,1979,Friendly,14,14,5,2,2,9,0,0
Togo,1980,FIFA World Cup qualification,2,2,1,1,0,2,0,0
Togo,1980,Friendly,2,6,1,2,0,3,-4,0
Togo,1981,African Cup of Nations qualification,2,6,0,1,1,2,-4,0
Togo,1981,Friendly,2,3,1,1,0,2,-1,0
Togo,1982,African Cup of Nations qualification,4,0,2,0,0,2,4,1
Togo,1982,Friendly,4,3,1,0,1,2,1,0
Togo,1982,West African Cup,5,4,2,1,1,4,1,0
Togo,1983,African Cup of Nations qualification,7,2,3,1,0,4,5,0
Togo,1983,Friendly,15,9,4,4,0,8,6,0
Togo,1983,West African Cup,6,7,1,2,1,4,-1,0
Togo,1984,African Cup of Nations,1,7,0,2,1,3,-6,0
Togo,1984,Friendly,3,2,1,0,1,2,1,0
Togo,1984,West African Cup,7,5,1,0,4,5,2,0
Togo,1985,African Cup of Nations qualification,1,2,0,1,1,2,-1,0
Togo,1985,Friendly,3,4,1,1,0,2,-1,0
Togo,1986,Friendly,3,4,0,1,2,3,-1,0
Togo,1986,West African Cup,8,7,3,2,1,6,1,0
Togo,1987,African Cup of Nations qualification,1,3,0,1,1,2,-2,0
Togo,1987,Friendly,2,3,2,1,0,3,-1,0
Togo,1988,Friendly,1,3,0,2,0,2,-2,0
Togo,1990,African Cup of Nations qualification,1,7,0,3,1,4,-6,0
Togo,1990,Friendly,1,1,0,0,2,2,0,0
Togo,1991,African Cup of Nations qualification,3,2,2,1,1,4,1,0
Togo,1992,FIFA World Cup qualification,1,5,0,2,0,2,-4,0
Togo,1992,Friendly,1,1,1,1,0,2,0,0
Togo,1993,FIFA World Cup qualification,1,6,0,3,0,3,-5,0
Togo,1994,African Cup of Nations qualification,3,2,1,1,1,3,1,0
Togo,1994,Friendly,6,5,1,1,2,4,1,0
Togo,1995,African Cup of Nations qualification,2,8,0,3,2,5,-6,0
Togo,1995,Friendly,3,0,1,0,1,2,3,0
Togo,1996,African Cup of Nations qualification,3,1,2,0,1,3,2,0
Togo,1996,FIFA World Cup qualification,5,6,1,1,1,3,-1,0
Togo,1996,Friendly,5,2,2,1,0,3,3,0
Togo,1997,African Cup of Nations qualification,7,4,2,2,1,5,3,0
Togo,1997,FIFA World Cup qualification,4,10,1,3,1,5,-6,0
Togo,1997,Friendly,10,16,2,4,2,8,-6,0
Togo,1998,African Cup of Nations,4,6,1,2,0,3,-2,0
Togo,1998,African Cup of Nations qualification,8,0,3,0,0,3,8,0
Togo,1998,Friendly,4,11,1,5,1,7,-7,0
Togo,1999,African Cup of Nations qualification,4,6,0,2,1,3,-2,0
Togo,1999,Friendly,6,14,0,6,2,8,-8,0
Togo,2000,African Cup of Nations,2,3,1,1,1,3,-1,0
Togo,2000,African Cup of Nations qualification,5,2,2,1,1,4,3,0
Togo,2000,FIFA World Cup qualification,3,2,1,1,1,3,1,0
Togo,2000,Friendly,4,10,2,2,0,4,-6,0
Togo,2001,African Cup of Nations qualification,4,0,2,0,0,2,4,0
Togo,2001,FIFA World Cup qualification,10,11,2,2,3,7,-1,0
Togo,2001,Friendly,5,4,2,1,2,5,1,0
Togo,2002,African Cup of Nations,0,3,0,1,2,3,-3,0
Togo,2002,African Cup of Nations qualification,1,3,1,1,0,2,-2,0
Togo,2002,Friendly,0,4,0,1,0,1,-4,0
Togo,2003,African Cup of Nations qualification,8,4,2,1,1,4,4,0
Togo,2003,FIFA World Cup qualification,2,1,1,1,0,2,1,0
Togo,2003,Friendly,3,1,1,0,0,1,2,0
Togo,2004,FIFA World Cup qualification,6,2,3,1,1,5,4,0
Togo,2004,Friendly,2,1,1,0,2,3,1,0
Togo,2005,FIFA World Cup qualification,14,6,4,0,1,5,8,0
Togo,2005,Friendly,4,6,2,2,0,4,-2,0
Togo,2006,African Cup of Nations,2,7,0,3,0,3,-5,0
Togo,2006,African Cup of Nations qualification,2,2,1,1,0,2,0,0
Togo,2006,FIFA World Cup,1,6,0,3,0,3,-5,0
Togo,2006,Friendly,3,5,2,3,2,7,-2,0
Togo,2007,African Cup of Nations qualification,5,7,2,2,0,4,-2,0
Togo,2007,Friendly,10,5,2,1,1,4,5,0
Togo,2008,FIFA World Cup qualification,8,3,2,2,0,4,5,0
Togo,2008,Friendly,2,4,1,2,0,3,-2,0
Togo,2009,FIFA World Cup qualification,3,7,2,2,2,6,-4,0
Togo,2009,Friendly,2,13,0,3,1,4,-11,0
Togo,2010,African Cup of Nations qualification,5,7,0,2,3,5,-2,0
Togo,2010,Corsica Cup,1,5,0,2,0,2,-4,0
Togo,2010,Friendly,0,4,0,2,0,2,-4,0
Togo,2011,African Cup of Nations qualification,1,3,1,2,0,3,-2,0
Togo,2011,FIFA World Cup qualification,2,1,1,0,1,2,1,0
Togo,2011,Friendly,4,7,0,1,1,2,-3,0
Togo,2012,African Cup of Nations qualification,5,4,2,1,1,4,1,0
Togo,2012,FIFA World Cup qualification,1,3,0,1,1,2,-2,0
Togo,2012,Friendly,2,6,2,2,0,4,-4,0
Togo,2013,African Cup of Nations,4,4,1,2,1,4,0,0
Togo,2013,FIFA World Cup qualification,3,8,1,3,0,4,-5,0
Togo,2013,Friendly,3,4,1,1,0,2,-1,0
Togo,2014,African Cup of Nations qualification,7,12,2,4,0,6,-5,0
Togo,2015,African Cup of Nations qualification,4,1,2,0,0,2,3,0
Togo,2015,FIFA World Cup qualification,0,4,0,2,0,2,-4,0
Togo,2015,Friendly,1,2,0,1,1,2,-1,0
Togo,2016,African Cup of Nations qualification,7,3,1,1,2,4,4,0
Togo,2016,Friendly,7,4,3,1,1,5,3,0
Togo,2017,African Cup of Nations,2,6,0,2,1,3,-4,0
Togo,2017,African Cup of Nations qualification,0,1,0,1,0,1,-1,0
Togo,2017,Friendly,10,9,3,4,1,8,1,0
Togo,2018,African Cup of Nations qualification,3,5,1,1,2,4,-2,0
Togo,2018,Friendly,2,2,0,0,2,2,0,0
Togo,2019,African Cup of Nations qualification,2,4,0,2,1,3,-2,0
Togo,2019,FIFA World Cup qualification,3,1,1,0,1,2,2,0
Togo,2019,Friendly,2,3,0,1,1,2,-1,0
Togo,2020,African Cup of Nations qualification,1,4,0,2,0,2,-3,0
Togo,2020,Friendly,1,1,0,0,1,1,0,0
Togo,2021,African Cup of Nations qualification,1,2,0,1,1,2,-1,0
Togo,2021,FIFA World Cup qualification,5,6,2,2,2,6,-1,0
Togo,2021,Friendly,2,1,1,1,0,2,1,0
Togo,2022,African Cup of Nations qualification,2,4,0,1,1,2,-2,0
Togo,2022,Friendly,7,5,1,1,2,4,2,0
Togo,2023,African Cup of Nations qualification,6,4,2,1,1,4,2,0
Togo,2023,FIFA World Cup qualification,1,1,0,0,2,2,0,0
Togo,2023,Friendly,2,0,1,0,0,1,2,0
Togo,2024,African Cup of Nations qualification,4,9,0,2,2,4,-5,0
Togo,2024,FIFA World Cup qualification,1,2,0,1,1,2,-1,0
Togo,2024,Friendly,2,4,1,1,0,2,-2,0
Togo,2025,FIFA World Cup qualification,2,4,0,1,1,2,-2,0
Tonga,1979,South Pacific Games,5,20,1,3,0,4,-15,0
Tonga,1983,South Pacific Games,6,8,1,1,1,3,-2,0
Tonga,1993,South Pacific Mini Games,0,19,0,3,0,3,-19,0
Tonga,1994,Oceania Nations Cup qualification,4,4,1,1,1,3,0,1
Tonga,1996,FIFA World Cup qualification,3,0,2,0,0,2,3,0
Tonga,1997,FIFA World Cup qualification,0,13,0,2,0,2,-13,0
Tonga,1998,Oceania Nations Cup qualification,5,9,1,2,1,4,-4,0
Tonga,2000,Oceania Nations Cup qualification,3,3,1,1,0,2,0,1
Tonga,2001,FIFA World Cup qualification,7,30,2,2,0,4,-23,0
Tonga,2002,Oceania Nations Cup qualification,7,18,1,3,0,4,-11,0
Tonga,2003,South Pacific Games,9,10,1,2,1,4,-1,0
Tonga,2004,FIFA World Cup qualification,2,17,1,3,0,4,-15,0
Tonga,2007,South Pacific Games,6,10,1,3,0,4,-4,0
Tonga,2009,Friendly,2,3,0,1,1,2,-1,0
Tonga,2011,FIFA World Cup qualification,4,4,1,1,1,3,0,1
Tonga,2015,FIFA World Cup qualification,1,8,0,3,0,3,-7,0
Tonga,2015,Friendly,0,5,0,1,0,1,-5,0
Tonga,2017,Pacific Mini Games,5,25,0,5,0,5,-20,0
Tonga,2019,Pacific Games,0,24,0,3,0,3,-24,0
Tonga,2023,Pacific Games,7,15,1,3,0,4,-8,0
Tonga,2024,FIFA World Cup qualification,4,3,1,1,0,2,1,0
Tonga,2024,Oceania Nations Cup qualification,1,5,0,2,0,2,-4,0
Trinidad and Tobago,1905,Friendly,4,1,1,0,0,1,3,1
Trinidad and Tobago,1928,Friendly,1,1,0,0,1,1,0,0
Trinidad and Tobago,1929,Friendly,5,11,1,5,2,8,-6,0
Trinidad and Tobago,1931,Friendly,15,4,3,1,0,4,11,0
Trinidad and Tobago,1932,Friendly,5,4,2,2,0,4,1,0
Trinidad and Tobago,1933,Friendly,21,6,5,0,1,6,15,0
Trinidad and Tobago,1934,Friendly,3,3,0,0,1,1,0,0
Trinidad and Tobago,1935,Friendly,7,5,2,1,0,3,2,1
Trinidad and Tobago,1936,Friendly,8,5,3,1,0,4,3,0
Trinidad and Tobago,1937,Friendly,12,8,2,0,3,5,4,0
Trinidad and Tobago,1938,Friendly,8,6,3,2,1,6,2,0
Trinidad and Tobago,1942,Friendly,3,3,0,0,1,1,0,0
Trinidad and Tobago,1944,Friendly,27,5,6,0,3,9,22,0
Trinidad and Tobago,1947,Friendly,19,13,5,5,1,11,6,0
Trinidad and Tobago,1948,Friendly,10,1,3,1,2,6,9,0
Trinidad and Tobago,1949,Friendly,24,19,4,4,1,9,5,0
Trinidad and Tobago,1950,Friendly,22,7,7,1,1,9,15,0
Trinidad and Tobago,1951,Friendly,2,0,1,0,0,1,2,0
Trinidad and Tobago,1953,Friendly,14,9,3,1,1,5,5,0
Trinidad and Tobago,1955,Friendly,3,11,0,3,0,3,-8,0
Trinidad and Tobago,1957,Friendly,1,5,0,3,0,3,-4,0
Trinidad and Tobago,1958,Friendly,5,1,2,1,0,3,4,0
Trinidad and Tobago,1959,Friendly,6,2,3,0,0,3,4,0
Trinidad and Tobago,1960,Friendly,5,3,1,0,3,4,2,0
Trinidad and Tobago,1962,Friendly,4,3,1,0,3,4,1,0
Trinidad and Tobago,1963,Friendly,6,8,1,2,0,3,-2,0
Trinidad and Tobago,1964,Friendly,15,5,4,0,1,5,10,0
Trinidad and Tobago,1965,FIFA World Cup qualification,5,12,1,3,0,4,-7,0
Trinidad and Tobago,1965,Friendly,0,5,0,2,0,2,-5,0
Trinidad and Tobago,1966,Friendly,9,6,3,2,0,5,3,0
Trinidad and Tobago,1967,CONCACAF Championship,6,10,2,3,0,5,-4,0
Trinidad and Tobago,1967,CONCACAF Championship qualification,7,7,2,1,1,4,0,0
Trinidad and Tobago,1967,Friendly,7,4,3,0,1,4,3,0
Trinidad and Tobago,1968,FIFA World Cup qualification,4,10,1,2,1,4,-6,0
Trinidad and Tobago,1969,CONCACAF Championship,4,12,1,3,1,5,-8,0
Trinidad and Tobago,1970,Friendly,5,6,0,1,3,4,-1,0
Trinidad and Tobago,1971,CONCACAF Championship,7,12,1,2,2,5,-5,1
Trinidad and Tobago,1972,CONCACAF Championship qualification,16,4,3,0,1,4,12,0
Trinidad and Tobago,1972,Friendly,7,2,3,0,0,3,5,0
Trinidad and Tobago,1973,CONCACAF Championship,11,4,3,2,0,5,7,0
Trinidad and Tobago,1973,Friendly,4,4,1,1,1,3,0,0
Trinidad and Tobago,1974,Friendly,5,6,1,2,1,4,-1,0
Trinidad and Tobago,1976,CONCACAF Championship qualification,10,9,2,2,2,6,1,0
Trinidad and Tobago,1977,Friendly,7,7,1,2,2,5,0,0
Trinidad and Tobago,1978,CFU Caribbean Cup,5,4,1,1,1,3,1,0
Trinidad and Tobago,1978,CFU Caribbean Cup qualification,6,5,1,1,0,2,1,0
Trinidad and Tobago,1978,Friendly,9,2,2,0,1,3,7,0
Trinidad and Tobago,1979,CFU Caribbean Cup,0,4,0,2,0,2,-4,0
Trinidad and Tobago,1979,CFU Caribbean Cup qualification,3,1,2,0,0,2,2,0
Trinidad and Tobago,1979,Friendly,3,5,0,1,2,3,-2,0
Trinidad and Tobago,1980,CONCACAF Championship qualification,1,2,1,1,2,4,-1,0
Trinidad and Tobago,1980,Friendly,5,3,1,0,2,3,2,0
Trinidad and Tobago,1981,CFU Caribbean Cup,4,0,2,0,0,2,4,0
Trinidad and Tobago,1981,CFU Caribbean Cup qualification,6,5,1,0,3,4,1,0
Trinidad and Tobago,1981,Friendly,12,7,3,1,1,5,5,0
Trinidad and Tobago,1982,Friendly,15,14,2,2,3,7,1,0
Trinidad and Tobago,1983,CFU Caribbean Cup,4,4,2,1,0,3,0,0
Trinidad and Tobago,1983,Friendly,0,5,0,1,0,1,-5,0
Trinidad and Tobago,1984,Friendly,12,5,4,2,0,6,7,0
Trinidad and Tobago,1985,CFU Caribbean Cup qualification,7,4,1,1,2,4,3,0
Trinidad and Tobago,1985,CONCACAF Championship,2,7,0,3,1,4,-5,0
Trinidad and Tobago,1985,Friendly,3,6,0,2,2,4,-3,0
Trinidad and Tobago,1987,CFU Caribbean Cup qualification,9,1,2,0,0,2,8,1
Trinidad and Tobago,1987,Friendly,2,1,1,0,0,1,1,0
Trinidad and Tobago,1988,CFU Caribbean Cup,7,1,2,0,1,3,6,1
Trinidad and Tobago,1988,CONCACAF Championship qualification,6,1,2,0,2,4,5,0
Trinidad and Tobago,1988,Friendly,1,2,0,1,0,1,-1,0
Trinidad and Tobago,1989,CFU Caribbean Cup,5,3,2,1,0,3,2,1
Trinidad and Tobago,1989,CFU Caribbean Cup qualification,16,2,3,1,0,4,14,0
Trinidad and Tobago,1989,CONCACAF Championship,7,5,3,2,3,8,2,0
Trinidad and Tobago,1989,Friendly,18,8,4,2,4,10,10,0
Trinidad and Tobago,1990,CFU Caribbean Cup,0,0,0,0,1,1,0,0
Trinidad and Tobago,1990,Friendly,0,5,0,2,1,3,-5,0
Trinidad and Tobago,1991,CFU Caribbean Cup,12,5,3,2,0,5,7,0
Trinidad and Tobago,1991,Gold Cup,3,4,1,2,0,3,-1,0
Trinidad and Tobago,1992,CFU Caribbean Cup,4,1,2,0,0,2,3,1
Trinidad and Tobago,1992,FIFA World Cup qualification,7,4,2,1,1,4,3,0
Trinidad and Tobago,1993,CFU Caribbean Cup,6,9,1,2,1,4,-3,1
Trinidad and Tobago,1993,Friendly,1,1,0,0,1,1,0,0
Trinidad and Tobago,1994,CFU Caribbean Cup,10,4,2,0,0,2,6,1
Trinidad and Tobago,1994,Friendly,5,5,2,2,0,4,0,0
Trinidad and Tobago,1995,CFU Caribbean Cup,16,3,3,1,0,4,13,0
Trinidad and Tobago,1995,Friendly,16,10,4,3,1,8,6,0
Trinidad and Tobago,1996,CFU Caribbean Cup,13,2,5,0,0,5,11,1
Trinidad and Tobago,1996,FIFA World Cup qualification,15,10,2,5,1,8,5,0
Trinidad and Tobago,1996,Friendly,6,4,2,2,3,7,2,0
Trinidad and Tobago,1996,Gold Cup,4,6,0,2,0,2,-2,0
Trinidad and Tobago,1997,CFU Caribbean Cup,9,3,2,1,1,4,6,0
Trinidad and Tobago,1997,Friendly,10,18,1,5,2,8,-8,0
Trinidad and Tobago,1998,CFU Caribbean Cup,18,6,4,1,0,5,12,0
Trinidad and Tobago,1998,Friendly,2,4,1,2,1,4,-2,0
Trinidad and Tobago,1998,Gold Cup,5,5,1,1,0,2,0,0
Trinidad and Tobago,1998,SKN Football Festival,1,4,0,1,0,1,-3,0
Trinidad and Tobago,1999,CFU Caribbean Cup,19,4,5,0,0,5,15,1
Trinidad and Tobago,1999,Friendly,12,8,3,1,1,5,4,0
Trinidad and Tobago,2000,FIFA World Cup qualification,28,10,9,1,2,12,18,0
Trinidad and Tobago,2000,Friendly,8,11,1,5,3,9,-3,0
Trinidad and Tobago,2000,Gold Cup,6,8,2,2,0,4,-2,0
Trinidad and Tobago,2001,CFU Caribbean Cup,13,3,4,1,0,5,10,1
Trinidad and Tobago,2001,FIFA World Cup qualification,5,18,1,7,2,10,-13,0
Trinidad and Tobago,2001,Friendly,21,9,6,1,2,9,12,0
Trinidad and Tobago,2002,Friendly,3,2,1,0,0,1,1,0
Trinidad and Tobago,2002,Gold Cup,1,2,0,1,1,2,-1,0
Trinidad and Tobago,2002,Gold Cup qualification,2,1,1,1,0,2,1,0
Trinidad and Tobago,2002,SKN Football Festival,1,2,0,1,1,2,-1,0
Trinidad and Tobago,2003,Friendly,7,13,1,4,3,8,-6,0
Trinidad and Tobago,2003,Gold Cup qualification,6,8,2,3,0,5,-2,0
Trinidad and Tobago,2003,SKN Football Festival,2,3,1,1,0,2,-1,1
Trinidad and Tobago,2004,CFU Caribbean Cup qualification,14,0,5,0,0,5,14,0
Trinidad and Tobago,2004,FIFA World Cup qualification,18,9,6,2,0,8,9,0
Trinidad and Tobago,2004,Friendly,12,19,3,5,2,10,-7,0
Trinidad and Tobago,2005,CFU Caribbean Cup,5,6,1,2,0,3,-1,0
Trinidad and Tobago,2005,FIFA World Cup qualification,12,16,5,5,2,12,-4,0
Trinidad and Tobago,2005,Friendly,12,4,6,2,0,8,8,0
Trinidad and Tobago,2005,Gold Cup,3,5,0,1,2,3,-2,0
Trinidad and Tobago,2006,FIFA World Cup,0,4,0,2,1,3,-4,0
Trinidad and Tobago,2006,Friendly,8,16,2,5,1,8,-8,0
Trinidad and Tobago,2007,CFU Caribbean Cup,13,6,3,1,1,5,7,0
Trinidad and Tobago,2007,Friendly,5,11,1,3,2,6,-6,0
Trinidad and Tobago,2007,Gold Cup,2,5,0,2,1,3,-3,0
Trinidad and Tobago,2008,CFU Caribbean Cup,4,4,1,1,1,3,0,0
Trinidad and Tobago,2008,CFU Caribbean Cup qualification,7,4,2,0,1,3,3,0
Trinidad and Tobago,2008,FIFA World Cup qualification,12,8,4,2,2,8,4,0
Trinidad and Tobago,2008,Friendly,34,11,10,2,4,16,23,0
Trinidad and Tobago,2009,FIFA World Cup qualification,10,22,1,6,3,10,-12,0
Trinidad and Tobago,2009,Friendly,4,2,2,0,0,2,2,0
Trinidad and Tobago,2010,CFU Caribbean Cup,1,3,1,2,0,3,-2,0
Trinidad and Tobago,2010,CFU Caribbean Cup qualification,6,1,2,0,0,2,5,0
Trinidad and Tobago,2010,Friendly,6,10,2,4,2,8,-4,0
Trinidad and Tobago,2011,FIFA World Cup qualification,11,4,4,2,0,6,7,0
Trinidad and Tobago,2011,Friendly,3,0,1,0,0,1,3,0
Trinidad and Tobago,2012,CFU Caribbean Cup,3,5,1,2,2,5,-2,0
Trinidad and Tobago,2012,CFU Caribbean Cup qualification,17,1,3,0,0,3,16,0
Trinidad and Tobago,2012,Friendly,6,5,1,2,0,3,1,0
Trinidad and Tobago,2013,Friendly,3,10,2,4,2,8,-7,0
Trinidad and Tobago,2013,Gold Cup,4,5,1,2,1,4,-1,0
Trinidad and Tobago,2013,OSN Cup,6,4,1,0,1,2,2,0
Trinidad and Tobago,2014,CFU Caribbean Cup,7,4,2,0,1,3,3,0
Trinidad and Tobago,2014,CFU Caribbean Cup qualification,9,1,3,0,0,3,8,0
Trinidad and Tobago,2014,Friendly,0,5,0,2,0,2,-5,0
Trinidad and Tobago,2015,FIFA World Cup qualification,2,1,1,0,0,1,1,0
Trinidad and Tobago,2015,Friendly,0,5,0,3,0,3,-5,0
Trinidad and Tobago,2015,Gold Cup,10,6,2,0,2,4,4,0
Trinidad and Tobago,2016,CFU Caribbean Cup qualification,4,0,1,0,0,1,4,0
Trinidad and Tobago,2016,Copa América qualification,0,1,0,1,0,1,-1,0
Trinidad and Tobago,2016,FIFA World Cup qualification,12,13,2,3,1,6,-1,0
Trinidad and Tobago,2016,Friendly,6,11,1,3,0,4,-5,0
Trinidad and Tobago,2017,CFU Caribbean Cup qualification,4,6,0,2,0,2,-2,0
Trinidad and Tobago,2017,FIFA World Cup qualification,6,14,2,6,0,8,-8,0
Trinidad and Tobago,2017,Friendly,7,8,1,2,2,5,-1,0
Trinidad and Tobago,2018,Friendly,3,3,2,3,1,6,0,0
Trinidad and Tobago,2019,CONCACAF Nations League,3,9,0,2,2,4,-6,0
Trinidad and Tobago,2019,Friendly,15,9,1,5,0,6,6,0
Trinidad and Tobago,2019,Gold Cup,1,9,0,2,1,3,-8,0
Trinidad and Tobago,2019,Kirin Challenge Cup,0,0,0,0,1,1,0,0
Trinidad and Tobago,2021,FIFA World Cup qualification,6,1,2,0,2,4,5,0
Trinidad and Tobago,2021,Friendly,0,7,0,1,0,1,-7,0
Trinidad and Tobago,2021,Gold Cup,1,3,0,1,2,3,-2,0
Trinidad and Tobago,2021,Gold Cup qualification,7,2,1,0,1,2,5,0
Trinidad and Tobago,2022,CONCACAF Nations League,8,3,3,1,0,4,5,0
Trinidad and Tobago,2022,Friendly,11,6,2,1,1,4,5,0
Trinidad and Tobago,2022,King's Cup,2,4,0,2,0,2,-2,0
Trinidad and Tobago,2023,CONCACAF Nations League,16,14,5,2,1,8,2,0
Trinidad and Tobago,2023,Friendly,2,0,2,0,2,4,2,0
Trinidad and Tobago,2023,Gold Cup,4,10,1,2,0,3,-6,0
Trinidad and Tobago,2024,CONCACAF Nations League,5,7,1,1,2,4,-2,0
Trinidad and Tobago,2024,Copa América qualification,0,2,0,1,0,1,-2,0
Trinidad and Tobago,2024,FIFA World Cup qualification,9,3,1,0,1,2,6,0
Trinidad and Tobago,2024,Friendly,4,2,2,1,1,4,2,0
Trinidad and Tobago,2025,Friendly,1,2,0,1,1,2,-1,0
Trinidad and Tobago,2025,Gold Cup qualification,6,1,2,0,0,2,5,0
Tunisia,1957,Friendly,4,2,1,0,0,1,2,0
Tunisia,1958,Friendly,4,1,1,0,0,1,3,0
Tunisia,1959,Friendly,0,0,0,0,1,1,0,0
Tunisia,1960,FIFA World Cup qualification,3,3,1,1,0,2,0,0
Tunisia,1960,Friendly,7,22,1,5,1,7,-15,0
Tunisia,1961,African Cup of Nations qualification,1,2,0,1,0,1,-1,0
Tunisia,1961,FIFA World Cup qualification,1,1,0,0,1,1,0,0
Tunisia,1962,African Cup of Nations,5,4,1,1,0,2,1,0
Tunisia,1962,Friendly,5,8,0,1,1,2,-3,0
Tunisia,1963,African Cup of Nations,3,5,0,1,1,2,-2,0
Tunisia,1963,African Cup of Nations qualification,6,5,1,1,0,2,1,0
Tunisia,1963,African Friendship Games,12,4,4,1,1,6,8,0
Tunisia,1963,Arab Cup,11,1,4,0,0,4,10,0
Tunisia,1963,Friendly,4,4,2,1,1,4,0,0
Tunisia,1964,Friendly,4,6,1,1,0,2,-2,0
Tunisia,1965,African Cup of Nations,6,3,1,1,1,3,3,0
Tunisia,1965,Friendly,1,0,1,0,1,2,1,0
Tunisia,1967,African Cup of Nations qualification,5,1,1,0,1,2,4,0
Tunisia,1967,Friendly,0,4,0,1,1,2,-4,0
Tunisia,1968,FIFA World Cup qualification,2,1,1,0,1,2,1,0
Tunisia,1968,Friendly,2,5,0,2,1,3,-3,0
Tunisia,1969,FIFA World Cup qualification,2,2,0,0,3,3,0,0
Tunisia,1969,Friendly,2,5,0,1,1,2,-3,0
Tunisia,1970,Friendly,6,5,1,1,1,3,1,0
Tunisia,1972,FIFA World Cup qualification,3,2,1,1,0,2,1,1
Tunisia,1972,Friendly,7,6,1,1,1,3,1,0
Tunisia,1973,FIFA World Cup qualification,2,3,0,1,1,2,-1,0
Tunisia,1973,Friendly,2,9,1,2,1,4,-7,0
Tunisia,1973,Palestine Cup,19,3,6,0,0,6,16,1
Tunisia,1974,African Cup of Nations qualification,1,1,1,1,0,2,0,0
Tunisia,1974,Friendly,2,8,1,3,0,4,-6,0
Tunisia,1974,Kuneitra Cup,5,4,2,1,0,3,1,1
Tunisia,1975,African Cup of Nations qualification,7,6,2,1,1,4,1,0
Tunisia,1975,Friendly,0,0,0,0,2,2,0,0
Tunisia,1975,Palestine Cup,4,1,1,0,1,2,3,0
Tunisia,1976,FIFA World Cup qualification,1,1,0,0,1,1,0,0
Tunisia,1976,Friendly,8,3,3,0,2,5,5,0
Tunisia,1977,African Cup of Nations qualification,10,7,2,1,1,4,3,0
Tunisia,1977,FIFA World Cup qualification,14,8,4,2,3,9,6,1
Tunisia,1977,Friendly,2,6,1,3,0,4,-4,0
Tunisia,1978,African Cup of Nations,4,3,1,1,2,4,1,0
Tunisia,1978,FIFA World Cup,3,2,1,1,1,3,1,0
Tunisia,1978,Friendly,1,8,0,3,0,3,-7,0
Tunisia,1979,Friendly,7,3,2,1,0,3,4,1
Tunisia,1980,FIFA World Cup qualification,2,2,1,1,0,2,0,0
Tunisia,1980,Friendly,4,6,1,2,2,5,-2,0
Tunisia,1981,African Cup of Nations qualification,1,0,1,0,1,2,1,0
Tunisia,1981,Friendly,16,6,4,1,2,7,10,1
Tunisia,1982,African Cup of Nations,1,4,0,2,1,3,-3,0
Tunisia,1982,Friendly,5,5,2,3,0,5,0,0
Tunisia,1983,African Cup of Nations qualification,6,1,2,1,1,4,5,0
Tunisia,1983,Friendly,4,3,3,1,0,4,1,0
Tunisia,1984,FIFA World Cup qualification,6,0,2,0,0,2,6,0
Tunisia,1984,Friendly,9,6,2,2,0,4,3,0
Tunisia,1985,African Cup of Nations qualification,1,2,1,1,0,2,-1,0
Tunisia,1985,FIFA World Cup qualification,5,9,2,4,0,6,-4,0
Tunisia,1985,Friendly,5,0,4,0,0,4,5,0
Tunisia,1986,Friendly,5,6,0,1,3,4,-1,0
Tunisia,1987,African Cup of Nations qualification,1,2,0,1,1,2,-1,0
Tunisia,1987,All-African Games,1,8,0,4,0,4,-7,0
Tunisia,1987,Arab Cup qualification,2,1,1,0,1,2,1,0
Tunisia,1987,Friendly,3,8,0,3,0,3,-5,0
Tunisia,1988,Arab Cup,2,3,0,1,2,3,-1,0
Tunisia,1988,FIFA World Cup qualification,5,3,1,1,0,2,2,0
Tunisia,1988,Friendly,7,10,1,4,2,7,-3,0
Tunisia,1988,Malta International Tournament,1,5,0,2,0,2,-4,0
Tunisia,1989,African Cup of Nations qualification,0,4,0,2,0,2,-4,0
Tunisia,1989,FIFA World Cup qualification,5,8,3,4,1,8,-3,0
Tunisia,1989,Friendly,3,3,1,2,2,5,0,0
Tunisia,1990,African Cup of Nations qualification,4,1,2,0,0,2,3,1
Tunisia,1990,Friendly,3,6,0,2,2,4,-3,0
Tunisia,1991,African Cup of Nations qualification,4,4,0,0,3,3,0,0
Tunisia,1991,Friendly,15,9,4,2,4,10,6,0
Tunisia,1992,FIFA World Cup qualification,6,2,1,0,2,3,4,0
Tunisia,1992,Friendly,4,4,1,1,2,4,0,0
Tunisia,1993,FIFA World Cup qualification,8,0,2,0,1,3,8,0
Tunisia,1993,Friendly,14,5,4,1,2,7,9,0
Tunisia,1994,African Cup of Nations,1,3,0,1,1,2,-2,0
Tunisia,1994,African Cup of Nations qualification,1,1,0,0,1,1,0,0
Tunisia,1994,Friendly,11,4,4,0,1,5,7,0
Tunisia,1994,Malta International Tournament,3,5,0,1,2,3,-2,0
Tunisia,1995,African Cup of Nations qualification,6,1,3,1,3,7,5,0
Tunisia,1995,Friendly,12,8,4,3,1,8,4,0
Tunisia,1996,African Cup of Nations,10,9,2,2,2,6,1,0
Tunisia,1996,African Cup of Nations qualification,2,0,1,0,0,1,2,0
Tunisia,1996,FIFA World Cup qualification,6,1,3,0,0,3,5,0
Tunisia,1996,Friendly,4,6,1,3,0,4,-2,0
Tunisia,1997,African Cup of Nations qualification,1,1,1,1,0,2,0,0
Tunisia,1997,FIFA World Cup qualification,9,1,4,0,1,5,8,0
Tunisia,1997,Friendly,8,3,4,1,1,6,5,0
Tunisia,1998,African Cup of Nations,6,5,2,1,1,4,1,0
Tunisia,1998,African Cup of Nations qualification,2,1,1,0,0,1,1,0
Tunisia,1998,FIFA World Cup,1,4,0,2,1,3,-3,0
Tunisia,1998,Friendly,17,11,4,3,2,9,6,0
Tunisia,1999,African Cup of Nations qualification,4,2,2,1,0,3,2,0
Tunisia,1999,Friendly,5,2,3,1,1,5,3,0
Tunisia,2000,African Cup of Nations,6,9,2,2,2,6,-3,0
Tunisia,2000,African Cup of Nations qualification,4,2,1,0,1,2,2,0
Tunisia,2000,FIFA World Cup qualification,8,3,3,0,1,4,5,0
Tunisia,2000,Friendly,15,7,2,1,3,6,8,0
Tunisia,2001,African Cup of Nations qualification,5,5,1,2,1,4,0,0
Tunisia,2001,FIFA World Cup qualification,20,2,5,0,1,6,18,0
Tunisia,2001,Friendly,11,5,2,0,1,3,6,0
Tunisia,2002,African Cup of Nations,0,1,0,1,2,3,-1,0
Tunisia,2002,FIFA World Cup,1,5,0,2,1,3,-4,0
Tunisia,2002,Friendly,3,6,0,3,5,8,-3,0
Tunisia,2003,Friendly,10,5,5,1,3,9,5,0
Tunisia,2004,African Cup of Nations,10,4,4,0,2,6,6,1
Tunisia,2004,FIFA World Cup qualification,8,6,1,1,2,4,2,0
Tunisia,2004,Friendly,5,9,3,3,0,6,-4,0
Tunisia,2005,Confederations Cup,3,5,1,2,0,3,-2,0
Tunisia,2005,FIFA World Cup qualification,17,3,5,0,1,6,14,0
Tunisia,2005,Friendly,8,4,2,0,1,3,4,0
Tunisia,2006,African Cup of Nations,7,5,2,1,1,4,2,0
Tunisia,2006,African Cup of Nations qualification,1,0,1,0,1,2,1,0
Tunisia,2006,FIFA World Cup,3,6,0,2,1,3,-3,0
Tunisia,2006,Friendly,8,2,4,2,1,7,6,0
Tunisia,2007,African Cup of Nations qualification,11,3,3,1,0,4,8,0
Tunisia,2007,Friendly,5,2,2,0,3,5,3,0
Tunisia,2008,African Cup of Nations,7,6,1,1,2,4,1,0
Tunisia,2008,FIFA World Cup qualification,11,3,4,1,1,6,8,0
Tunisia,2008,Friendly,6,6,2,2,2,6,0,0
Tunisia,2009,FIFA World Cup qualification,7,4,3,1,2,6,3,0
Tunisia,2009,Friendly,5,2,1,1,2,4,3,0
Tunisia,2010,African Cup of Nations,3,3,0,0,3,3,0,0
Tunisia,2010,African Cup of Nations qualification,7,6,2,2,1,5,1,0
Tunisia,2010,Friendly,8,5,1,1,1,3,3,0
Tunisia,2011,African Cup of Nations qualification,7,0,2,0,1,3,7,0
Tunisia,2011,Friendly,13,8,3,2,2,7,5,0
Tunisia,2012,African Cup of Nations,5,5,2,2,0,4,0,0
Tunisia,2012,African Cup of Nations qualification,2,2,0,0,2,2,0,0
Tunisia,2012,FIFA World Cup qualification,5,2,2,0,0,2,3,0
Tunisia,2012,Friendly,15,9,4,2,2,8,6,0
Tunisia,2013,African Cup of Nations,2,4,1,1,1,3,-2,0
Tunisia,2013,FIFA World Cup qualification,9,8,2,1,3,6,1,0
Tunisia,2013,Friendly,7,6,1,1,2,4,1,0
Tunisia,2014,African Cup of Nations qualification,6,2,4,0,2,6,4,0
Tunisia,2014,Friendly,2,2,1,1,1,3,0,0
Tunisia,2015,African Cup of Nations,5,5,1,1,2,4,0,0
Tunisia,2015,African Cup of Nations qualification,8,2,1,1,0,2,6,0
Tunisia,2015,FIFA World Cup qualification,4,2,2,0,0,2,2,0
Tunisia,2015,Friendly,5,5,0,0,3,3,0,0
Tunisia,2015,Kirin Challenge Cup,0,2,0,1,0,1,-2,0
Tunisia,2016,African Cup of Nations qualification,8,1,3,0,1,4,7,0
Tunisia,2016,FIFA World Cup qualification,3,0,2,0,0,2,3,0
Tunisia,2016,Friendly,4,6,0,1,2,3,-2,0
Tunisia,2017,African Cup of Nations,6,7,2,2,0,4,-1,0
Tunisia,2017,African Cup of Nations qualification,1,0,1,0,0,1,1,0
Tunisia,2017,FIFA World Cup qualification,8,4,2,0,2,4,4,0
Tunisia,2017,Friendly,2,3,1,3,0,4,-1,0
Tunisia,2018,African Cup of Nations qualification,7,4,3,1,0,4,3,0
Tunisia,2018,FIFA World Cup,5,8,1,2,0,3,-3,0
Tunisia,2018,Friendly,6,6,2,2,2,6,0,0
Tunisia,2019,African Cup of Nations,6,5,1,2,4,7,1,0
Tunisia,2019,African Cup of Nations qualification,9,1,3,0,0,3,8,0
Tunisia,2019,Friendly,8,5,4,2,1,7,3,0
Tunisia,2020,African Cup of Nations qualification,2,1,1,0,1,2,1,0
Tunisia,2020,Friendly,4,1,1,0,1,2,3,0
Tunisia,2021,African Cup of Nations qualification,7,3,2,0,0,2,4,0
Tunisia,2021,Arab Cup,9,6,4,2,0,6,3,0
Tunisia,2021,FIFA World Cup qualification,11,2,4,1,1,6,9,0
Tunisia,2021,Friendly,2,2,2,1,0,3,0,0
Tunisia,2022,African Cup of Nations,5,3,2,3,0,5,2,0
Tunisia,2022,African Cup of Nations qualification,4,0,1,0,1,2,4,0
Tunisia,2022,FIFA World Cup,1,1,1,1,1,3,0,0
Tunisia,2022,FIFA World Cup qualification,1,0,1,0,1,2,1,0
Tunisia,2022,Friendly,4,5,2,1,0,3,-1,0
Tunisia,2022,Kirin Cup,5,0,2,0,0,2,5,1
Tunisia,2023,African Cup of Nations qualification,7,1,3,1,0,4,6,0
Tunisia,2023,FIFA World Cup qualification,5,0,2,0,0,2,5,0
Tunisia,2023,Friendly,4,6,1,1,1,3,-2,0
Tunisia,2024,African Cup of Nations,1,2,0,1,2,3,-1,0
Tunisia,2024,African Cup of Nations qualification,4,3,2,1,1,4,1,0
Tunisia,2024,FIFA Series,0,0,0,0,2,2,0,0
Tunisia,2024,FIFA World Cup qualification,1,0,1,0,1,2,1,0
Tunisia,2024,Friendly,2,0,1,0,1,2,2,0
Tunisia,2025,FIFA World Cup qualification,3,0,2,0,0,2,3,0
Turkey,1923,Friendly,2,2,0,0,1,1,0,0
Turkey,1924,Friendly,11,9,3,2,0,5,2,0
Turkey,1924,Olympic Games,2,5,0,1,0,1,-3,0
Turkey,1925,Friendly,6,6,2,2,0,4,0,0
Turkey,1926,Friendly,2,9,0,2,0,2,-7,0
Turkey,1927,Friendly,6,4,1,0,1,2,2,0
Turkey,1928,Friendly,3,6,0,2,0,2,-3,0
Turkey,1928,Olympic Games,1,7,0,1,0,1,-6,0
Turkey,1931,Balkan Cup,3,5,1,1,0,2,-2,0
Turkey,1932,Friendly,2,3,0,1,0,1,-1,0
Turkey,1936,Friendly,3,3,0,0,1,1,0,0
Turkey,1937,Friendly,1,3,0,1,0,1,-2,0
Turkey,1947,Friendly,3,1,1,0,0,1,2,0
Turkey,1948,Friendly,6,4,2,1,1,4,2,0
Turkey,1949,FIFA World Cup qualification,7,0,1,0,0,1,7,0
Turkey,1949,Friendly,5,4,2,1,0,3,1,0
Turkey,1950,Friendly,10,8,2,1,0,3,2,0
Turkey,1951,Friendly,4,6,2,2,0,4,-2,0
Turkey,1952,Friendly,1,5,0,1,1,2,-4,0
Turkey,1953,Friendly,4,3,1,0,1,2,1,0
Turkey,1954,FIFA World Cup,10,11,1,2,0,3,-1,0
Turkey,1954,FIFA World Cup qualification,4,6,1,1,1,3,-2,0
Turkey,1954,Friendly,1,5,0,1,0,1,-4,0
Turkey,1955,Friendly,3,1,1,0,0,1,2,0
Turkey,1956,Friendly,6,7,1,2,2,5,-1,0
Turkey,1957,Friendly,2,1,1,0,1,2,1,0
Turkey,1958,Friendly,4,2,2,0,2,4,2,0
Turkey,1958,UEFA Euro qualification,0,3,0,1,0,1,-3,0
Turkey,1959,Friendly,0,0,0,0,1,1,0,0
Turkey,1959,UEFA Euro qualification,2,0,1,0,0,1,2,0
Turkey,1960,Friendly,5,4,1,1,0,2,1,0
Turkey,1961,FIFA World Cup qualification,4,4,2,2,0,4,0,0
Turkey,1961,Friendly,1,5,1,2,0,3,-4,0
Turkey,1962,Friendly,8,3,3,1,2,6,5,0
Turkey,1962,UEFA Euro qualification,0,6,0,1,0,1,-6,0
Turkey,1963,Friendly,0,3,0,1,2,3,-3,0
Turkey,1963,UEFA Euro qualification,0,1,0,1,0,1,-1,0
Turkey,1964,Friendly,6,4,1,1,1,3,2,0
Turkey,1965,FIFA World Cup qualification,4,19,1,5,0,6,-15,0
Turkey,1965,Friendly,7,8,2,2,1,5,-1,0
Turkey,1966,Friendly,2,2,1,1,2,4,0,0
Turkey,1966,UEFA Euro qualification,1,2,0,1,0,1,-1,0
Turkey,1967,Friendly,8,4,2,0,1,3,4,0
Turkey,1967,UEFA Euro qualification,2,6,1,2,2,5,-4,0
Turkey,1968,FIFA World Cup qualification,1,7,0,2,0,2,-6,0
Turkey,1968,Friendly,0,10,0,2,1,3,-10,0
Turkey,1969,FIFA World Cup qualification,1,6,0,2,0,2,-5,0
Turkey,1969,Friendly,14,6,4,1,0,5,8,0
Turkey,1970,Friendly,4,2,1,0,1,2,2,0
Turkey,1970,UEFA Euro qualification,3,2,1,0,1,2,1,0
Turkey,1971,Friendly,0,4,0,1,0,1,-4,0
Turkey,1971,UEFA Euro qualification,2,11,1,3,0,4,-9,1
Turkey,1972,FIFA World Cup qualification,3,2,1,1,0,2,1,0
Turkey,1972,Friendly,0,1,0,1,0,1,-1,0
Turkey,1973,Balkan Cup,5,2,1,0,0,1,3,1
Turkey,1973,FIFA World Cup qualification,2,1,1,1,2,4,1,0
Turkey,1973,Friendly,4,0,1,0,1,2,4,0
Turkey,1974,Balkan Cup,1,5,0,1,0,1,-4,0
Turkey,1974,Friendly,3,3,1,1,1,3,0,0
Turkey,1974,UEFA Euro qualification,3,2,1,0,1,2,1,0
Turkey,1975,Friendly,3,8,0,1,2,3,-5,0
Turkey,1975,UEFA Euro qualification,2,8,1,2,1,4,-6,0
Turkey,1976,FIFA World Cup qualification,5,1,1,0,1,2,4,0
Turkey,1976,Friendly,6,7,0,1,3,4,-1,0
Turkey,1977,Balkan Cup,3,7,1,2,0,3,-4,0
Turkey,1977,FIFA World Cup qualification,4,4,1,3,0,4,0,0
Turkey,1977,Friendly,2,3,1,2,0,3,-1,0
Turkey,1978,Balkan Cup,1,1,0,0,1,1,0,0
Turkey,1978,Friendly,2,7,0,3,0,3,-5,0
Turkey,1978,UEFA Euro qualification,0,1,0,1,0,1,-1,0
Turkey,1979,Friendly,0,1,0,1,0,1,-1,0
Turkey,1979,UEFA Euro qualification,5,4,3,1,1,5,1,0
Turkey,1980,FIFA World Cup qualification,1,9,0,3,0,3,-8,0
Turkey,1980,Friendly,9,2,2,1,0,3,7,0
Turkey,1981,FIFA World Cup qualification,0,13,0,5,0,5,-13,0
Turkey,1982,Friendly,0,5,0,1,0,1,-5,0
Turkey,1982,UEFA Euro qualification,1,4,1,1,0,2,-3,0
Turkey,1983,Friendly,2,4,0,1,2,3,-2,0
Turkey,1983,UEFA Euro qualification,7,12,2,3,1,6,-5,0
Turkey,1984,FIFA World Cup qualification,1,10,0,2,0,2,-9,0
Turkey,1984,Friendly,6,12,3,4,1,8,-6,0
Turkey,1985,FIFA World Cup qualification,1,14,0,5,1,6,-13,0
Turkey,1985,Friendly,1,1,0,0,3,3,0,0
Turkey,1986,Friendly,1,0,1,0,0,1,1,0
Turkey,1986,UEFA Euro qualification,0,4,0,1,1,2,-4,0
Turkey,1987,Friendly,4,4,1,1,0,2,0,0
Turkey,1987,UEFA Euro qualification,2,12,0,3,1,4,-10,0
Turkey,1988,FIFA World Cup qualification,6,5,1,1,1,3,1,0
Turkey,1988,Friendly,3,2,1,1,0,2,1,0
Turkey,1989,FIFA World Cup qualification,6,5,2,3,0,5,1,0
Turkey,1989,Friendly,1,0,1,0,0,1,1,0
Turkey,1990,Friendly,1,5,0,2,1,3,-4,0
Turkey,1990,UEFA Euro qualification,0,6,0,2,0,2,-6,0
Turkey,1991,Friendly,4,8,0,1,5,6,-4,0
Turkey,1991,UEFA Euro qualification,1,8,0,4,0,4,-7,0
Turkey,1992,FIFA World Cup qualification,5,9,1,3,0,4,-4,0
Turkey,1992,Friendly,9,7,3,1,1,5,2,0
Turkey,1993,FIFA World Cup qualification,6,10,2,3,1,6,-4,0
Turkey,1994,Friendly,4,8,1,3,0,4,-4,0
Turkey,1994,UEFA Euro qualification,8,4,1,1,1,3,4,0
Turkey,1995,Friendly,14,5,6,0,3,9,9,0
Turkey,1995,UEFA Euro qualification,8,4,3,0,2,5,4,0
Turkey,1996,FIFA World Cup qualification,8,2,1,1,1,3,6,0
Turkey,1996,Friendly,11,12,5,2,1,8,-1,0
Turkey,1996,UEFA Euro,0,5,0,3,0,3,-5,0
Turkey,1997,FIFA World Cup qualification,13,7,3,1,1,5,6,0
Turkey,1997,Friendly,1,1,0,0,1,1,0,0
Turkey,1997,Kirin Cup,1,2,0,1,1,2,-1,0
Turkey,1998,Friendly,1,9,0,3,0,3,-8,0
Turkey,1998,UEFA Euro qualification,5,3,2,1,0,3,2,0
Turkey,1999,UEFA Euro qualification,11,4,3,0,4,7,7,0
Turkey,2000,FIFA World Cup qualification,4,1,2,0,1,3,3,0
Turkey,2000,Friendly,0,8,0,3,0,3,-8,0
Turkey,2000,UEFA Euro,3,4,1,2,1,4,-1,0
Turkey,2001,FIFA World Cup qualification,20,7,6,1,2,9,13,0
Turkey,2001,Friendly,1,3,0,1,2,3,-2,0
Turkey,2002,FIFA World Cup,10,6,4,2,1,7,4,0
Turkey,2002,Friendly,6,4,2,2,2,6,2,0
Turkey,2002,UEFA Euro qualification,10,1,3,0,0,3,9,0
Turkey,2003,Confederations Cup,8,8,2,2,1,5,0,0
Turkey,2003,Friendly,4,6,1,1,2,4,-2,0
Turkey,2003,UEFA Euro qualification,9,7,3,2,2,7,2,0
Turkey,2004,FIFA World Cup qualification,6,5,1,1,3,5,1,0
Turkey,2004,Friendly,12,9,4,2,1,7,3,0
Turkey,2005,FIFA World Cup qualification,21,8,6,1,2,9,13,0
Turkey,2005,Friendly,3,4,1,1,0,2,-1,0
Turkey,2006,Friendly,14,12,3,1,6,10,2,0
Turkey,2006,UEFA Euro qualification,8,0,3,0,0,3,8,0
Turkey,2007,Friendly,0,3,0,2,1,3,-3,0
Turkey,2007,UEFA Euro qualification,17,11,4,2,3,9,6,0
Turkey,2008,FIFA World Cup qualification,5,2,2,0,2,4,3,0
Turkey,2008,Friendly,12,7,4,1,2,7,5,0
Turkey,2008,UEFA Euro,8,9,2,2,1,5,-1,0
Turkey,2009,FIFA World Cup qualification,8,8,2,3,1,6,0,0
Turkey,2009,Friendly,6,2,2,1,1,4,4,0
Turkey,2010,Friendly,9,4,4,2,0,6,5,0
Turkey,2010,UEFA Euro qualification,6,6,2,2,0,4,0,0
Turkey,2011,Friendly,3,0,1,0,1,2,3,0
Turkey,2011,UEFA Euro qualification,7,8,3,2,3,8,-1,0
Turkey,2012,FIFA World Cup qualification,4,6,1,3,0,4,-2,0
Turkey,2012,Friendly,14,10,4,3,1,8,4,0
Turkey,2013,FIFA World Cup qualification,12,3,4,1,1,6,9,0
Turkey,2013,Friendly,8,10,2,2,2,6,-2,0
Turkey,2014,Friendly,13,10,4,2,0,6,3,0
Turkey,2014,UEFA Euro qualification,5,7,1,2,1,4,-2,0
Turkey,2015,Friendly,8,2,3,0,1,4,6,0
Turkey,2015,UEFA Euro qualification,9,2,4,0,2,6,7,0
Turkey,2016,FIFA World Cup qualification,5,5,1,1,2,4,0,0
Turkey,2016,Friendly,7,4,4,1,1,6,3,0
Turkey,2016,UEFA Euro,2,4,1,2,0,3,-2,0
Turkey,2017,FIFA World Cup qualification,9,8,3,2,1,6,1,0
Turkey,2017,Friendly,5,6,1,2,1,4,-1,0
Turkey,2018,Friendly,8,6,2,0,5,7,2,0
Turkey,2018,UEFA Nations League,4,7,1,3,0,4,-3,0
Turkey,2019,Friendly,4,1,2,0,0,2,3,0
Turkey,2019,UEFA Euro qualification,18,3,7,1,2,10,15,0
Turkey,2020,Friendly,6,6,0,0,2,2,0,0
Turkey,2020,UEFA Nations League,6,8,1,2,3,6,-2,0
Turkey,2021,FIFA World Cup qualification,27,16,6,1,3,10,11,0
Turkey,2021,Friendly,4,1,2,0,1,3,3,0
Turkey,2021,UEFA Euro,1,8,0,3,0,3,-7,0
Turkey,2022,FIFA World Cup qualification,1,3,0,1,0,1,-2,0
Turkey,2022,Friendly,6,5,2,1,0,3,1,0
Turkey,2022,UEFA Nations League,18,5,4,1,1,6,13,0
Turkey,2023,Friendly,5,6,1,1,0,2,-1,0
Turkey,2023,UEFA Euro qualification,14,7,5,1,2,8,7,0
Turkey,2024,Friendly,2,9,0,3,1,4,-7,0
Turkey,2024,UEFA Euro,8,8,3,2,0,5,0,0
Turkey,2024,UEFA Nations League,9,6,3,1,2,6,3,0
Turkey,2025,UEFA Nations League,6,1,2,0,0,2,5,1
Turkmenistan,1992,Friendly,10,7,2,2,2,6,3,0
Turkmenistan,1993,Friendly,12,4,2,2,0,4,8,0
Turkmenistan,1994,Asian Games,9,8,1,1,3,5,1,0
Turkmenistan,1994,Friendly,7,5,2,1,1,4,2,0
Turkmenistan,1996,AFC Asian Cup qualification,3,8,0,3,1,4,-5,0
Turkmenistan,1996,Friendly,2,2,1,1,1,3,0,0
Turkmenistan,1997,FIFA World Cup qualification,8,13,2,4,0,6,-5,0
Turkmenistan,1997,Friendly,2,3,1,1,0,2,-1,0
Turkmenistan,1998,Asian Games,10,9,3,1,2,6,1,0
Turkmenistan,1998,Friendly,3,3,0,0,1,1,0,0
Turkmenistan,1999,United Arab Emirates Friendship Tournament,2,7,0,2,1,3,-5,0
Turkmenistan,2000,AFC Asian Cup qualification,15,6,3,1,0,4,9,0
Turkmenistan,2000,Friendly,0,3,0,1,0,1,-3,0
Turkmenistan,2001,FIFA World Cup qualification,12,7,4,2,0,6,5,0
Turkmenistan,2003,AFC Asian Cup qualification,7,2,3,0,2,5,5,0
Turkmenistan,2003,FIFA World Cup qualification,13,0,2,0,0,2,13,0
Turkmenistan,2004,AFC Asian Cup,4,6,0,2,1,3,-2,0
Turkmenistan,2004,FIFA World Cup qualification,8,10,2,3,1,6,-2,0
Turkmenistan,2004,Friendly,2,7,1,2,0,3,-5,0
Turkmenistan,2005,Friendly,0,6,0,2,0,2,-6,0
Turkmenistan,2007,FIFA World Cup qualification,8,1,3,0,1,4,7,0
Turkmenistan,2007,Friendly,1,3,0,2,0,2,-2,0
Turkmenistan,2008,AFC Challenge Cup,6,2,1,1,1,3,4,0
Turkmenistan,2008,FIFA World Cup qualification,1,12,0,5,1,6,-11,0
Turkmenistan,2008,Friendly,3,3,1,1,0,2,0,0
Turkmenistan,2009,AFC Challenge Cup qualification,15,1,3,0,0,3,14,0
Turkmenistan,2009,Friendly,3,12,0,4,0,4,-9,0
Turkmenistan,2010,AFC Challenge Cup,5,2,2,0,2,4,3,0
Turkmenistan,2011,AFC Challenge Cup qualification,4,1,1,0,1,2,3,0
Turkmenistan,2011,FIFA World Cup qualification,4,5,0,1,1,2,-1,0
Turkmenistan,2012,AFC Challenge Cup,9,4,3,1,1,5,5,0
Turkmenistan,2012,Friendly,0,4,0,1,0,1,-4,0
Turkmenistan,2012,VFF Cup,5,2,2,0,0,2,3,1
Turkmenistan,2013,AFC Challenge Cup qualification,7,1,1,1,0,2,6,0
Turkmenistan,2014,AFC Challenge Cup,6,6,1,2,0,3,0,0
Turkmenistan,2015,FIFA World Cup qualification,8,10,3,3,1,7,-2,0
Turkmenistan,2015,Friendly,1,5,0,1,0,1,-4,0
Turkmenistan,2016,FIFA World Cup qualification,2,1,1,0,0,1,1,0
Turkmenistan,2016,Friendly,0,5,0,3,0,3,-5,0
Turkmenistan,2017,AFC Asian Cup qualification,6,5,2,1,1,4,1,0
Turkmenistan,2017,Friendly,1,2,0,1,0,1,-1,0
Turkmenistan,2018,AFC Asian Cup qualification,0,4,0,1,0,1,-4,0
Turkmenistan,2018,Friendly,2,0,1,0,0,1,2,0
Turkmenistan,2019,AFC Asian Cup,3,10,0,3,0,3,-7,0
Turkmenistan,2019,FIFA World Cup qualification,8,5,3,2,0,5,3,0
Turkmenistan,2019,Friendly,1,1,0,0,2,2,0,0
Turkmenistan,2021,FIFA World Cup qualification,3,7,1,1,0,2,-4,0
Turkmenistan,2022,AFC Asian Cup qualification,3,5,1,2,0,3,-2,0
Turkmenistan,2022,Friendly,0,1,0,1,0,1,-1,0
Turkmenistan,2023,CAFA Nations Cup,1,5,0,2,1,3,-4,0
Turkmenistan,2023,FIFA World Cup qualification,3,5,0,1,1,2,-2,0
Turkmenistan,2023,Friendly,1,4,0,2,1,3,-3,0
Turkmenistan,2024,FIFA World Cup qualification,1,9,0,3,1,4,-8,0
Turkmenistan,2024,Friendly,0,2,0,1,0,1,-2,0
Turkmenistan,2025,AFC Asian Cup qualification,2,1,1,0,0,1,1,0
Turks and Caicos Islands,1999,CFU Caribbean Cup qualification,2,5,0,1,1,2,-3,0
Turks and Caicos Islands,2000,FIFA World Cup qualification,0,14,0,2,0,2,-14,0
Turks and Caicos Islands,2000,Friendly,0,3,0,1,0,1,-3,0
Turks and Caicos Islands,2004,FIFA World Cup qualification,0,7,0,2,0,2,-7,0
Turks and Caicos Islands,2006,CFU Caribbean Cup qualification,4,9,1,2,0,3,-5,0
Turks and Caicos Islands,2008,FIFA World Cup qualification,2,3,1,1,0,2,-1,0
Turks and Caicos Islands,2011,FIFA World Cup qualification,0,10,0,2,0,2,-10,0
Turks and Caicos Islands,2014,CFU Caribbean Cup qualification,2,7,1,2,0,3,-5,0
Turks and Caicos Islands,2015,FIFA World Cup qualification,4,12,0,2,0,2,-8,0
Turks and Caicos Islands,2018,CONCACAF Nations League qualification,3,21,1,2,0,3,-18,0
Turks and Caicos Islands,2018,Friendly,0,4,0,1,0,1,-4,0
Turks and Caicos Islands,2019,CONCACAF Nations League,8,17,2,2,0,4,-9,0
Turks and Caicos Islands,2019,CONCACAF Nations League qualification,2,2,0,0,1,1,0,0
Turks and Caicos Islands,2019,Friendly,1,6,0,1,0,1,-5,0
Turks and Caicos Islands,2021,FIFA World Cup qualification,0,22,0,3,0,3,-22,0
Turks and Caicos Islands,2022,CONCACAF Nations League,7,15,1,3,0,4,-8,0
Turks and Caicos Islands,2022,Friendly,4,5,1,1,0,2,-1,0
Turks and Caicos Islands,2023,CONCACAF Nations League,6,11,2,3,1,6,-5,0
Turks and Caicos Islands,2024,CONCACAF Nations League,2,10,1,3,0,4,-8,0
Turks and Caicos Islands,2024,FIFA World Cup qualification,1,1,0,0,2,2,0,0
Tuvalu,1979,South Pacific Games,10,42,1,3,1,5,-32,0
Tuvalu,2003,Friendly,0,9,0,1,0,1,-9,0
Tuvalu,2003,South Pacific Games,3,11,1,3,0,4,-8,0
Tuvalu,2007,South Pacific Games,2,22,0,3,1,4,-20,0
Tuvalu,2011,Friendly,3,0,1,0,0,1,3,0
Tuvalu,2011,Pacific Games,7,20,1,3,1,5,-13,0
Tuvalu,2017,Pacific Mini Games,6,28,2,3,0,5,-22,1
Tuvalu,2018,CONIFA World Football Cup,4,24,0,5,0,5,-20,0
Tuvalu,2019,Pacific Games,2,42,0,4,1,5,-40,0
Tuvalu,2023,Pacific Games,8,10,2,2,0,4,-2,0
Two Sicilies,2010,Viva World Cup,2,8,1,3,0,4,-6,0
Two Sicilies,2023,CONIFA World Football Cup qualification,1,10,0,2,0,2,-9,0
Uganda,1926,Friendly,2,3,0,1,1,2,-1,0
Uganda,1928,Friendly,4,0,1,0,0,1,4,0
Uganda,1929,Friendly,5,3,1,0,0,1,2,0
Uganda,1930,Friendly,5,0,1,0,1,2,5,0
Uganda,1931,Friendly,1,2,0,1,0,1,-1,0
Uganda,1932,Friendly,13,1,1,0,0,1,12,0
Uganda,1935,Friendly,8,2,2,0,0,2,6,0
Uganda,1937,Friendly,9,5,1,0,0,1,4,0
Uganda,1938,Friendly,3,1,1,0,0,1,2,0
Uganda,1939,Friendly,5,2,1,0,0,1,3,0
Uganda,1940,Friendly,6,3,1,0,0,1,3,0
Uganda,1941,Friendly,3,4,0,1,0,1,-1,0
Uganda,1942,Friendly,3,4,0,1,0,1,-1,0
Uganda,1943,Friendly,2,1,1,0,0,1,1,0
Uganda,1944,Friendly,1,2,0,1,0,1,-1,0
Uganda,1945,Friendly,18,1,3,0,0,3,17,0
Uganda,1946,Friendly,1,2,0,1,0,1,-1,0
Uganda,1947,Friendly,7,4,2,0,0,2,3,0
Uganda,1948,Friendly,8,1,2,0,0,2,7,0
Uganda,1950,Friendly,1,3,0,1,0,1,-2,0
Uganda,1951,Friendly,1,2,0,1,0,1,-1,0
Uganda,1952,Friendly,10,3,2,0,0,2,7,0
Uganda,1953,Friendly,16,8,2,1,0,3,8,0
Uganda,1954,Friendly,11,6,2,0,1,3,5,0
Uganda,1955,Friendly,6,1,2,0,0,2,5,0
Uganda,1956,Friendly,8,4,2,0,0,2,4,0
Uganda,1957,Friendly,6,3,2,0,0,2,3,0
Uganda,1958,Friendly,3,3,1,1,1,3,0,0
Uganda,1959,Friendly,2,3,0,1,2,3,-1,0
Uganda,1960,Friendly,5,1,2,0,1,3,4,0
Uganda,1961,African Cup of Nations qualification,3,1,2,1,0,3,2,0
Uganda,1961,Friendly,7,10,2,3,0,5,-3,0
Uganda,1962,African Cup of Nations,1,5,0,2,0,2,-4,0
Uganda,1962,Friendly,6,12,1,3,0,4,-6,0
Uganda,1963,Friendly,20,10,4,1,2,7,10,0
Uganda,1964,Friendly,14,14,3,2,0,5,0,0
Uganda,1964,Zambian Independence Tournament,5,2,2,0,0,2,3,0
Uganda,1965,African Cup of Nations qualification,3,11,0,4,0,4,-8,0
Uganda,1965,All-African Games,10,14,1,3,1,5,-4,0
Uganda,1965,Friendly,9,6,1,0,3,4,3,0
Uganda,1966,Friendly,10,15,1,4,3,8,-5,0
Uganda,1967,African Cup of Nations qualification,5,5,1,1,1,3,0,0
Uganda,1967,Friendly,8,15,2,4,0,6,-7,0
Uganda,1968,African Cup of Nations,2,8,0,3,0,3,-6,0
Uganda,1968,Friendly,13,12,2,3,4,9,1,0
Uganda,1969,African Cup of Nations qualification,2,3,1,1,0,2,-1,0
Uganda,1969,Friendly,22,5,5,1,0,6,17,0
Uganda,1970,African Cup of Nations qualification,1,5,0,2,0,2,-4,0
Uganda,1970,Friendly,8,3,3,0,1,4,5,0
Uganda,1971,Friendly,8,9,2,2,2,6,-1,0
Uganda,1972,Friendly,10,5,3,1,1,5,5,0
Uganda,1973,African Cup of Nations qualification,6,3,3,0,1,4,3,0
Uganda,1973,CECAFA Cup,11,4,3,0,1,4,7,1
Uganda,1973,Friendly,9,6,2,1,1,4,3,0
Uganda,1974,African Cup of Nations,3,5,0,2,1,3,-2,0
Uganda,1974,CECAFA Cup,4,3,1,0,2,3,1,0
Uganda,1974,Friendly,0,2,0,1,0,1,-2,0
Uganda,1975,African Cup of Nations qualification,9,3,2,1,1,4,6,1
Uganda,1975,CECAFA Cup,3,3,1,1,1,3,0,0
Uganda,1975,Friendly,1,3,0,2,0,2,-2,0
Uganda,1976,African Cup of Nations,2,6,0,3,0,3,-4,0
Uganda,1976,CECAFA Cup,9,4,4,1,0,5,5,1
Uganda,1976,Friendly,10,3,4,0,1,5,7,0
Uganda,1977,African Cup of Nations qualification,2,1,1,0,1,2,1,0
Uganda,1977,CECAFA Cup,5,1,3,0,1,4,4,0
Uganda,1977,FIFA World Cup qualification,3,4,1,1,0,2,-1,0
Uganda,1977,Friendly,1,1,0,0,1,1,0,0
Uganda,1978,African Cup of Nations,9,7,3,2,0,5,2,0
Uganda,1978,CECAFA Cup,6,10,2,3,1,6,-4,0
Uganda,1979,CECAFA Cup,5,10,0,3,0,3,-5,0
Uganda,1981,CECAFA Cup,6,7,1,2,1,4,-1,0
Uganda,1981,Friendly,3,2,1,0,1,2,1,0
Uganda,1982,African Cup of Nations qualification,4,3,1,0,1,2,1,0
Uganda,1982,CECAFA Cup,8,3,3,0,2,5,5,0
Uganda,1982,Friendly,4,5,1,2,1,4,-1,0
Uganda,1983,African Cup of Nations qualification,1,3,0,2,0,2,-2,0
Uganda,1983,CECAFA Cup,8,7,3,2,1,6,1,0
Uganda,1983,Friendly,2,2,1,1,0,2,0,0
Uganda,1984,African Cup of Nations qualification,2,3,1,1,0,2,-1,0
Uganda,1984,CECAFA Cup,9,6,2,1,2,5,3,0
Uganda,1984,FIFA World Cup qualification,1,3,1,1,0,2,-2,0
Uganda,1984,Friendly,0,1,0,1,0,1,-1,0
Uganda,1985,CECAFA Cup,4,4,1,2,1,4,0,0
Uganda,1985,Friendly,1,0,1,0,0,1,1,0
Uganda,1986,African Cup of Nations qualification,5,0,1,0,1,2,5,0
Uganda,1986,Friendly,5,3,2,1,2,5,2,0
Uganda,1987,African Cup of Nations qualification,4,6,1,1,0,2,-2,0
Uganda,1987,CECAFA Cup,8,3,3,1,1,5,5,0
Uganda,1988,CECAFA Cup,1,5,0,2,1,3,-4,0
Uganda,1988,FIFA World Cup qualification,2,3,1,1,0,2,-1,0
Uganda,1989,CECAFA Cup,13,8,2,1,2,5,5,0
Uganda,1989,Friendly,6,4,1,0,3,4,2,0
Uganda,1990,African Cup of Nations qualification,2,2,1,1,0,2,0,0
Uganda,1990,CECAFA Cup,6,4,1,0,2,3,2,1
Uganda,1990,Friendly,6,3,1,0,2,3,3,0
Uganda,1991,African Cup of Nations qualification,4,4,1,1,2,4,0,0
Uganda,1991,CECAFA Cup,11,4,3,1,0,4,7,0
Uganda,1991,Friendly,3,16,0,5,1,6,-13,0
Uganda,1992,African Cup of Nations qualification,3,3,1,1,0,2,0,0
Uganda,1992,CECAFA Cup,6,3,1,0,1,2,3,0
Uganda,1992,Friendly,0,0,0,0,1,1,0,0
Uganda,1993,African Cup of Nations qualification,4,3,1,0,3,4,1,0
Uganda,1993,Friendly,6,4,2,2,0,4,2,0
Uganda,1994,African Cup of Nations qualification,5,6,1,1,1,3,-1,0
Uganda,1994,CECAFA Cup,3,0,2,0,1,3,3,0
Uganda,1994,Friendly,2,2,0,0,1,1,0,0
Uganda,1995,African Cup of Nations qualification,6,10,2,2,3,7,-4,0
Uganda,1995,CECAFA Cup,0,1,0,1,2,3,-1,0
Uganda,1996,African Cup of Nations qualification,2,2,0,0,2,2,0,0
Uganda,1996,CECAFA Cup,4,1,2,0,1,3,3,1
Uganda,1996,FIFA World Cup qualification,1,5,0,2,0,2,-4,0
Uganda,1996,Friendly,6,6,1,1,3,5,0,0
Uganda,1997,Friendly,0,0,0,0,1,1,0,0
Uganda,1998,African Cup of Nations qualification,5,0,1,0,1,2,5,0
Uganda,1998,Friendly,6,3,1,0,1,2,3,0
Uganda,1999,African Cup of Nations qualification,1,6,1,3,0,4,-5,0
Uganda,1999,CECAFA Cup,2,1,1,1,1,3,1,0
Uganda,1999,Friendly,2,2,1,2,0,3,0,0
Uganda,2000,African Cup of Nations qualification,5,5,2,1,0,3,0,0
Uganda,2000,CECAFA Cup,20,4,4,0,1,5,16,1
Uganda,2000,FIFA World Cup qualification,4,7,0,1,1,2,-3,0
Uganda,2000,Friendly,10,9,3,1,2,6,1,0
Uganda,2001,African Cup of Nations qualification,1,7,0,2,1,3,-6,0
Uganda,2001,CECAFA Cup,12,7,1,3,0,4,5,0
Uganda,2001,Friendly,2,4,1,2,1,4,-2,0
Uganda,2002,African Cup of Nations qualification,1,0,1,0,0,1,1,0
Uganda,2002,CECAFA Cup,11,6,4,2,0,6,5,0
Uganda,2002,Friendly,9,8,2,2,5,9,1,0
Uganda,2003,African Cup of Nations qualification,1,2,0,1,2,3,-1,0
Uganda,2003,CECAFA Cup,5,2,2,0,2,4,3,1
Uganda,2003,FIFA World Cup qualification,4,3,1,1,0,2,1,0
Uganda,2003,Friendly,8,6,3,1,3,7,2,0
Uganda,2004,CECAFA Cup,4,3,1,1,1,3,1,0
Uganda,2004,FIFA World Cup qualification,2,5,1,3,1,5,-3,0
Uganda,2004,Friendly,5,12,0,4,2,6,-7,0
Uganda,2005,CECAFA Cup,16,2,3,1,2,6,14,0
Uganda,2005,FIFA World Cup qualification,4,10,1,3,1,5,-6,0
Uganda,2005,Friendly,2,6,1,2,0,3,-4,1
Uganda,2006,African Cup of Nations qualification,3,0,1,0,1,2,3,0
Uganda,2006,CECAFA Cup,7,3,3,0,3,6,4,0
Uganda,2006,Friendly,3,4,0,1,3,4,-1,0
Uganda,2007,African Cup of Nations qualification,5,3,2,1,1,4,2,0
Uganda,2007,CECAFA Cup,14,5,3,2,1,6,9,0
Uganda,2007,Friendly,1,2,0,1,1,2,-1,0
Uganda,2008,FIFA World Cup qualification,8,9,3,2,1,6,-1,0
Uganda,2008,Friendly,1,1,0,0,1,1,0,0
Uganda,2009,CECAFA Cup,25,2,10,0,2,12,23,0
Uganda,2009,Friendly,5,3,2,1,0,3,2,0
Uganda,2010,African Cup of Nations qualification,3,0,1,0,1,2,3,0
Uganda,2010,CECAFA Cup,11,7,3,0,3,6,4,1
Uganda,2010,Friendly,6,5,1,0,4,5,1,0
Uganda,2011,African Cup of Nations qualification,3,2,2,1,1,4,1,0
Uganda,2011,CECAFA Cup,12,5,4,1,1,6,7,0
Uganda,2011,Friendly,1,0,1,0,1,2,1,0
Uganda,2011,Nile Basin Tournament,6,6,2,2,1,5,0,0
Uganda,2012,African Cup of Nations qualification,6,4,2,2,0,4,2,0
Uganda,2012,CECAFA Cup,13,1,6,0,0,6,12,1
Uganda,2012,FIFA World Cup qualification,2,2,0,0,2,2,0,0
Uganda,2012,Friendly,3,4,0,1,2,3,-1,0
Uganda,2013,CECAFA Cup,7,2,3,0,1,4,5,0
Uganda,2013,FIFA World Cup qualification,3,4,2,2,0,4,-1,0
Uganda,2013,Friendly,5,11,1,3,2,6,-6,0
Uganda,2014,African Cup of Nations qualification,9,7,5,4,1,10,2,0
Uganda,2014,Friendly,5,4,2,2,1,5,1,0
Uganda,2015,African Cup of Nations qualification,3,0,2,0,0,2,3,0
Uganda,2015,CECAFA Cup,8,2,4,1,1,6,6,1
Uganda,2015,FIFA World Cup qualification,4,0,2,0,0,2,4,0
Uganda,2015,Friendly,2,2,1,1,1,3,0,0
Uganda,2016,African Cup of Nations qualification,3,2,2,1,1,4,1,0
Uganda,2016,FIFA World Cup qualification,1,0,1,0,1,2,1,0
Uganda,2016,Friendly,0,4,0,3,2,5,-4,0
Uganda,2017,African Cup of Nations,1,3,0,2,1,3,-2,0
Uganda,2017,African Cup of Nations qualification,1,0,1,0,0,1,1,0
Uganda,2017,CECAFA Cup,9,5,2,1,2,5,4,0
Uganda,2017,FIFA World Cup qualification,2,2,1,1,2,4,0,0
Uganda,2017,Friendly,1,6,0,2,3,5,-5,0
Uganda,2018,African Cup of Nations qualification,6,0,3,0,1,4,6,0
Uganda,2018,Friendly,4,4,1,2,2,5,0,0
Uganda,2019,African Cup of Nations,3,4,1,2,1,4,-1,0
Uganda,2019,African Cup of Nations qualification,2,3,1,1,1,3,-1,0
Uganda,2019,COSAFA Cup,1,1,0,0,2,2,0,0
Uganda,2019,Friendly,3,1,2,0,2,4,2,0
Uganda,2020,African Cup of Nations qualification,1,1,1,1,0,2,0,0
Uganda,2021,African Cup of Nations qualification,0,1,0,1,1,2,-1,0
Uganda,2021,FIFA World Cup qualification,3,2,2,1,3,6,1,0
Uganda,2021,Friendly,5,5,1,2,0,3,0,0
Uganda,2022,African Cup of Nations qualification,1,3,0,1,1,2,-2,0
Uganda,2022,Friendly,5,8,1,3,2,6,-3,0
Uganda,2022,Navruz Cup,3,5,0,1,1,2,-2,0
Uganda,2023,African Cup of Nations qualification,4,3,2,2,0,4,1,0
Uganda,2023,FIFA World Cup qualification,2,2,1,1,0,2,0,0
Uganda,2023,Friendly,0,5,0,3,0,3,-5,0
Uganda,2024,African Cup of Nations qualification,7,3,3,0,1,4,4,0
Uganda,2024,FIFA World Cup qualification,2,2,1,1,0,2,0,0
Uganda,2024,Friendly,2,4,1,1,0,2,-2,0
Uganda,2025,FIFA World Cup qualification,2,3,1,1,0,2,-1,0
Ukraine,1928,Friendly,6,2,1,0,0,1,4,0
Ukraine,1979,Friendly,2,0,1,0,1,2,2,0
Ukraine,1992,Friendly,3,6,0,2,2,4,-3,0
Ukraine,1993,Friendly,8,8,3,2,1,6,0,0
Ukraine,1994,Friendly,5,7,1,3,2,6,-2,0
Ukraine,1994,UEFA Euro qualification,3,2,1,1,1,3,1,0
Ukraine,1995,UEFA Euro qualification,8,13,3,4,0,7,-5,0
Ukraine,1996,FIFA World Cup qualification,3,2,2,1,0,3,1,0
Ukraine,1996,Friendly,9,7,1,1,1,3,2,0
Ukraine,1997,FIFA World Cup qualification,8,7,4,2,3,9,1,0
Ukraine,1998,Friendly,5,2,1,1,0,2,3,0
Ukraine,1998,UEFA Euro qualification,7,2,3,0,0,3,5,0
Ukraine,1999,Friendly,2,1,1,0,1,2,1,0
Ukraine,1999,UEFA Euro qualification,9,5,2,1,6,9,4,0
Ukraine,2000,FIFA World Cup qualification,5,5,2,1,0,3,0,0
Ukraine,2000,Friendly,1,2,1,1,0,2,-1,0
Ukraine,2001,Cyprus International Tournament,3,5,0,2,0,2,-2,0
Ukraine,2001,FIFA World Cup qualification,10,8,2,1,6,9,2,0
Ukraine,2001,Friendly,1,0,1,0,1,2,1,0
Ukraine,2002,Friendly,6,10,2,4,1,7,-4,0
Ukraine,2002,UEFA Euro qualification,4,2,1,0,2,3,2,0
Ukraine,2003,Friendly,1,3,1,2,2,5,-2,0
Ukraine,2003,UEFA Euro qualification,7,8,1,2,2,5,-1,0
Ukraine,2004,FIFA World Cup qualification,9,3,3,0,2,5,6,0
Ukraine,2004,Friendly,2,7,0,3,2,5,-5,0
Ukraine,2005,FIFA World Cup qualification,9,4,4,1,2,7,5,0
Ukraine,2005,Friendly,3,1,2,0,1,3,2,0
Ukraine,2006,FIFA World Cup,5,7,2,2,1,5,-2,0
Ukraine,2006,Friendly,16,0,4,0,2,6,16,0
Ukraine,2006,UEFA Euro qualification,5,4,2,1,0,3,1,0
Ukraine,2007,Friendly,3,2,1,0,1,2,1,0
Ukraine,2007,UEFA Euro qualification,13,12,3,4,2,9,1,0
Ukraine,2008,FIFA World Cup qualification,4,1,2,0,1,3,3,0
Ukraine,2008,Friendly,6,4,4,1,1,6,2,0
Ukraine,2009,Cyprus International Tournament,4,2,2,0,0,2,2,0
Ukraine,2009,FIFA World Cup qualification,17,6,4,2,3,9,11,0
Ukraine,2009,Friendly,0,3,0,1,0,1,-3,0
Ukraine,2010,Friendly,16,11,4,1,4,9,5,0
Ukraine,2011,Cyprus International Tournament,3,3,0,0,2,2,0,0
Ukraine,2011,Friendly,15,18,4,5,1,10,-3,0
Ukraine,2012,FIFA World Cup qualification,1,2,0,1,2,3,-1,0
Ukraine,2012,Friendly,10,7,3,2,1,6,3,0
Ukraine,2012,UEFA Euro,2,4,1,2,0,3,-2,0
Ukraine,2013,FIFA World Cup qualification,29,5,7,1,1,9,24,0
Ukraine,2013,Friendly,4,0,2,0,1,3,4,0
Ukraine,2014,Friendly,5,1,3,0,1,4,4,0
Ukraine,2014,UEFA Euro qualification,6,1,3,1,0,4,5,0
Ukraine,2015,Friendly,3,2,1,0,1,2,1,0
Ukraine,2015,UEFA Euro qualification,11,4,4,2,2,8,7,0
Ukraine,2016,FIFA World Cup qualification,7,3,2,0,2,4,4,0
Ukraine,2016,Friendly,11,4,5,0,0,5,7,0
Ukraine,2016,UEFA Euro,0,5,0,3,0,3,-5,0
Ukraine,2017,FIFA World Cup qualification,6,6,3,3,0,6,0,0
Ukraine,2017,Friendly,2,2,1,1,0,2,0,0
Ukraine,2018,Friendly,8,4,2,0,4,6,4,0
Ukraine,2018,UEFA Nations League,5,5,3,1,0,4,0,0
Ukraine,2019,Friendly,3,2,1,0,1,2,1,0
Ukraine,2019,UEFA Euro qualification,17,4,6,0,2,8,13,0
Ukraine,2020,Friendly,1,9,0,2,0,2,-8,0
Ukraine,2020,UEFA Nations League,5,13,2,4,0,6,-8,0
Ukraine,2021,FIFA World Cup qualification,11,8,2,0,6,8,3,0
Ukraine,2021,Friendly,8,3,2,0,3,5,5,0
Ukraine,2021,UEFA Euro,6,10,2,3,0,5,-4,0
Ukraine,2022,FIFA World Cup qualification,3,2,1,1,0,2,1,0
Ukraine,2022,UEFA Nations League,10,4,3,1,2,6,6,0
Ukraine,2023,Friendly,3,3,0,0,1,1,0,0
Ukraine,2023,UEFA Euro qualification,11,8,4,2,2,8,3,0
Ukraine,2024,Friendly,5,3,1,1,1,3,2,0
Ukraine,2024,UEFA Euro,2,4,1,1,1,3,-2,0
Ukraine,2024,UEFA Euro qualification,4,2,2,0,0,2,2,0
Ukraine,2024,UEFA Nations League,8,8,2,2,2,6,0,0
Ukraine,2025,UEFA Nations League,3,4,1,1,0,2,-1,0
United Arab Emirates,1972,Gulf Cup,1,13,1,3,0,4,-12,0
United Arab Emirates,1973,Palestine Cup,4,8,0,2,2,4,-4,0
United Arab Emirates,1974,Gulf Cup,5,11,1,3,1,5,-6,0
United Arab Emirates,1975,Palestine Cup,0,8,0,2,0,2,-8,0
United Arab Emirates,1976,Gulf Cup,4,13,0,4,2,6,-9,0
United Arab Emirates,1979,Friendly,0,0,0,0,1,1,0,0
United Arab Emirates,1979,Gulf Cup,5,18,1,5,0,6,-13,1
United Arab Emirates,1980,AFC Asian Cup,3,9,0,3,1,4,-6,0
United Arab Emirates,1980,Friendly,0,5,0,2,0,2,-5,0
United Arab Emirates,1981,Friendly,6,5,2,1,0,3,1,0
United Arab Emirates,1981,Merdeka Tournament,6,10,2,3,0,5,-4,0
United Arab Emirates,1982,Friendly,8,4,2,1,1,4,4,0
United Arab Emirates,1982,Gulf Cup,7,6,3,2,0,5,1,0
United Arab Emirates,1982,Merdeka Tournament,5,8,1,3,0,4,-3,0
United Arab Emirates,1984,AFC Asian Cup,3,8,2,2,0,4,-5,0
United Arab Emirates,1984,AFC Asian Cup qualification,24,2,3,1,0,4,22,1
United Arab Emirates,1984,Friendly,2,1,1,0,0,1,1,0
United Arab Emirates,1984,Gulf Cup,5,4,2,1,3,6,1,0
United Arab Emirates,1985,FIFA World Cup qualification,5,4,2,1,1,4,1,0
United Arab Emirates,1985,Friendly,7,5,1,2,0,3,2,0
United Arab Emirates,1986,Asian Games,7,4,3,0,2,5,3,0
United Arab Emirates,1986,Gulf Cup,10,7,3,2,1,6,3,0
United Arab Emirates,1987,Friendly,3,2,1,0,1,2,1,0
United Arab Emirates,1988,AFC Asian Cup,2,4,1,3,0,4,-2,0
United Arab Emirates,1988,AFC Asian Cup qualification,12,1,4,0,1,5,11,0
United Arab Emirates,1988,Friendly,12,13,4,3,3,10,-1,0
United Arab Emirates,1988,Gulf Cup,7,4,3,1,2,6,3,0
United Arab Emirates,1989,FIFA World Cup qualification,16,7,4,1,4,9,9,0
United Arab Emirates,1990,FIFA World Cup,2,11,0,3,0,3,-9,0
United Arab Emirates,1990,Friendly,6,14,2,4,2,8,-8,0
United Arab Emirates,1990,Gulf Cup,2,8,0,2,2,4,-6,0
United Arab Emirates,1992,AFC Asian Cup,3,4,1,1,3,5,-1,0
United Arab Emirates,1992,Friendly,6,4,2,1,5,8,2,0
United Arab Emirates,1992,Gulf Cup,4,3,3,2,0,5,1,0
United Arab Emirates,1993,FIFA World Cup qualification,19,4,6,1,1,8,15,0
United Arab Emirates,1993,Friendly,5,6,3,2,0,5,-1,0
United Arab Emirates,1994,Asian Games,6,5,1,1,2,4,1,0
United Arab Emirates,1994,Friendly,4,7,1,3,2,6,-3,0
United Arab Emirates,1994,Gulf Cup,7,1,3,0,2,5,6,1
United Arab Emirates,1994,United Arab Emirates Friendship Tournament,1,3,0,2,1,3,-2,0
United Arab Emirates,1996,AFC Asian Cup,8,3,4,0,2,6,5,0
United Arab Emirates,1996,Friendly,15,15,5,4,3,12,0,0
United Arab Emirates,1996,Gulf Cup,5,5,1,1,3,5,0,0
United Arab Emirates,1996,United Arab Emirates Friendship Tournament,4,2,2,0,1,3,2,1
United Arab Emirates,1997,Confederations Cup,2,8,1,2,0,3,-6,0
United Arab Emirates,1997,FIFA World Cup qualification,16,13,5,3,4,12,3,0
United Arab Emirates,1997,Friendly,6,6,2,1,0,3,0,0
United Arab Emirates,1998,Arab Cup,6,7,1,2,0,3,-1,0
United Arab Emirates,1998,Asian Games,5,10,1,2,1,4,-5,0
United Arab Emirates,1998,Friendly,9,1,2,0,0,2,8,0
United Arab Emirates,1998,Gulf Cup,5,7,2,2,1,5,-2,0
United Arab Emirates,1998,United Arab Emirates Friendship Tournament,4,1,3,0,0,3,3,1
United Arab Emirates,1999,AFC Asian Cup qualification,12,2,3,1,0,4,10,1
United Arab Emirates,1999,Friendly,0,1,0,1,0,1,-1,0
United Arab Emirates,1999,United Arab Emirates Friendship Tournament,7,5,1,0,2,3,2,0
United Arab Emirates,2000,Friendly,9,13,3,2,3,8,-4,0
United Arab Emirates,2000,United Arab Emirates Friendship Tournament,2,1,1,0,1,2,1,0
United Arab Emirates,2001,FIFA World Cup qualification,31,20,7,7,2,16,11,0
United Arab Emirates,2001,Friendly,6,7,1,3,1,5,-1,0
United Arab Emirates,2001,United Arab Emirates Friendship Tournament,2,5,0,1,1,2,-3,0
United Arab Emirates,2002,Friendly,2,4,0,2,0,2,-2,0
United Arab Emirates,2002,Gulf Cup,3,7,1,4,0,5,-4,0
United Arab Emirates,2003,AFC Asian Cup qualification,13,5,4,1,1,6,8,0
United Arab Emirates,2003,Friendly,8,8,0,0,4,4,0,0
United Arab Emirates,2003,Gulf Cup,2,4,1,2,0,3,-2,0
United Arab Emirates,2004,AFC Asian Cup,1,5,0,2,1,3,-4,0
United Arab Emirates,2004,FIFA World Cup qualification,6,6,3,2,1,6,0,0
United Arab Emirates,2004,Friendly,13,11,2,3,2,7,2,0
United Arab Emirates,2004,Gulf Cup,8,8,1,2,3,6,0,0
United Arab Emirates,2005,Friendly,8,14,1,2,5,8,-6,0
United Arab Emirates,2005,Kirin Cup,1,0,1,0,1,2,1,1
United Arab Emirates,2006,AFC Asian Cup qualification,11,6,4,1,1,6,5,0
United Arab Emirates,2006,Friendly,6,10,2,4,0,6,-4,0
United Arab Emirates,2007,AFC Asian Cup,3,6,1,2,0,3,-3,0
United Arab Emirates,2007,FIFA World Cup qualification,6,0,2,0,0,2,6,0
United Arab Emirates,2007,Friendly,9,15,2,4,4,10,-6,0
United Arab Emirates,2007,Gulf Cup,8,5,4,1,0,5,3,1
United Arab Emirates,2008,FIFA World Cup qualification,11,16,2,5,3,10,-5,0
United Arab Emirates,2008,Friendly,6,9,0,3,5,8,-3,0
United Arab Emirates,2009,AFC Asian Cup qualification,5,1,1,1,0,2,4,0
United Arab Emirates,2009,FIFA World Cup qualification,2,8,0,4,0,4,-6,0
United Arab Emirates,2009,Friendly,6,10,1,2,3,6,-4,0
United Arab Emirates,2009,Gulf Cup,3,4,1,1,1,3,-1,0
United Arab Emirates,2010,AFC Asian Cup qualification,2,0,2,0,0,2,2,0
United Arab Emirates,2010,Friendly,11,7,3,3,0,6,4,0
United Arab Emirates,2010,Gulf Cup,3,2,1,1,2,4,1,0
United Arab Emirates,2011,AFC Asian Cup,0,4,0,2,1,3,-4,0
United Arab Emirates,2011,FIFA World Cup qualification,10,14,1,5,1,7,-4,0
United Arab Emirates,2011,Friendly,12,5,3,1,1,5,7,0
United Arab Emirates,2012,FIFA World Cup qualification,4,2,1,0,0,1,2,0
United Arab Emirates,2012,Friendly,22,7,7,1,1,9,15,0
United Arab Emirates,2013,AFC Asian Cup qualification,17,2,5,0,0,5,15,0
United Arab Emirates,2013,Friendly,4,0,1,0,0,1,4,0
United Arab Emirates,2013,Gulf Cup,10,3,5,0,0,5,7,0
United Arab Emirates,2013,OSN Cup,5,3,1,0,1,2,2,1
United Arab Emirates,2014,AFC Asian Cup qualification,1,1,0,0,1,1,0,0
United Arab Emirates,2014,Friendly,9,11,3,2,4,9,-2,0
United Arab Emirates,2014,Gulf Cup,7,5,2,1,2,5,2,0
United Arab Emirates,2015,AFC Asian Cup,10,8,3,2,1,6,2,0
United Arab Emirates,2015,FIFA World Cup qualification,24,3,4,1,1,6,21,0
United Arab Emirates,2015,Friendly,6,4,2,1,0,3,2,0
United Arab Emirates,2016,FIFA World Cup qualification,10,7,4,2,1,7,3,0
United Arab Emirates,2016,Friendly,10,4,3,1,0,4,6,0
United Arab Emirates,2016,King's Cup,1,4,0,2,0,2,-3,0
United Arab Emirates,2017,FIFA World Cup qualification,3,7,1,3,1,5,-4,0
United Arab Emirates,2017,Friendly,5,0,2,0,0,2,5,0
United Arab Emirates,2017,Gulf Cup,1,0,1,0,2,3,1,0
United Arab Emirates,2018,Friendly,7,9,2,4,3,9,-2,0
United Arab Emirates,2018,Gulf Cup,0,0,0,0,2,2,0,0
United Arab Emirates,2019,AFC Asian Cup,8,8,3,1,2,6,0,0
United Arab Emirates,2019,FIFA World Cup qualification,8,4,2,2,0,4,4,0
United Arab Emirates,2019,Friendly,11,2,3,0,1,4,9,0
United Arab Emirates,2019,Gulf Cup,5,6,1,2,0,3,-1,0
United Arab Emirates,2020,Friendly,5,7,1,2,0,3,-2,0
United Arab Emirates,2021,Arab Cup,3,7,2,2,0,4,-4,0
United Arab Emirates,2021,FIFA World Cup qualification,19,8,5,2,3,10,11,0
United Arab Emirates,2021,Friendly,11,1,2,0,1,3,10,0
United Arab Emirates,2022,FIFA World Cup qualification,4,4,2,3,0,5,0,0
United Arab Emirates,2022,Friendly,4,12,2,3,1,6,-8,1
United Arab Emirates,2023,FIFA World Cup qualification,6,0,2,0,0,2,6,0
United Arab Emirates,2023,Friendly,9,2,4,0,1,5,7,0
United Arab Emirates,2023,Gulf Cup,2,4,0,2,1,3,-2,0
United Arab Emirates,2024,AFC Asian Cup,6,5,1,1,2,4,1,0
United Arab Emirates,2024,FIFA World Cup qualification,22,6,6,2,2,10,16,0
United Arab Emirates,2024,Friendly,0,1,0,1,0,1,-1,0
United Arab Emirates,2024,Gulf Cup,3,4,0,1,2,3,-1,0
United Arab Emirates,2025,FIFA World Cup qualification,2,3,1,1,0,2,-1,0
United Koreans in Japan,2016,CONIFA World Football Cup,4,7,1,2,2,5,-3,0
United Koreans in Japan,2016,Friendly,9,0,1,0,0,1,9,0
United Koreans in Japan,2018,CONIFA World Football Cup,7,4,1,1,4,6,3,0
United States,1885,Friendly,0,1,0,1,0,1,-1,0
United States,1886,Friendly,3,2,1,0,0,1,1,1
United States,1916,Friendly,4,3,1,0,1,2,1,0
United States,1919,Inter-Allied Games,7,19,1,2,0,3,-12,0
United States,1924,Friendly,3,2,1,0,0,1,1,0
United States,1924,Olympic Games,1,3,1,1,0,2,-2,0
United States,1925,Friendly,6,2,1,1,0,2,4,0
United States,1926,Friendly,6,2,1,0,0,1,4,0
United States,1928,Friendly,3,3,0,0,1,1,0,0
United States,1928,Olympic Games,2,11,0,1,0,1,-9,0
United States,1930,FIFA World Cup,7,6,2,1,0,3,1,0
United States,1930,Friendly,3,4,0,1,0,1,-1,0
United States,1934,FIFA World Cup,1,7,0,1,0,1,-6,0
United States,1934,FIFA World Cup qualification,4,2,1,0,0,1,2,1
United States,1935,Friendly,2,9,0,2,0,2,-7,0
United States,1937,Friendly,5,14,0,2,0,2,-9,0
United States,1947,NAFC Championship,2,10,0,2,0,2,-8,0
United States,1948,Friendly,3,17,1,2,0,3,-14,0
United States,1949,FIFA World Cup qualification,7,8,1,1,0,2,-1,0
United States,1949,Friendly,0,4,0,1,0,1,-4,0
United States,1949,NAFC Championship,1,7,0,1,1,2,-6,0
United States,1950,FIFA World Cup,4,8,1,2,0,3,-4,0
United States,1952,Friendly,0,6,0,1,0,1,-6,0
United States,1953,Friendly,3,6,0,1,0,1,-3,0
United States,1954,FIFA World Cup qualification,7,9,2,2,0,4,-2,1
United States,1955,Friendly,2,3,0,1,0,1,-1,0
United States,1956,Friendly,9,8,1,2,0,3,1,0
United States,1957,FIFA World Cup qualification,5,21,0,4,0,4,-16,0
United States,1959,Friendly,1,8,0,1,0,1,-7,0
United States,1960,FIFA World Cup qualification,3,6,0,1,1,2,-3,0
United States,1961,Friendly,0,2,0,1,0,1,-2,0
United States,1964,Friendly,0,10,0,1,0,1,-10,0
United States,1965,FIFA World Cup qualification,4,5,1,1,2,4,-1,0
United States,1968,FIFA World Cup qualification,11,6,3,1,0,4,5,0
United States,1968,Friendly,11,16,1,3,1,5,-5,0
United States,1969,FIFA World Cup qualification,0,3,0,2,0,2,-3,0
United States,1972,CONCACAF Championship qualification,6,10,0,3,1,4,-4,0
United States,1973,Friendly,5,22,3,9,0,12,-17,0
United States,1974,Friendly,1,4,0,2,0,2,-3,0
United States,1975,Friendly,1,32,0,6,0,6,-31,0
United States,1976,CONCACAF Championship qualification,3,7,1,2,2,5,-4,0
United States,1976,Friendly,0,0,0,0,3,3,0,0
United States,1977,Friendly,7,11,3,3,2,8,-4,0
United States,1978,Friendly,0,3,0,2,1,3,-3,0
United States,1979,Friendly,7,13,2,3,0,5,-6,0
United States,1980,CONCACAF Championship qualification,4,8,1,2,1,4,-4,0
United States,1980,Friendly,3,1,1,0,1,2,2,0
United States,1982,Friendly,2,1,1,0,0,1,1,0
United States,1983,Friendly,2,0,1,0,0,1,2,0
United States,1984,CONCACAF Championship qualification,4,0,1,0,1,2,4,1
United States,1984,Friendly,7,9,2,2,3,7,-2,0
United States,1985,CONCACAF Championship,4,3,2,1,1,4,1,0
United States,1985,Friendly,2,9,0,2,2,4,-7,0
United States,1987,Korea Cup,2,4,1,2,0,3,-2,0
United States,1988,CONCACAF Championship qualification,5,1,1,0,1,2,4,0
United States,1988,Friendly,4,13,2,6,2,10,-9,0
United States,1989,CONCACAF Championship,6,3,4,1,3,8,3,1
United States,1989,Friendly,2,2,1,1,0,2,0,0
United States,1989,Marlboro Cup,4,2,1,1,0,2,2,0
United States,1990,FIFA World Cup,2,8,0,3,0,3,-6,0
United States,1990,Friendly,26,20,8,7,2,17,6,0
United States,1990,Miami Cup,1,3,0,1,1,2,-2,0
United States,1991,Friendly,8,7,3,3,3,9,1,0
United States,1991,Gold Cup,10,3,4,0,1,5,7,0
United States,1991,Miami Cup,0,1,0,1,0,1,-1,0
United States,1991,NAFU Championship,4,2,1,0,1,2,2,1
United States,1992,Confederations Cup,5,5,1,1,0,2,0,0
United States,1992,Friendly,11,20,3,10,3,16,-9,0
United States,1992,USA Cup,5,2,2,0,1,3,3,0
United States,1993,Copa América,3,6,0,2,1,3,-3,0
United States,1993,Friendly,27,22,4,7,8,19,5,0
United States,1993,Gold Cup,5,5,4,1,0,5,0,0
United States,1993,Kirin Cup,1,3,0,1,1,2,-2,0
United States,1993,USA Cup,5,6,1,2,0,3,-1,0
United States,1994,FIFA World Cup,3,4,1,2,1,4,-1,0
United States,1994,Friendly,25,18,7,5,8,20,7,0
United States,1994,Joe Robbie Cup,2,4,0,1,1,2,-2,0
United States,1994,Lunar New Year Cup,1,2,0,1,0,1,-1,0
United States,1995,Copa América,6,7,2,3,1,6,-1,0
United States,1995,Friendly,7,9,1,3,1,5,-2,0
United States,1995,USA Cup,7,2,2,0,1,3,5,0
United States,1996,FIFA World Cup qualification,10,5,4,1,1,6,5,0
United States,1996,Friendly,6,6,2,1,0,3,0,0
United States,1996,Gold Cup,8,3,3,1,0,4,5,0
United States,1996,USA Cup,4,5,1,1,1,3,-1,0
United States,1997,FIFA World Cup qualification,17,9,4,1,5,10,8,0
United States,1997,Friendly,4,5,1,2,2,5,-1,0
United States,1997,USA Cup,0,3,0,2,0,2,-3,0
United States,1998,FIFA World Cup,1,5,0,3,0,3,-4,0
United States,1998,Friendly,8,6,3,2,4,9,2,0
United States,1998,Gold Cup,6,2,3,1,0,4,4,0
United States,1999,Confederations Cup,6,3,3,2,0,5,3,0
United States,1999,Friendly,9,5,3,1,2,6,4,0
United States,1999,USA Cup,4,3,1,1,0,2,1,0
United States,2000,FIFA World Cup qualification,14,3,3,1,2,6,11,0
United States,2000,Friendly,6,5,2,1,2,5,1,0
United States,2000,Gold Cup,6,2,2,0,1,3,4,0
United States,2000,USA Cup,8,1,2,0,1,3,7,0
United States,2001,FIFA World Cup qualification,11,8,5,3,2,10,3,0
United States,2001,Friendly,3,5,1,3,1,5,-2,0
United States,2002,FIFA World Cup,7,7,2,2,1,5,0,0
United States,2002,Friendly,17,10,5,4,0,9,7,0
United States,2002,Gold Cup,9,1,4,0,1,5,8,0
United States,2003,Confederations Cup,1,3,0,2,1,3,-2,0
United States,2003,Friendly,14,3,6,1,1,8,11,0
United States,2003,Gold Cup,13,4,4,1,0,5,9,0
United States,2004,FIFA World Cup qualification,19,5,5,0,3,8,14,0
United States,2004,Friendly,8,3,3,1,2,6,5,0
United States,2005,FIFA World Cup qualification,16,6,7,2,1,10,10,0
United States,2005,Friendly,6,3,2,1,1,4,3,0
United States,2005,Gold Cup,11,3,4,0,2,6,8,0
United States,2006,FIFA World Cup,2,6,0,2,1,3,-4,0
United States,2006,Friendly,18,8,6,2,2,10,10,0
United States,2007,Copa América,2,8,0,3,0,3,-6,0
United States,2007,Friendly,13,7,5,2,1,8,6,0
United States,2007,Gold Cup,13,3,6,0,0,6,10,1
United States,2008,FIFA World Cup qualification,23,3,7,1,0,8,20,0
United States,2008,Friendly,7,5,2,2,2,6,2,0
United States,2009,Confederations Cup,8,9,2,3,0,5,-1,0
United States,2009,FIFA World Cup qualification,19,13,6,2,2,10,6,0
United States,2009,Friendly,4,6,1,2,0,3,-2,0
United States,2009,Gold Cup,12,8,4,1,1,6,4,0
United States,2010,FIFA World Cup,5,5,1,1,2,4,0,0
United States,2010,Friendly,14,16,4,4,2,10,-2,0
United States,2011,Friendly,7,14,2,6,3,11,-7,0
United States,2011,Gold Cup,9,6,4,2,0,6,3,0
United States,2012,FIFA World Cup qualification,11,6,4,1,1,6,5,0
United States,2012,Friendly,12,7,5,1,2,8,5,0
United States,2013,FIFA World Cup qualification,15,8,7,2,1,10,7,0
United States,2013,Friendly,10,11,2,2,2,6,-1,0
United States,2013,Gold Cup,20,4,6,0,0,6,16,1
United States,2014,FIFA World Cup,5,6,1,2,1,4,-1,0
United States,2014,Friendly,10,11,4,3,1,8,-1,0
United States,2015,FIFA World Cup qualification,6,1,1,0,0,1,5,0
United States,2015,Friendly,20,19,5,4,1,10,1,0
United States,2015,Gold Cup,12,5,3,1,2,6,7,0
United States,2016,Copa América,7,8,3,3,0,6,-1,0
United States,2016,FIFA World Cup qualification,15,8,3,3,0,6,7,0
United States,2016,Friendly,8,3,3,0,0,3,5,0
United States,2017,FIFA World Cup qualification,16,7,3,2,3,8,9,0
United States,2017,Friendly,4,3,1,0,3,4,1,0
United States,2017,Gold Cup,13,4,5,0,1,6,9,1
United States,2018,Friendly,10,14,3,5,3,11,-4,0
United States,2019,CONCACAF Nations League,15,3,3,1,0,4,12,0
United States,2019,Friendly,8,9,3,3,2,8,-1,0
United States,2019,Gold Cup,15,2,5,1,0,6,13,0
United States,2020,Friendly,13,2,3,0,1,4,11,1
United States,2021,CONCACAF Nations League,4,2,2,0,0,2,2,0
United States,2021,FIFA World Cup qualification,12,5,4,1,3,8,7,0
United States,2021,Friendly,19,4,5,1,0,6,15,0
United States,2021,Gold Cup,11,1,6,0,0,6,10,1
United States,2022,CONCACAF Nations League,6,1,1,0,1,2,5,0
United States,2022,FIFA World Cup,3,4,1,1,2,4,-1,0
United States,2022,FIFA World Cup qualification,9,5,3,2,1,6,4,0
United States,2022,Friendly,3,0,1,0,2,3,3,0
United States,2022,Kirin Challenge Cup,0,2,0,1,0,1,-2,0
United States,2023,CONCACAF Nations League,17,3,5,1,0,6,14,0
United States,2023,Friendly,14,6,3,2,2,7,8,0
United States,2023,Gold Cup,16,4,2,0,3,5,12,0
United States,2024,CONCACAF Nations League,10,3,4,0,0,4,7,0
United States,2024,Copa América,3,3,1,2,0,3,0,0
United States,2024,Friendly,6,12,1,4,2,7,-6,0
United States,2025,CONCACAF Nations League,1,3,0,2,0,2,-2,0
United States,2025,Friendly,6,1,2,0,0,2,5,0
United States Virgin Islands,1998,Friendly,1,0,1,0,0,1,1,0
United States Virgin Islands,1999,CFU Caribbean Cup qualification,2,2,0,0,2,2,0,0
United States Virgin Islands,2000,FIFA World Cup qualification,1,14,0,2,0,2,-13,0
United States Virgin Islands,2000,Friendly,0,11,0,2,0,2,-11,0
United States Virgin Islands,2001,CFU Caribbean Cup qualification,2,37,0,3,0,3,-35,0
United States Virgin Islands,2001,Friendly,0,2,0,1,0,1,-2,0
United States Virgin Islands,2002,Gold Cup qualification,2,11,0,2,0,2,-9,0
United States Virgin Islands,2004,CFU Caribbean Cup qualification,1,22,0,2,1,3,-21,0
United States Virgin Islands,2004,FIFA World Cup qualification,0,11,0,2,0,2,-11,0
United States Virgin Islands,2004,Friendly,1,12,0,3,0,3,-11,0
United States Virgin Islands,2006,CFU Caribbean Cup qualification,1,12,0,2,0,2,-11,0
United States Virgin Islands,2008,FIFA World Cup qualification,0,10,0,1,0,1,-10,0
United States Virgin Islands,2008,Friendly,1,1,0,0,2,2,0,0
United States Virgin Islands,2011,FIFA World Cup qualification,6,41,2,6,0,8,-35,0
United States Virgin Islands,2011,Friendly,0,0,0,0,1,1,0,0
United States Virgin Islands,2014,CFU Caribbean Cup qualification,1,3,0,2,0,2,-2,0
United States Virgin Islands,2015,FIFA World Cup qualification,1,4,1,1,0,2,-3,0
United States Virgin Islands,2015,Friendly,0,2,0,1,0,1,-2,0
United States Virgin Islands,2016,CFU Caribbean Cup qualification,3,17,1,3,0,4,-14,0
United States Virgin Islands,2018,CONCACAF Nations League qualification,0,16,0,3,0,3,-16,0
United States Virgin Islands,2019,CONCACAF Nations League,3,11,1,5,0,6,-8,0
United States Virgin Islands,2019,CONCACAF Nations League qualification,3,0,1,0,0,1,3,0
United States Virgin Islands,2021,FIFA World Cup qualification,0,15,0,4,0,4,-15,0
United States Virgin Islands,2022,CONCACAF Nations League,4,7,1,2,1,4,-3,0
United States Virgin Islands,2023,CONCACAF Nations League,6,14,0,5,1,6,-8,0
United States Virgin Islands,2024,CONCACAF Nations League,4,14,0,3,1,4,-10,0
United States Virgin Islands,2024,FIFA World Cup qualification,1,1,0,0,2,2,0,0
Uruguay,1902,Friendly,0,6,0,1,0,1,-6,0
Uruguay,1903,Friendly,3,2,1,0,0,1,1,0
Uruguay,1905,Copa Lipton,0,0,0,0,1,1,0,0
Uruguay,1906,Copa Lipton,0,2,0,1,0,1,-2,0
Uruguay,1906,Copa Newton,1,2,0,1,0,1,-1,0
Uruguay,1908,Copa Lipton,2,2,0,0,1,1,0,0
Uruguay,1908,Copa Newton,1,2,0,1,0,1,-1,0
Uruguay,1908,Copa Premio Honor Argentino,1,0,1,0,0,1,1,1
Uruguay,1909,Copa Lipton,1,2,0,1,0,1,-1,0
Uruguay,1909,Copa Newton,2,2,0,0,1,1,0,0
Uruguay,1909,Copa Premio Honor Argentino,1,3,0,1,0,1,-2,0
Uruguay,1910,Copa Lipton,3,1,1,0,0,1,2,1
Uruguay,1910,Copa Premio Honor Argentino,7,3,1,0,1,2,4,1
Uruguay,1910,Friendly,4,4,1,1,0,2,0,0
Uruguay,1911,Copa Lipton,2,0,1,0,0,1,2,1
Uruguay,1911,Copa Newton,2,3,0,1,0,1,-1,0
Uruguay,1911,Copa Premio Honor Argentino,0,2,0,1,0,1,-2,0
Uruguay,1911,Copa Premio Honor Uruguayo,4,1,1,0,1,2,3,1
Uruguay,1912,Copa Lipton,2,0,1,0,0,1,2,1
Uruguay,1912,Copa Newton,3,3,0,0,1,1,0,0
Uruguay,1912,Copa Premio Honor Argentino,1,0,1,0,0,1,1,1
Uruguay,1912,Copa Premio Honor Uruguayo,3,0,1,0,0,1,3,1
Uruguay,1912,Friendly,1,3,0,1,0,1,-2,0
Uruguay,1913,Copa Lipton,0,4,0,1,0,1,-4,0
Uruguay,1913,Copa Newton,1,0,1,0,0,1,1,1
Uruguay,1913,Copa Premio Honor Argentino,0,2,0,1,0,1,-2,0
Uruguay,1913,Copa Premio Honor Uruguayo,1,0,1,0,0,1,1,1
Uruguay,1913,Friendly,2,3,0,1,1,2,-1,0
Uruguay,1914,Copa Premio Honor Argentino,1,2,0,1,0,1,-1,0
Uruguay,1914,Copa Premio Honor Uruguayo,3,2,1,0,0,1,1,1
Uruguay,1915,Copa Lipton,1,2,0,1,0,1,-1,0
Uruguay,1915,Copa Newton,2,0,1,0,0,1,2,1
Uruguay,1915,Copa Premio Honor Uruguayo,2,3,0,1,0,1,-1,0
Uruguay,1916,Copa América,6,1,2,0,1,3,5,0
Uruguay,1916,Copa Lipton,1,2,0,1,0,1,-1,0
Uruguay,1916,Copa Newton,1,3,0,1,0,1,-2,0
Uruguay,1916,Copa Premio Honor Uruguayo,0,1,0,1,0,1,-1,0
Uruguay,1916,Friendly,9,10,2,2,0,4,-1,0
Uruguay,1917,Copa América,9,0,3,0,0,3,9,1
Uruguay,1917,Copa Lipton,0,1,0,1,0,1,-1,0
Uruguay,1917,Copa Newton,1,0,1,0,0,1,1,1
Uruguay,1917,Copa Premio Honor Uruguayo,0,2,0,1,0,1,-2,0
Uruguay,1917,Friendly,3,1,1,0,0,1,2,0
Uruguay,1918,Copa Lipton,1,1,0,0,1,1,0,0
Uruguay,1918,Copa Newton,0,2,0,1,0,1,-2,0
Uruguay,1918,Copa Premio Honor Argentino,1,2,0,1,1,2,-1,0
Uruguay,1918,Copa Premio Honor Uruguayo,4,2,1,0,1,2,2,1
Uruguay,1919,Copa América,7,5,2,1,1,4,2,0
Uruguay,1919,Copa Lipton,2,1,1,0,0,1,1,1
Uruguay,1919,Copa Newton,2,1,1,0,0,1,1,1
Uruguay,1919,Copa Premio Honor Argentino,1,6,0,1,0,1,-5,0
Uruguay,1919,Copa Premio Honor Uruguayo,4,1,1,0,0,1,3,1
Uruguay,1919,Friendly,4,2,1,0,0,1,2,1
Uruguay,1920,Copa América,9,2,2,0,1,3,7,1
Uruguay,1920,Copa Newton,3,1,1,0,0,1,2,1
Uruguay,1920,Copa Premio Honor Argentino,0,1,0,1,0,1,-1,0
Uruguay,1920,Copa Premio Honor Uruguayo,2,0,1,0,0,1,2,1
Uruguay,1921,Copa América,3,4,1,2,0,3,-1,0
Uruguay,1921,Friendly,4,2,1,0,0,1,2,0
Uruguay,1922,Copa América,3,1,2,1,1,4,2,0
Uruguay,1922,Copa Lipton,1,0,1,0,0,1,1,1
Uruguay,1922,Copa Newton,2,2,0,0,1,1,0,0
Uruguay,1922,Copa Premio Honor Uruguayo,1,0,1,0,0,1,1,1
Uruguay,1923,Copa América,6,1,3,0,0,3,5,1
Uruguay,1923,Copa Lipton,0,0,0,0,1,1,0,0
Uruguay,1923,Copa Premio Honor Uruguayo,2,4,0,1,1,2,-2,0
Uruguay,1923,Friendly,2,2,0,0,1,1,0,0
Uruguay,1924,Copa América,8,1,2,0,1,3,7,0
Uruguay,1924,Copa Lipton,2,0,1,0,0,1,2,1
Uruguay,1924,Copa Newton,0,4,0,1,0,1,-4,0
Uruguay,1924,Friendly,2,3,0,1,1,2,-1,0
Uruguay,1924,Olympic Games,20,2,5,0,0,5,18,1
Uruguay,1925,Friendly,1,3,1,3,1,5,-2,0
Uruguay,1926,Copa América,17,2,4,0,0,4,15,0
Uruguay,1927,Copa América,15,3,2,1,0,3,12,0
Uruguay,1927,Copa Lipton,1,0,1,0,0,1,1,1
Uruguay,1927,Copa Newton,0,1,0,1,0,1,-1,0
Uruguay,1927,Friendly,3,2,1,0,0,1,1,1
Uruguay,1928,Copa Lipton,2,2,0,0,1,1,0,0
Uruguay,1928,Copa Newton,0,1,0,1,0,1,-1,0
Uruguay,1928,Friendly,2,4,0,1,1,2,-2,0
Uruguay,1928,Olympic Games,12,5,4,0,1,5,7,1
Uruguay,1929,Copa América,4,6,1,2,0,3,-2,0
Uruguay,1929,Copa Lipton,0,0,0,0,1,1,0,0
Uruguay,1929,Copa Newton,2,1,1,0,0,1,1,1
Uruguay,1929,Friendly,1,3,0,1,1,2,-2,0
Uruguay,1930,Copa Newton,1,1,0,0,1,1,0,0
Uruguay,1930,FIFA World Cup,15,3,4,0,0,4,12,1
Uruguay,1931,Copa Rio Branco,0,2,0,1,0,1,-2,0
Uruguay,1932,Copa Rio Branco,1,2,0,1,0,1,-1,0
Uruguay,1932,Friendly,1,2,1,1,0,2,-1,0
Uruguay,1933,Friendly,3,6,1,2,0,3,-3,0
Uruguay,1934,Friendly,2,3,0,1,1,2,-1,0
Uruguay,1935,Copa América,6,1,3,0,0,3,5,1
Uruguay,1935,Friendly,1,4,0,1,1,2,-3,0
Uruguay,1936,Friendly,2,2,1,1,0,2,0,0
Uruguay,1937,Copa América,11,14,2,3,0,5,-3,0
Uruguay,1937,Copa Lipton,1,5,0,1,0,1,-4,0
Uruguay,1937,Copa Newton,0,3,0,1,0,1,-3,0
Uruguay,1938,Friendly,2,4,0,2,0,2,-2,0
Uruguay,1939,Copa América,13,5,3,1,0,4,8,0
Uruguay,1940,Copa Rio Branco,5,4,1,0,1,2,1,0
Uruguay,1940,Friendly,6,7,2,1,0,3,-1,0
Uruguay,1941,Copa América,10,1,3,1,0,4,9,0
Uruguay,1942,Copa América,21,2,6,0,0,6,19,1
Uruguay,1942,Copa Lipton,1,1,0,0,1,1,0,0
Uruguay,1942,Copa Newton,1,4,0,1,0,1,-3,0
Uruguay,1943,Friendly,3,4,0,1,1,2,-1,0
Uruguay,1944,Friendly,1,10,0,2,0,2,-9,0
Uruguay,1945,Copa América,14,6,3,3,0,6,8,0
Uruguay,1945,Copa Lipton,2,2,0,0,1,1,0,0
Uruguay,1945,Copa Newton,2,6,0,1,0,1,-4,0
Uruguay,1946,Copa América,11,9,2,3,0,5,2,0
Uruguay,1946,Copa Rio Branco,4,3,1,0,0,1,1,1
Uruguay,1947,Copa América,21,8,5,2,0,7,13,0
Uruguay,1947,Copa Rio Branco,2,3,0,1,1,2,-1,0
Uruguay,1948,Copa Rio Branco,5,3,1,0,1,2,2,1
Uruguay,1949,Copa América,14,20,2,4,1,7,-6,0
Uruguay,1950,Copa Rio Branco,6,6,1,1,0,2,0,0
Uruguay,1950,FIFA World Cup,15,5,3,0,1,4,10,0
Uruguay,1950,Friendly,8,6,1,2,0,3,2,0
Uruguay,1952,Pan American Championship,16,10,3,2,0,5,6,0
Uruguay,1953,Copa América,15,6,3,2,1,6,9,0
Uruguay,1953,Friendly,2,1,1,0,0,1,1,0
Uruguay,1954,FIFA World Cup,16,9,3,2,0,5,7,0
Uruguay,1954,Friendly,12,9,1,1,2,4,3,0
Uruguay,1955,Copa América,12,12,2,2,1,5,0,0
Uruguay,1956,Atlantic Cup,1,4,0,2,0,2,-3,0
Uruguay,1956,Copa América,9,3,4,0,1,5,6,1
Uruguay,1956,Friendly,7,7,1,1,2,4,0,0
Uruguay,1957,Copa América,15,12,4,2,0,6,3,0
Uruguay,1957,Copa Lipton,1,1,0,0,1,1,0,0
Uruguay,1957,Copa Newton,0,0,0,0,1,1,0,0
Uruguay,1957,FIFA World Cup qualification,4,6,2,1,1,4,-2,0
Uruguay,1958,Friendly,1,2,1,1,0,2,-1,0
Uruguay,1959,Copa América,28,15,5,4,1,10,13,0
Uruguay,1959,Friendly,1,3,0,1,0,1,-2,0
Uruguay,1960,Atlantic Cup,3,5,2,1,0,3,-2,0
Uruguay,1960,Friendly,5,4,1,0,1,2,1,0
Uruguay,1961,FIFA World Cup qualification,3,2,1,0,1,2,1,0
Uruguay,1961,Friendly,5,5,1,1,1,3,0,0
Uruguay,1962,Copa Lipton,1,3,0,1,0,1,-2,0
Uruguay,1962,FIFA World Cup,4,6,1,2,0,3,-2,0
Uruguay,1962,Friendly,6,15,1,3,2,6,-9,0
Uruguay,1963,Copa Juan Pinto Durán,3,2,1,0,1,2,1,0
Uruguay,1964,Friendly,3,6,1,3,0,4,-3,0
Uruguay,1965,Copa Artigas,5,2,1,1,0,2,3,1
Uruguay,1965,Copa Juan Pinto Durán,1,1,0,0,2,2,0,0
Uruguay,1965,FIFA World Cup qualification,11,2,4,0,0,4,9,0
Uruguay,1965,Friendly,1,8,0,3,0,3,-7,0
Uruguay,1966,Copa Artigas,5,3,1,0,1,2,2,1
Uruguay,1966,FIFA World Cup,2,5,1,1,2,4,-3,0
Uruguay,1966,Friendly,3,6,1,2,1,4,-3,0
Uruguay,1967,Copa América,13,2,4,0,1,5,11,1
Uruguay,1967,Copa Rio Branco,3,3,0,0,3,3,0,0
Uruguay,1967,Friendly,4,2,2,0,1,3,2,0
Uruguay,1968,Copa Artigas,0,0,0,0,1,1,0,0
Uruguay,1968,Copa Lipton,0,2,0,1,0,1,-2,0
Uruguay,1968,Copa Newton,2,1,1,0,0,1,1,1
Uruguay,1968,Copa Rio Branco,0,6,0,2,0,2,-6,0
Uruguay,1968,Friendly,5,7,0,1,2,3,-2,0
Uruguay,1969,FIFA World Cup qualification,5,0,3,0,1,4,5,0
Uruguay,1969,Friendly,2,3,1,2,0,3,-1,0
Uruguay,1970,FIFA World Cup,4,5,2,3,1,6,-1,0
Uruguay,1970,Friendly,5,3,2,1,0,3,2,0
Uruguay,1971,Copa Juan Pinto Durán,3,5,1,1,0,2,-2,0
Uruguay,1971,Friendly,2,6,0,2,2,4,-4,0
Uruguay,1972,Brazil Independence Cup,1,3,0,2,1,3,-2,0
Uruguay,1972,Friendly,1,3,1,2,1,4,-2,0
Uruguay,1973,Copa Lipton,1,1,0,0,1,1,0,0
Uruguay,1973,Copa Newton,1,1,0,0,1,1,0,0
Uruguay,1973,FIFA World Cup qualification,6,2,2,1,1,4,4,0
Uruguay,1973,Friendly,2,1,1,0,1,2,1,0
Uruguay,1974,FIFA World Cup,1,6,0,2,1,3,-5,0
Uruguay,1974,Friendly,10,4,4,1,1,6,6,0
Uruguay,1975,Copa América,1,3,1,1,0,2,-2,0
Uruguay,1975,Copa Artigas,1,1,1,1,0,2,0,0
Uruguay,1975,Copa Juan Pinto Durán,4,1,2,0,0,2,3,1
Uruguay,1975,Copa Newton,2,3,0,1,0,1,-1,0
Uruguay,1976,Atlantic Cup,2,3,0,1,1,2,-1,0
Uruguay,1976,Copa Juan Pinto Durán,0,0,0,0,1,1,0,0
Uruguay,1976,Copa Lipton,1,4,0,1,0,1,-3,0
Uruguay,1976,Copa Newton,0,3,0,1,0,1,-3,0
Uruguay,1976,Copa Rio Branco,2,4,0,2,0,2,-2,0
Uruguay,1976,Friendly,4,3,1,0,3,4,1,0
Uruguay,1977,Copa Artigas,3,2,1,0,1,2,1,1
Uruguay,1977,Copa Juan Pinto Durán,3,0,1,0,0,1,3,1
Uruguay,1977,FIFA World Cup qualification,5,4,1,1,2,4,1,0
Uruguay,1977,Friendly,1,3,0,1,2,3,-2,0
Uruguay,1978,Friendly,2,3,1,1,1,3,-1,0
Uruguay,1979,Copa América,5,5,1,1,2,4,0,0
Uruguay,1979,Copa Juan Pinto Durán,2,2,1,1,0,2,0,1
Uruguay,1979,Friendly,1,7,0,2,0,2,-6,0
Uruguay,1980,Friendly,21,8,5,4,3,12,13,0
Uruguay,1980,Mundialito,2,0,1,0,0,1,2,1
Uruguay,1981,Copa Juan Pinto Durán,2,1,1,0,1,2,1,0
Uruguay,1981,FIFA World Cup qualification,5,5,1,1,2,4,0,0
Uruguay,1981,Mundialito,4,1,2,0,0,2,3,1
Uruguay,1982,Nehru Cup,7,3,2,0,2,4,4,1
Uruguay,1983,Copa América,12,6,5,1,2,8,6,0
Uruguay,1983,Copa Artigas,3,0,1,0,1,2,3,1
Uruguay,1983,Friendly,4,6,0,1,4,5,-2,0
Uruguay,1984,Friendly,9,3,4,1,2,7,6,0
Uruguay,1985,CONMEBOL–UEFA Cup of Champions,0,2,0,1,0,1,-2,0
Uruguay,1985,Copa Artigas,4,1,2,0,0,2,3,1
Uruguay,1985,FIFA World Cup qualification,6,4,3,1,0,4,2,0
Uruguay,1985,Friendly,13,9,4,3,1,8,4,0
Uruguay,1985,Kirin Cup,4,1,1,0,0,1,3,1
Uruguay,1986,FIFA World Cup,2,8,0,2,2,4,-6,0
Uruguay,1986,Friendly,3,4,0,1,3,4,-1,0
Uruguay,1986,Miami Cup,3,1,1,0,0,1,2,0
Uruguay,1987,Copa América,2,0,2,0,0,2,2,1
Uruguay,1987,Friendly,4,2,2,0,0,2,2,0
Uruguay,1988,Copa Juan Pinto Durán,4,2,1,0,1,2,2,1
Uruguay,1988,Friendly,9,7,3,3,0,6,2,0
Uruguay,1989,Copa América,11,3,4,3,0,7,8,0
Uruguay,1989,FIFA World Cup qualification,7,2,3,1,0,4,5,0
Uruguay,1989,Friendly,8,5,2,0,5,7,3,0
Uruguay,1990,FIFA World Cup,2,5,1,2,1,4,-3,0
Uruguay,1990,Friendly,7,8,1,2,2,5,-1,0
Uruguay,1990,Miami Cup,4,0,2,0,0,2,4,1
Uruguay,1991,Copa América,4,3,1,0,3,4,1,0
Uruguay,1991,Friendly,7,8,2,4,2,8,-1,0
Uruguay,1992,Copa Lipton,0,0,0,0,1,1,0,0
Uruguay,1992,Friendly,11,8,5,2,0,7,3,0
Uruguay,1993,Copa América,5,5,1,1,2,4,0,0
Uruguay,1993,FIFA World Cup qualification,10,7,4,2,2,8,3,0
Uruguay,1993,Friendly,5,6,2,1,0,3,-1,0
Uruguay,1994,Friendly,1,0,1,0,0,1,1,0
Uruguay,1995,Copa América,11,4,4,0,2,6,7,0
Uruguay,1995,Friendly,16,15,2,5,4,11,1,0
Uruguay,1996,FIFA World Cup qualification,6,6,3,3,0,6,0,0
Uruguay,1996,Friendly,4,6,0,1,1,2,-2,0
Uruguay,1997,Confederations Cup,8,6,3,2,0,5,2,0
Uruguay,1997,Copa América,2,2,1,2,0,3,0,0
Uruguay,1997,FIFA World Cup qualification,12,15,3,4,3,10,-3,0
Uruguay,1998,Friendly,3,7,0,1,1,2,-4,0
Uruguay,1999,Copa América,4,9,1,3,2,6,-5,0
Uruguay,1999,Friendly,10,7,3,1,1,5,3,0
Uruguay,2000,FIFA World Cup qualification,12,7,4,3,3,10,5,0
Uruguay,2001,Copa América,7,7,2,2,2,6,0,0
Uruguay,2001,FIFA World Cup qualification,10,7,4,3,3,10,3,1
Uruguay,2001,Friendly,2,0,1,0,0,1,2,0
Uruguay,2002,FIFA World Cup,4,5,0,1,2,3,-1,0
Uruguay,2002,Friendly,10,9,3,3,1,7,1,0
Uruguay,2003,FIFA World Cup qualification,11,8,2,1,1,4,3,0
Uruguay,2003,Friendly,21,14,5,2,2,9,7,0
Uruguay,2003,Lunar New Year Cup,1,1,0,0,1,1,0,0
Uruguay,2004,Copa América,12,10,3,1,2,6,2,0
Uruguay,2004,FIFA World Cup qualification,5,15,2,4,1,7,-10,0
Uruguay,2004,Friendly,0,2,0,1,0,1,-2,0
Uruguay,2005,FIFA World Cup qualification,8,6,3,1,5,9,2,0
Uruguay,2005,Friendly,3,8,0,3,0,3,-5,0
Uruguay,2006,Friendly,13,7,5,3,2,10,6,0
Uruguay,2007,Copa América,8,9,2,2,2,6,-1,0
Uruguay,2007,FIFA World Cup qualification,8,5,1,2,1,4,3,0
Uruguay,2007,Friendly,7,2,3,0,1,4,5,0
Uruguay,2008,FIFA World Cup qualification,11,5,2,1,3,6,6,0
Uruguay,2008,Friendly,10,7,2,0,3,5,3,0
Uruguay,2009,FIFA World Cup qualification,11,11,4,3,3,10,0,0
Uruguay,2009,Friendly,3,3,1,1,0,2,0,0
Uruguay,2010,FIFA World Cup,11,8,3,2,2,7,3,0
Uruguay,2010,Friendly,20,5,5,1,0,6,15,0
Uruguay,2011,Copa América,9,3,3,0,3,6,6,1
Uruguay,2011,Copa Confraternidad,1,1,0,0,1,1,0,0
Uruguay,2011,FIFA World Cup qualification,9,3,2,0,1,3,6,0
Uruguay,2011,Friendly,11,8,4,2,0,6,3,0
Uruguay,2012,FIFA World Cup qualification,7,15,1,3,2,6,-8,0
Uruguay,2012,Friendly,5,3,1,0,3,4,2,0
Uruguay,2013,Confederations Cup,14,7,2,2,1,5,7,0
Uruguay,2013,FIFA World Cup qualification,14,7,5,2,2,9,7,0
Uruguay,2013,Friendly,6,5,2,1,0,3,1,0
Uruguay,2014,FIFA World Cup,4,6,2,2,0,4,-2,0
Uruguay,2014,Friendly,12,6,4,0,3,7,6,0
Uruguay,2014,Kirin Challenge Cup,2,0,1,0,0,1,2,1
Uruguay,2015,Copa América,2,3,1,2,1,4,-1,0
Uruguay,2015,FIFA World Cup qualification,9,2,3,1,0,4,7,0
Uruguay,2015,Friendly,6,1,2,0,0,2,5,0
Uruguay,2016,Copa América,4,4,1,2,0,3,0,0
Uruguay,2016,FIFA World Cup qualification,15,9,4,2,2,8,6,0
Uruguay,2017,FIFA World Cup qualification,8,9,2,2,2,6,-1,0
Uruguay,2017,Friendly,2,8,0,3,1,4,-6,0
Uruguay,2018,FIFA World Cup,7,3,4,1,0,5,4,0
Uruguay,2018,Friendly,11,5,4,3,0,7,6,0
Uruguay,2018,Kirin Challenge Cup,3,4,0,1,0,1,-1,0
Uruguay,2019,Copa América,7,2,2,0,2,4,5,0
Uruguay,2019,Friendly,12,6,4,0,3,7,6,0
Uruguay,2020,FIFA World Cup qualification,7,7,2,2,0,4,0,0
Uruguay,2021,Copa América,4,2,2,1,2,5,2,0
Uruguay,2021,FIFA World Cup qualification,7,14,2,4,4,10,-7,0
Uruguay,2022,FIFA World Cup,2,2,1,1,1,3,0,0
Uruguay,2022,FIFA World Cup qualification,8,1,4,0,0,4,7,0
Uruguay,2022,Friendly,10,1,3,1,1,5,9,0
Uruguay,2023,FIFA World Cup qualification,13,5,4,1,1,6,8,0
Uruguay,2023,Friendly,9,3,3,0,1,4,6,0
Uruguay,2024,Copa América,10,4,3,1,2,6,6,0
Uruguay,2024,FIFA World Cup qualification,4,4,1,1,4,6,0,0
Uruguay,2024,Friendly,6,3,1,1,2,4,3,0
Uruguay,2025,FIFA World Cup qualification,0,1,0,1,1,2,-1,0
Uzbekistan,1992,Friendly,14,8,3,2,2,7,6,0
Uzbekistan,1994,Asian Games,23,7,7,0,0,7,16,1
Uzbekistan,1994,Friendly,9,1,3,0,1,4,8,0
Uzbekistan,1995,Friendly,2,4,0,2,0,2,-2,0
Uzbekistan,1995,Nehru Cup,2,4,1,2,0,3,-2,1
Uzbekistan,1996,AFC Asian Cup,3,6,1,2,0,3,-3,0
Uzbekistan,1996,AFC Asian Cup qualification,5,4,1,1,0,2,1,0
Uzbekistan,1996,Friendly,2,7,0,3,0,3,-5,0
Uzbekistan,1997,FIFA World Cup qualification,33,21,6,4,4,14,12,0
Uzbekistan,1998,Asian Games,25,8,3,1,2,6,17,0
Uzbekistan,1998,Friendly,6,6,1,2,1,4,0,0
Uzbekistan,1999,AFC Asian Cup qualification,16,2,4,0,0,4,14,0
Uzbekistan,1999,Friendly,8,2,2,1,0,3,6,0
Uzbekistan,2000,AFC Asian Cup,2,14,0,2,1,3,-12,0
Uzbekistan,2000,Friendly,13,9,2,3,0,5,4,0
Uzbekistan,2001,FIFA World Cup qualification,33,19,7,4,3,14,14,0
Uzbekistan,2001,Friendly,2,5,1,2,0,3,-3,0
Uzbekistan,2001,Merdeka Tournament,6,2,3,0,0,3,4,1
Uzbekistan,2001,Millennium Cup,5,2,1,1,0,2,3,0
Uzbekistan,2002,Friendly,1,6,0,2,0,2,-5,0
Uzbekistan,2003,AFC Asian Cup qualification,13,6,4,1,1,6,7,0
Uzbekistan,2003,Friendly,8,6,1,1,2,4,2,0
Uzbekistan,2004,AFC Asian Cup,5,2,3,0,1,4,3,0
Uzbekistan,2004,FIFA World Cup qualification,16,3,5,0,1,6,13,0
Uzbekistan,2004,Friendly,1,3,0,1,0,1,-2,0
Uzbekistan,2005,FIFA World Cup qualification,8,12,1,3,4,8,-4,0
Uzbekistan,2006,AFC Asian Cup qualification,14,4,3,1,2,6,10,0
Uzbekistan,2007,AFC Asian Cup,10,4,2,2,0,4,6,0
Uzbekistan,2007,FIFA World Cup qualification,11,0,2,0,0,2,11,0
Uzbekistan,2007,Friendly,12,9,2,4,3,9,3,0
Uzbekistan,2007,King's Cup,4,5,0,1,1,2,-1,0
Uzbekistan,2008,FIFA World Cup qualification,18,12,5,3,1,9,6,0
Uzbekistan,2008,Friendly,4,6,1,2,1,4,-2,0
Uzbekistan,2009,AFC Asian Cup qualification,7,2,3,0,0,3,5,0
Uzbekistan,2009,FIFA World Cup qualification,4,5,1,4,0,5,-1,0
Uzbekistan,2009,Friendly,1,1,0,0,3,3,0,0
Uzbekistan,2010,AFC Asian Cup qualification,0,1,0,1,0,1,-1,0
Uzbekistan,2010,Friendly,9,14,1,3,2,6,-5,0
Uzbekistan,2011,AFC Asian Cup,10,13,3,2,1,6,-3,0
Uzbekistan,2011,FIFA World Cup qualification,14,1,6,0,1,7,13,0
Uzbekistan,2011,Friendly,2,6,0,3,1,4,-4,0
Uzbekistan,2012,FIFA World Cup qualification,6,4,3,1,2,6,2,0
Uzbekistan,2012,Friendly,8,10,2,4,1,7,-2,0
Uzbekistan,2013,AFC Asian Cup qualification,9,3,3,1,1,5,6,0
Uzbekistan,2013,FIFA World Cup qualification,8,4,2,1,2,5,4,0
Uzbekistan,2013,Friendly,2,1,1,0,1,2,1,0
Uzbekistan,2014,AFC Asian Cup qualification,1,1,0,0,1,1,0,0
Uzbekistan,2014,Friendly,13,7,6,3,3,12,6,0
Uzbekistan,2015,AFC Asian Cup,5,5,2,2,0,4,0,0
Uzbekistan,2015,FIFA World Cup qualification,18,7,5,1,0,6,11,0
Uzbekistan,2015,Friendly,2,7,0,2,1,3,-5,0
Uzbekistan,2016,FIFA World Cup qualification,7,3,5,2,0,7,4,0
Uzbekistan,2016,Friendly,7,3,4,1,0,5,4,0
Uzbekistan,2017,FIFA World Cup qualification,1,4,1,3,1,5,-3,0
Uzbekistan,2017,Friendly,4,3,1,1,1,3,1,0
Uzbekistan,2018,Friendly,6,13,2,5,3,10,-7,0
Uzbekistan,2019,AFC Asian Cup,7,3,2,1,1,4,4,0
Uzbekistan,2019,FIFA World Cup qualification,12,6,3,2,0,5,6,1
Uzbekistan,2019,Friendly,9,3,3,1,1,5,6,0
Uzbekistan,2020,Friendly,4,6,1,3,0,4,-2,0
Uzbekistan,2021,FIFA World Cup qualification,6,3,2,1,0,3,3,0
Uzbekistan,2021,Friendly,8,8,2,4,0,6,0,0
Uzbekistan,2022,AFC Asian Cup qualification,9,0,3,0,0,3,9,0
Uzbekistan,2022,Friendly,8,2,3,1,1,5,6,0
Uzbekistan,2022,Navruz Cup,7,3,2,0,0,2,4,1
Uzbekistan,2023,CAFA Nations Cup,10,2,3,1,0,4,8,0
Uzbekistan,2023,FIFA World Cup qualification,5,3,1,0,1,2,2,0
Uzbekistan,2023,Friendly,9,8,3,1,2,6,1,0
Uzbekistan,2024,AFC Asian Cup,7,3,2,0,3,5,4,0
Uzbekistan,2024,FIFA World Cup qualification,16,6,7,1,2,10,10,0
Uzbekistan,2024,Friendly,1,0,1,0,0,1,1,0
Uzbekistan,2025,FIFA World Cup qualification,3,2,1,0,1,2,1,0
Uzbekistan,2025,Friendly,0,0,0,0,1,1,0,0
Vanuatu,1951,Friendly,0,9,0,1,0,1,-9,0
Vanuatu,1953,Friendly,4,8,0,2,0,2,-4,0
Vanuatu,1957,Friendly,1,2,0,1,0,1,-1,0
Vanuatu,1963,South Pacific Games,3,6,0,1,0,1,-3,0
Vanuatu,1966,South Pacific Games,9,14,1,2,1,4,-5,1
Vanuatu,1969,South Pacific Games,13,14,1,3,1,5,-1,0
Vanuatu,1971,South Pacific Games,9,12,2,1,1,4,-3,0
Vanuatu,1973,Oceania Nations Cup,5,11,1,4,0,5,-6,0
Vanuatu,1975,South Pacific Games,4,6,1,2,0,3,-2,0
Vanuatu,1978,Friendly,2,4,0,1,0,1,-2,0
Vanuatu,1979,South Pacific Games,13,5,3,2,0,5,8,0
Vanuatu,1980,Friendly,0,1,0,1,0,1,-1,0
Vanuatu,1980,Oceania Nations Cup,6,9,0,3,0,3,-3,0
Vanuatu,1981,South Pacific Mini Games,20,11,1,3,3,7,9,0
Vanuatu,1983,Friendly,3,12,0,2,1,3,-9,0
Vanuatu,1983,South Pacific Games,2,12,0,2,0,2,-10,0
Vanuatu,1987,Friendly,6,2,1,0,0,1,4,0
Vanuatu,1987,South Pacific Games,16,13,2,3,1,6,3,0
Vanuatu,1988,Friendly,2,19,1,3,0,4,-17,0
Vanuatu,1989,Friendly,2,12,0,4,0,4,-10,0
Vanuatu,1990,Friendly,4,2,2,0,2,4,2,0
Vanuatu,1991,South Pacific Games,7,9,2,3,0,5,-2,0
Vanuatu,1992,FIFA World Cup qualification,1,18,0,4,0,4,-17,0
Vanuatu,1992,Friendly,2,8,0,4,0,4,-6,0
Vanuatu,1993,South Pacific Mini Games,6,5,2,2,1,5,1,0
Vanuatu,1994,Oceania Nations Cup qualification,5,12,0,3,1,4,-7,0
Vanuatu,1995,South Pacific Games,10,9,2,3,0,5,1,0
Vanuatu,1996,FIFA World Cup qualification,2,3,0,1,1,2,-1,0
Vanuatu,1998,Oceania Nations Cup,2,13,0,2,0,2,-11,0
Vanuatu,1998,Oceania Nations Cup qualification,8,6,2,1,1,4,2,1
Vanuatu,2000,Friendly,1,4,0,2,0,2,-3,0
Vanuatu,2000,Oceania Nations Cup,5,8,1,3,0,4,-3,0
Vanuatu,2000,Oceania Nations Cup qualification,12,7,2,2,0,4,5,0
Vanuatu,2001,FIFA World Cup qualification,11,21,1,3,0,4,-10,0
Vanuatu,2002,Oceania Nations Cup,2,6,2,3,0,5,-4,0
Vanuatu,2003,South Pacific Games,23,3,3,0,3,6,20,0
Vanuatu,2004,FIFA World Cup qualification,16,2,3,0,1,4,14,0
Vanuatu,2004,Friendly,2,4,0,2,0,2,-2,0
Vanuatu,2004,Oceania Nations Cup,5,9,1,4,0,5,-4,0
Vanuatu,2007,Friendly,5,5,1,1,0,2,0,0
Vanuatu,2007,Oceania Nations Cup,2,6,0,2,0,2,-4,0
Vanuatu,2007,South Pacific Games,25,6,4,2,0,6,19,0
Vanuatu,2008,Friendly,2,1,1,0,0,1,1,0
Vanuatu,2008,Oceania Nations Cup,3,7,1,2,1,4,-4,0
Vanuatu,2011,Friendly,5,3,2,1,3,6,2,0
Vanuatu,2011,Pacific Games,18,7,4,1,0,5,11,0
Vanuatu,2012,Oceania Nations Cup,8,9,1,2,0,3,-1,0
Vanuatu,2015,Friendly,3,2,1,0,1,2,1,0
Vanuatu,2016,Oceania Nations Cup,3,8,1,2,0,3,-5,0
Vanuatu,2017,Friendly,0,1,0,1,0,1,-1,0
Vanuatu,2017,Pacific Mini Games,21,4,4,0,1,5,17,0
Vanuatu,2018,Friendly,2,3,0,1,1,2,-1,0
Vanuatu,2019,Friendly,3,9,1,2,1,4,-6,0
Vanuatu,2019,Pacific Games,25,2,2,1,0,3,23,0
Vanuatu,2022,Friendly,1,2,0,1,0,1,-1,0
Vanuatu,2022,MSG Prime Minister's Cup,0,1,0,1,0,1,-1,0
Vanuatu,2023,Friendly,2,3,1,1,0,2,-1,0
Vanuatu,2023,MSG Prime Minister's Cup,1,5,1,2,0,3,-4,1
Vanuatu,2023,Pacific Games,9,6,1,2,1,4,3,0
Vanuatu,2024,FIFA Series,2,9,0,2,0,2,-7,0
Vanuatu,2024,FIFA World Cup qualification,5,11,1,2,0,3,-6,0
Vanuatu,2024,Oceania Nations Cup,3,8,2,2,0,4,-5,0
Vatican City,2002,Friendly,0,0,0,0,1,1,0,0
Vatican City,2011,Friendly,2,11,0,2,0,2,-9,0
Vatican City,2013,Friendly,0,2,0,1,0,1,-2,0
Vatican City,2014,Friendly,0,2,0,1,0,1,-2,0
Vatican City,2017,Friendly,0,0,0,0,1,1,0,0
Vatican City,2019,Friendly,2,2,0,0,1,1,0,0
Venezuela,1938,Bolivarian Games,4,12,0,4,0,4,-8,0
Venezuela,1938,Central American and Caribbean Games,5,10,1,4,0,5,-5,0
Venezuela,1944,Friendly,8,4,2,0,1,3,4,0
Venezuela,1946,Central American and Caribbean Games,12,11,2,4,0,6,1,0
Venezuela,1947,Bolivarian Games,2,2,0,0,1,1,0,0
Venezuela,1951,Friendly,4,1,1,0,0,1,3,0
Venezuela,1956,Friendly,6,6,2,1,1,4,0,0
Venezuela,1961,Friendly,9,2,2,0,0,2,7,0
Venezuela,1965,FIFA World Cup qualification,4,15,0,4,0,4,-11,0
Venezuela,1967,Copa América,7,16,1,4,0,5,-9,0
Venezuela,1969,FIFA World Cup qualification,1,18,0,5,1,6,-17,0
Venezuela,1972,Brazil Independence Cup,3,17,0,3,1,4,-14,0
Venezuela,1975,Copa América,1,26,0,4,0,4,-25,0
Venezuela,1977,FIFA World Cup qualification,2,8,0,3,1,4,-6,0
Venezuela,1977,Friendly,1,0,1,0,0,1,1,0
Venezuela,1978,Friendly,0,1,0,1,0,1,-1,0
Venezuela,1979,Copa América,1,12,0,2,2,4,-11,0
Venezuela,1981,FIFA World Cup qualification,1,9,1,3,0,4,-8,0
Venezuela,1981,Friendly,3,5,2,2,0,4,-2,0
Venezuela,1983,Copa América,1,10,0,3,1,4,-9,0
Venezuela,1985,FIFA World Cup qualification,5,15,0,5,1,6,-10,0
Venezuela,1985,Friendly,0,4,0,1,0,1,-4,0
Venezuela,1987,Copa América,1,8,0,2,0,2,-7,0
Venezuela,1988,Friendly,0,0,0,0,1,1,0,0
Venezuela,1989,Copa América,4,11,0,3,1,4,-7,0
Venezuela,1989,FIFA World Cup qualification,1,18,0,4,0,4,-17,0
Venezuela,1989,Friendly,5,5,1,2,1,4,0,0
Venezuela,1991,Copa América,1,15,0,4,0,4,-14,0
Venezuela,1993,Copa América,6,11,0,1,2,3,-5,0
Venezuela,1993,FIFA World Cup qualification,4,34,1,7,0,8,-30,0
Venezuela,1993,Friendly,2,4,0,1,3,4,-2,0
Venezuela,1994,Friendly,1,2,0,1,0,1,-1,0
Venezuela,1995,Copa América,4,10,0,3,0,3,-6,0
Venezuela,1995,Friendly,1,9,0,2,1,3,-8,0
Venezuela,1996,FIFA World Cup qualification,5,21,0,6,1,7,-16,0
Venezuela,1996,Friendly,4,10,2,4,2,8,-6,0
Venezuela,1997,Copa América,0,5,0,3,0,3,-5,0
Venezuela,1997,FIFA World Cup qualification,3,20,0,7,2,9,-17,0
Venezuela,1997,Friendly,2,5,0,1,1,2,-3,0
Venezuela,1999,Copa América,1,13,0,3,0,3,-12,0
Venezuela,1999,Friendly,9,13,2,4,3,9,-4,0
Venezuela,2000,FIFA World Cup qualification,6,28,1,9,0,10,-22,0
Venezuela,2000,Friendly,9,4,2,1,1,4,5,0
Venezuela,2001,Copa América,0,7,0,3,0,3,-7,0
Venezuela,2001,FIFA World Cup qualification,12,16,4,3,1,8,-4,0
Venezuela,2002,Friendly,7,1,4,1,1,6,6,0
Venezuela,2003,FIFA World Cup qualification,3,6,2,2,0,4,-3,0
Venezuela,2003,Friendly,12,9,4,3,1,8,3,0
Venezuela,2004,Copa América,2,5,0,2,1,3,-3,0
Venezuela,2004,FIFA World Cup qualification,10,11,2,4,1,7,-1,0
Venezuela,2004,Friendly,6,8,1,3,1,5,-2,0
Venezuela,2005,FIFA World Cup qualification,7,11,1,4,2,7,-4,0
Venezuela,2005,Friendly,5,4,1,1,1,3,1,0
Venezuela,2006,Friendly,5,10,3,4,2,9,-5,0
Venezuela,2007,Copa América,5,6,1,1,2,4,-1,0
Venezuela,2007,FIFA World Cup qualification,6,6,2,2,0,4,0,0
Venezuela,2007,Friendly,23,16,5,3,3,11,7,0
Venezuela,2008,FIFA World Cup qualification,6,12,1,4,1,6,-6,0
Venezuela,2008,Friendly,13,9,5,2,3,10,4,0
Venezuela,2009,FIFA World Cup qualification,11,11,3,2,3,8,0,0
Venezuela,2009,Friendly,5,8,2,2,1,5,-3,0
Venezuela,2010,Friendly,14,18,4,5,4,13,-4,0
Venezuela,2011,Copa América,7,8,2,1,3,6,-1,0
Venezuela,2011,FIFA World Cup qualification,3,3,2,1,1,4,0,0
Venezuela,2011,Friendly,14,18,4,6,2,12,-4,0
Venezuela,2012,FIFA World Cup qualification,5,6,1,2,2,5,-1,0
Venezuela,2012,Friendly,7,13,1,4,1,6,-6,0
Venezuela,2013,FIFA World Cup qualification,6,11,2,3,2,7,-5,0
Venezuela,2013,Friendly,4,3,1,0,1,2,1,0
Venezuela,2014,Friendly,5,8,0,2,1,3,-3,0
Venezuela,2015,Copa América,2,3,1,2,0,3,-1,0
Venezuela,2015,FIFA World Cup qualification,4,11,0,4,0,4,-7,0
Venezuela,2015,Friendly,5,6,2,1,1,4,-1,0
Venezuela,2016,Copa América,4,5,2,1,1,4,-1,0
Venezuela,2016,FIFA World Cup qualification,10,18,1,5,2,8,-8,0
Venezuela,2016,Friendly,2,3,0,1,1,2,-1,0
Venezuela,2017,FIFA World Cup qualification,5,6,1,1,4,6,-1,0
Venezuela,2017,Friendly,2,3,0,1,2,3,-1,0
Venezuela,2018,Friendly,8,7,2,2,1,5,1,0
Venezuela,2018,Kirin Challenge Cup,1,1,0,0,1,1,0,0
Venezuela,2019,Copa América,3,3,1,1,2,4,0,0
Venezuela,2019,Friendly,15,8,4,2,2,8,7,0
Venezuela,2019,Kirin Challenge Cup,4,1,1,0,0,1,3,1
Venezuela,2020,FIFA World Cup qualification,2,6,1,3,0,4,-4,0
Venezuela,2021,Copa América,2,6,0,2,2,4,-4,0
Venezuela,2021,FIFA World Cup qualification,7,19,1,8,1,10,-12,0
Venezuela,2022,FIFA World Cup qualification,5,9,1,3,0,4,-4,0
Venezuela,2022,Friendly,10,4,4,1,1,6,6,0
Venezuela,2023,FIFA World Cup qualification,6,3,2,1,3,6,3,0
Venezuela,2023,Friendly,5,2,3,0,1,4,3,0
Venezuela,2024,Copa América,7,2,3,0,1,4,5,0
Venezuela,2024,FIFA World Cup qualification,5,12,0,3,3,6,-7,0
Venezuela,2024,Friendly,1,2,0,1,1,2,-1,0
Venezuela,2025,FIFA World Cup qualification,2,2,1,1,0,2,0,0
Venezuela,2025,Friendly,1,3,0,1,0,1,-2,0
Vietnam,1949,Friendly,3,3,0,0,1,1,0,0
Vietnam,1954,Asian Games,5,5,1,1,0,2,0,0
Vietnam,1991,Southeast Asian Games,3,5,0,2,1,3,-2,0
Vietnam,1993,FIFA World Cup qualification,4,18,1,7,0,8,-14,0
Vietnam,1993,Southeast Asian Games,1,3,1,2,0,3,-2,0
Vietnam,1995,Friendly,1,0,1,0,0,1,1,0
Vietnam,1995,Southeast Asian Games,10,8,4,2,0,6,2,0
Vietnam,1996,AFC Asian Cup qualification,13,5,2,1,0,3,8,0
Vietnam,1996,AFF Championship,14,10,3,1,2,6,4,1
Vietnam,1997,Dunhill Cup,0,11,0,3,0,3,-11,0
Vietnam,1997,FIFA World Cup qualification,2,21,0,6,0,6,-19,0
Vietnam,1997,Southeast Asian Games,9,6,3,2,1,6,3,1
Vietnam,1998,AFF Championship,8,2,3,1,1,5,6,0
Vietnam,1998,Asian Games,0,6,0,2,0,2,-6,0
Vietnam,1998,Friendly,1,1,0,0,1,1,0,0
Vietnam,1999,Friendly,1,0,1,0,0,1,1,0
Vietnam,1999,Southeast Asian Games,14,2,4,1,1,6,12,0
Vietnam,2000,AFC Asian Cup qualification,14,2,2,1,0,3,12,0
Vietnam,2000,AFF Championship,14,6,3,2,1,6,8,0
Vietnam,2000,Friendly,2,2,0,0,1,1,0,0
Vietnam,2001,FIFA World Cup qualification,9,9,3,2,1,6,0,0
Vietnam,2002,AFF Championship,21,12,4,1,1,6,9,0
Vietnam,2002,Friendly,6,6,1,1,2,4,0,0
Vietnam,2003,AFC Asian Cup qualification,8,13,3,3,0,6,-5,0
Vietnam,2003,Friendly,0,5,0,1,0,1,-5,0
Vietnam,2004,AFF Championship,13,5,2,1,1,4,8,0
Vietnam,2004,FIFA World Cup qualification,5,9,1,4,1,6,-4,0
Vietnam,2004,Friendly,7,1,2,0,0,2,6,0
Vietnam,2006,King's Cup,7,8,2,2,0,4,-1,0
Vietnam,2007,AFC Asian Cup,4,7,1,2,1,4,-3,0
Vietnam,2007,AFF Championship,10,3,1,1,3,5,7,0
Vietnam,2007,FIFA World Cup qualification,0,6,0,2,0,2,-6,0
Vietnam,2007,Friendly,8,3,2,0,0,2,5,0
Vietnam,2008,AFF Championship,10,6,3,1,2,6,4,0
Vietnam,2008,Friendly,2,4,0,2,1,3,-2,0
Vietnam,2008,VFF Cup,2,2,0,0,2,2,0,0
Vietnam,2009,AFC Asian Cup qualification,4,8,1,2,1,4,-4,0
Vietnam,2009,Friendly,4,2,2,0,1,3,2,0
Vietnam,2010,AFC Asian Cup qualification,2,3,0,1,1,2,-1,0
Vietnam,2010,AFF Championship,8,5,2,2,1,5,3,0
Vietnam,2010,Friendly,2,6,0,2,1,3,-4,0
Vietnam,2010,VFF Cup,1,3,0,1,1,2,-2,0
Vietnam,2011,FIFA World Cup qualification,15,5,3,1,0,4,10,0
Vietnam,2011,Friendly,0,1,0,1,0,1,-1,0
Vietnam,2012,AFF Championship,2,5,0,2,1,3,-3,0
Vietnam,2012,Friendly,5,4,3,1,1,5,1,0
Vietnam,2012,VFF Cup,4,1,1,1,0,2,3,0
Vietnam,2013,AFC Asian Cup qualification,2,14,0,5,0,5,-12,0
Vietnam,2013,Friendly,2,1,1,0,0,1,1,0
Vietnam,2014,AFC Asian Cup qualification,3,1,1,0,0,1,2,0
Vietnam,2014,AFF Championship,12,8,3,1,1,5,4,0
Vietnam,2014,Friendly,13,5,3,1,0,4,8,0
Vietnam,2015,FIFA World Cup qualification,3,6,1,2,1,4,-3,0
Vietnam,2015,Friendly,1,1,0,0,1,1,0,0
Vietnam,2016,AFF Championship,8,6,3,1,1,5,2,0
Vietnam,2016,FIFA World Cup qualification,4,2,1,1,0,2,2,0
Vietnam,2016,Friendly,17,8,4,0,2,6,9,0
Vietnam,2017,AFC Asian Cup qualification,8,2,2,0,3,5,6,0
Vietnam,2017,Friendly,1,1,0,0,1,1,0,0
Vietnam,2018,AFC Asian Cup qualification,1,1,0,0,1,1,0,0
Vietnam,2018,AFF Championship,15,4,6,0,2,8,11,1
Vietnam,2018,Friendly,5,3,1,0,1,2,2,0
Vietnam,2019,AFC Asian Cup,5,7,1,3,1,5,-2,0
Vietnam,2019,FIFA World Cup qualification,5,1,3,0,2,5,4,0
Vietnam,2021,AFF Championship,9,2,3,1,2,6,7,0
Vietnam,2021,FIFA World Cup qualification,12,16,2,7,0,9,-4,0
Vietnam,2021,Friendly,1,1,0,0,1,1,0,0
Vietnam,2022,AFF Championship,9,0,2,0,1,3,9,0
Vietnam,2022,FIFA World Cup qualification,4,7,1,2,1,4,-3,0
Vietnam,2022,Friendly,10,0,4,0,0,4,10,0
Vietnam,2023,AFF Championship,7,3,2,1,2,5,4,0
Vietnam,2023,FIFA World Cup qualification,2,1,1,1,0,2,1,0
Vietnam,2023,Friendly,4,10,3,3,0,6,-6,0
Vietnam,2024,AFC Asian Cup,4,8,0,3,0,3,-4,0
Vietnam,2024,ASEAN Championship,16,3,5,0,1,6,13,0
Vietnam,2024,FIFA World Cup qualification,4,9,1,3,0,4,-5,0
Vietnam,2024,Friendly,3,8,0,3,1,4,-5,0
Vietnam,2025,AFC Asian Cup qualification,5,0,1,0,0,1,5,0
Vietnam,2025,ASEAN Championship,5,3,2,0,0,2,2,1
Vietnam,2025,Friendly,2,1,1,0,0,1,1,0
Vietnam Republic,1956,AFC Asian Cup,6,9,0,2,1,3,-3,0
Vietnam Republic,1956,AFC Asian Cup qualification,7,3,1,0,1,2,4,0
Vietnam Republic,1956,Friendly,5,2,2,0,0,2,3,0
Vietnam Republic,1957,Merdeka Tournament,12,10,2,1,1,4,2,0
Vietnam Republic,1958,Asian Games,8,5,1,1,1,3,3,0
Vietnam Republic,1958,Merdeka Tournament,5,10,0,2,1,3,-5,0
Vietnam Republic,1959,AFC Asian Cup qualification,5,1,2,0,0,2,4,0
Vietnam Republic,1959,Friendly,5,1,1,0,0,1,4,0
Vietnam Republic,1959,Merdeka Tournament,8,8,1,1,1,3,0,0
Vietnam Republic,1959,Southeast Asian Peninsular Games,11,3,3,1,0,4,8,1
Vietnam Republic,1960,AFC Asian Cup,2,12,0,3,0,3,-10,0
Vietnam Republic,1960,Friendly,3,3,0,0,2,2,0,0
Vietnam Republic,1960,Merdeka Tournament,5,6,1,1,1,3,-1,0
Vietnam Republic,1961,Friendly,5,2,2,0,0,2,3,0
Vietnam Republic,1961,Merdeka Tournament,8,7,3,1,0,4,1,1
Vietnam Republic,1961,Southeast Asian Peninsular Games,9,3,1,1,2,4,6,0
Vietnam Republic,1961,Vietnam Independence Cup,5,1,2,0,0,2,4,1
Vietnam Republic,1962,Asian Games,12,8,2,3,0,5,4,0
Vietnam Republic,1962,Friendly,3,2,1,0,1,2,1,0
Vietnam Republic,1962,Merdeka Tournament,9,4,1,1,1,3,5,0
Vietnam Republic,1962,Vietnam Independence Cup,8,1,3,1,0,4,7,1
Vietnam Republic,1963,AFC Asian Cup qualification,9,7,2,1,0,3,2,1
Vietnam Republic,1963,Friendly,1,2,0,1,0,1,-1,0
Vietnam Republic,1963,Merdeka Tournament,11,11,2,2,1,5,0,0
Vietnam Republic,1964,Friendly,1,2,0,1,0,1,-1,0
Vietnam Republic,1964,Merdeka Tournament,2,2,1,1,1,3,0,0
Vietnam Republic,1965,Merdeka Tournament,11,10,2,2,2,6,1,0
Vietnam Republic,1965,Southeast Asian Peninsular Games,8,5,2,2,0,4,3,0
Vietnam Republic,1965,Vietnam Independence Cup,6,2,1,0,1,2,4,0
Vietnam Republic,1966,Asian Games,2,6,1,1,1,3,-4,0
Vietnam Republic,1966,Friendly,2,2,0,0,1,1,0,0
Vietnam Republic,1966,Merdeka Tournament,10,7,4,2,0,6,3,1
Vietnam Republic,1966,Vietnam Independence Cup,7,3,2,0,0,2,4,1
Vietnam Republic,1967,AFC Asian Cup qualification,4,4,2,2,0,4,0,0
Vietnam Republic,1967,Friendly,0,1,0,1,0,1,-1,0
Vietnam Republic,1967,Merdeka Tournament,17,7,5,1,1,7,10,0
Vietnam Republic,1967,Southeast Asian Peninsular Games,11,2,2,1,0,3,9,0
Vietnam Republic,1967,Vietnam Independence Cup,11,6,3,2,0,5,5,1
Vietnam Republic,1968,Friendly,2,1,1,1,0,2,1,0
Vietnam Republic,1968,Merdeka Tournament,8,13,2,3,0,5,-5,0
Vietnam Republic,1969,King's Cup,12,8,2,2,1,5,4,1
Vietnam Republic,1969,Southeast Asian Peninsular Games,1,2,0,1,1,2,-1,0
Vietnam Republic,1970,Asian Games,0,3,0,2,0,2,-3,0
Vietnam Republic,1970,King's Cup,6,9,0,2,1,3,-3,0
Vietnam Republic,1970,Merdeka Tournament,9,11,1,4,1,6,-2,0
Vietnam Republic,1970,Vietnam Independence Cup,5,2,2,0,1,3,3,0
Vietnam Republic,1971,Friendly,2,1,1,0,1,2,1,0
Vietnam Republic,1971,King's Cup,7,5,2,0,1,3,2,0
Vietnam Republic,1971,Korea Cup,1,11,0,2,0,2,-10,0
Vietnam Republic,1971,Merdeka Tournament,9,8,2,2,0,4,1,0
Vietnam Republic,1971,Southeast Asian Peninsular Games,5,4,1,1,2,4,1,0
Vietnam Republic,1971,Vietnam Independence Cup,4,2,1,1,1,3,2,0
Vietnam Republic,1972,Friendly,0,1,0,1,0,1,-1,0
Vietnam Republic,1972,Vietnam Independence Cup,5,3,1,1,1,3,2,0
Vietnam Republic,1973,FIFA World Cup qualification,1,5,1,2,0,3,-4,0
Vietnam Republic,1973,King's Cup,1,0,1,0,0,1,1,0
Vietnam Republic,1973,Merdeka Tournament,6,8,1,3,2,6,-2,0
Vietnam Republic,1973,Southeast Asian Peninsular Games,10,8,1,2,1,4,2,0
Vietnam Republic,1973,Vietnam Independence Cup,5,7,1,1,0,2,-2,1
Vietnam Republic,1974,King's Cup,4,7,0,2,1,3,-3,0
Vietnam Republic,1974,Vietnam Independence Cup,6,3,3,0,1,4,3,1
Vietnam Republic,1975,AFC Asian Cup qualification,1,10,0,4,0,4,-9,0
Wales,1876,Friendly,0,4,0,1,0,1,-4,0
Wales,1877,Friendly,0,2,0,1,0,1,-2,0
Wales,1878,Friendly,0,9,0,1,0,1,-9,0
Wales,1879,Friendly,1,5,0,2,0,2,-4,0
Wales,1880,Friendly,3,8,0,2,0,2,-5,0
Wales,1881,Friendly,2,5,1,1,0,2,-3,0
Wales,1882,Friendly,12,9,2,1,0,3,3,0
Wales,1883,Friendly,1,9,0,2,1,3,-8,0
Wales,1884,British Home Championship,7,8,1,2,0,3,-1,0
Wales,1885,British Home Championship,10,11,1,1,1,3,-1,1
Wales,1886,British Home Championship,7,7,1,2,0,3,0,0
Wales,1887,British Home Championship,1,10,0,3,0,3,-9,0
Wales,1888,British Home Championship,13,10,1,2,0,3,3,0
Wales,1889,British Home Championship,4,5,1,1,1,3,-1,1
Wales,1890,British Home Championship,6,10,1,2,0,3,-4,0
Wales,1891,British Home Championship,6,15,0,3,0,3,-9,0
Wales,1892,British Home Championship,2,9,0,2,1,3,-7,0
Wales,1893,British Home Championship,0,14,0,2,0,2,-14,0
Wales,1894,British Home Championship,7,11,1,2,0,3,-4,0
Wales,1895,British Home Championship,5,5,0,0,3,3,0,0
Wales,1896,British Home Championship,7,14,1,2,0,3,-7,0
Wales,1897,British Home Championship,5,10,0,2,1,3,-5,0
Wales,1898,British Home Championship,2,9,0,3,0,3,-7,0
Wales,1899,British Home Championship,0,11,0,3,0,3,-11,0
Wales,1900,British Home Championship,5,6,1,1,1,3,-1,0
Wales,1901,British Home Championship,2,7,1,1,1,3,-5,0
Wales,1902,British Home Championship,1,8,0,2,1,3,-7,0
Wales,1903,British Home Championship,1,5,0,3,0,3,-4,0
Wales,1904,British Home Championship,3,4,0,1,2,3,-1,0
Wales,1905,British Home Championship,6,6,1,1,1,3,0,0
Wales,1906,British Home Championship,6,5,1,1,1,3,1,0
Wales,1907,British Home Championship,5,3,2,0,1,3,2,0
Wales,1908,British Home Championship,2,10,0,3,0,3,-8,0
Wales,1909,British Home Championship,6,6,2,1,0,3,0,0
Wales,1910,British Home Championship,4,3,1,2,0,3,1,1
Wales,1911,British Home Championship,4,6,1,1,1,3,-2,0
Wales,1912,British Home Championship,2,6,0,3,0,3,-4,0
Wales,1913,British Home Championship,4,4,1,1,1,3,0,0
Wales,1914,British Home Championship,1,4,0,2,1,3,-3,0
Wales,1920,British Home Championship,5,4,1,0,2,3,1,0
Wales,1921,British Home Championship,3,3,1,1,1,3,0,0
Wales,1922,British Home Championship,2,2,1,1,0,2,0,0
Wales,1923,British Home Championship,2,7,0,2,1,3,-5,0
Wales,1924,British Home Championship,5,1,3,0,0,3,4,0
Wales,1925,British Home Championship,2,8,0,3,1,4,-6,0
Wales,1926,British Home Championship,3,7,1,2,0,3,-4,0
Wales,1927,British Home Championship,9,8,1,0,3,4,1,1
Wales,1928,British Home Championship,6,8,1,2,0,3,-2,0
Wales,1929,British Home Championship,4,12,0,2,1,3,-8,0
Wales,1930,British Home Championship,1,12,0,2,1,3,-11,0
Wales,1931,British Home Championship,6,12,1,3,0,4,-6,0
Wales,1932,British Home Championship,9,3,2,0,1,3,6,1
Wales,1933,British Home Championship,6,4,2,0,1,3,2,1
Wales,1933,Friendly,1,1,0,0,1,1,0,0
Wales,1934,British Home Championship,2,7,0,2,0,2,-5,0
Wales,1935,British Home Championship,4,2,1,0,1,2,2,0
Wales,1936,British Home Championship,8,6,3,1,0,4,2,1
Wales,1937,British Home Championship,7,4,2,1,0,3,3,0
Wales,1938,British Home Championship,6,6,1,2,0,3,0,0
Wales,1939,British Home Championship,3,1,1,0,0,1,2,0
Wales,1939,Friendly,1,2,0,1,0,1,-1,0
Wales,1945,Friendly,1,0,1,0,0,1,1,0
Wales,1946,British Home Championship,3,4,1,1,0,2,-1,0
Wales,1947,British Home Championship,3,6,1,2,0,3,-3,1
Wales,1948,British Home Championship,3,4,1,2,0,3,-1,0
Wales,1949,British Home Championship,2,0,1,0,0,1,2,0
Wales,1949,FIFA World Cup qualification,1,6,0,2,0,2,-5,0
Wales,1949,Friendly,8,11,1,3,0,4,-3,0
Wales,1950,British Home Championship,3,7,0,2,0,2,-4,0
Wales,1950,FIFA World Cup qualification,0,0,0,0,1,1,0,0
Wales,1951,British Home Championship,4,2,2,0,1,3,2,0
Wales,1951,Friendly,5,3,2,0,0,2,2,0
Wales,1952,British Home Championship,6,7,1,2,0,3,-1,0
Wales,1953,British Home Championship,7,9,1,1,1,3,-2,0
Wales,1953,Friendly,3,11,0,2,0,2,-8,0
Wales,1954,British Home Championship,3,6,0,3,0,3,-3,0
Wales,1954,Friendly,1,5,0,2,0,2,-4,0
Wales,1955,British Home Championship,5,5,2,1,0,3,0,0
Wales,1955,Friendly,1,2,0,1,0,1,-1,0
Wales,1956,British Home Championship,4,6,0,1,2,3,-2,0
Wales,1957,British Home Championship,1,5,0,1,2,3,-4,0
Wales,1957,FIFA World Cup qualification,6,5,2,2,0,4,1,0
Wales,1958,British Home Championship,3,6,0,1,2,3,-3,0
Wales,1958,FIFA World Cup,4,4,1,1,3,5,0,0
Wales,1958,FIFA World Cup qualification,4,0,2,0,0,2,4,1
Wales,1959,British Home Championship,2,5,0,1,1,2,-3,0
Wales,1960,British Home Championship,6,7,2,1,0,3,-1,0
Wales,1960,Friendly,3,2,1,0,0,1,1,0
Wales,1961,British Home Championship,6,4,1,1,1,3,2,0
Wales,1961,FIFA World Cup qualification,2,3,0,1,1,2,-1,0
Wales,1961,Friendly,2,3,0,1,0,1,-1,0
Wales,1962,British Home Championship,6,7,1,2,0,3,-1,0
Wales,1962,Friendly,3,8,0,3,0,3,-5,0
Wales,1962,UEFA Euro qualification,1,3,0,1,0,1,-2,0
Wales,1963,British Home Championship,5,7,1,2,0,3,-2,0
Wales,1963,UEFA Euro qualification,1,1,0,0,1,1,0,0
Wales,1964,British Home Championship,6,7,1,2,0,3,-1,0
Wales,1964,FIFA World Cup qualification,0,3,0,2,0,2,-3,0
Wales,1965,British Home Championship,6,4,1,1,1,3,2,0
Wales,1965,FIFA World Cup qualification,11,6,3,1,0,4,5,0
Wales,1965,Friendly,1,4,0,1,0,1,-3,0
Wales,1966,British Home Championship,3,10,0,2,1,3,-7,0
Wales,1966,Friendly,1,6,0,3,0,3,-5,0
Wales,1967,British Home Championship,2,6,0,2,1,3,-4,0
Wales,1968,British Home Championship,2,0,1,0,0,1,2,1
Wales,1968,FIFA World Cup qualification,0,1,0,1,0,1,-1,0
Wales,1968,Friendly,1,1,0,0,1,1,0,0
Wales,1969,British Home Championship,4,7,0,2,1,3,-3,0
Wales,1969,FIFA World Cup qualification,3,9,0,3,0,3,-6,0
Wales,1969,Friendly,1,1,0,0,1,1,0,0
Wales,1970,British Home Championship,2,1,1,0,2,3,1,1
Wales,1970,UEFA Euro qualification,0,0,0,0,1,1,0,0
Wales,1971,British Home Championship,0,1,0,1,2,3,-1,0
Wales,1971,UEFA Euro qualification,5,6,2,3,0,5,-1,0
Wales,1972,British Home Championship,0,4,0,2,1,3,-4,0
Wales,1972,FIFA World Cup qualification,0,1,0,1,0,1,-1,0
Wales,1973,British Home Championship,0,6,0,3,0,3,-6,0
Wales,1973,FIFA World Cup qualification,3,4,1,1,1,3,-1,0
Wales,1974,British Home Championship,1,4,1,2,0,3,-3,1
Wales,1974,UEFA Euro qualification,8,2,2,1,0,3,6,0
Wales,1975,British Home Championship,4,5,0,1,2,3,-1,0
Wales,1975,UEFA Euro qualification,6,2,3,0,0,3,4,0
Wales,1976,British Home Championship,2,4,1,2,0,3,-2,0
Wales,1976,FIFA World Cup qualification,0,1,0,1,0,1,-1,0
Wales,1976,Friendly,1,4,0,2,0,2,-3,0
Wales,1976,UEFA Euro qualification,1,3,0,1,1,2,-2,0
Wales,1977,British Home Championship,2,1,1,0,2,3,1,0
Wales,1977,FIFA World Cup qualification,3,3,1,2,0,3,0,0
Wales,1977,Friendly,1,1,0,0,3,3,0,0
Wales,1978,British Home Championship,3,4,1,1,1,3,-1,0
Wales,1978,Friendly,1,0,1,0,0,1,1,0
Wales,1978,UEFA Euro qualification,8,0,2,0,0,2,8,0
Wales,1979,British Home Championship,4,1,1,0,2,3,3,0
Wales,1979,Friendly,2,1,1,0,0,1,1,0
Wales,1979,UEFA Euro qualification,3,8,1,3,0,4,-5,0
Wales,1980,British Home Championship,4,3,1,2,0,3,1,0
Wales,1980,FIFA World Cup qualification,9,0,3,0,0,3,9,0
Wales,1981,British Home Championship,2,0,1,0,1,2,2,0
Wales,1981,FIFA World Cup qualification,3,7,1,2,2,5,-4,0
Wales,1981,Friendly,3,1,1,0,0,1,2,0
Wales,1982,British Home Championship,3,2,1,2,0,3,1,0
Wales,1982,Friendly,2,1,1,0,1,2,1,0
Wales,1982,UEFA Euro qualification,5,4,1,0,1,2,1,0
Wales,1983,British Home Championship,2,4,1,2,0,3,-2,0
Wales,1983,Friendly,6,1,1,0,1,2,5,0
Wales,1983,UEFA Euro qualification,2,2,1,1,2,4,0,0
Wales,1984,British Home Championship,3,3,1,1,1,3,0,0
Wales,1984,FIFA World Cup qualification,2,5,1,2,0,3,-3,0
Wales,1984,Friendly,0,1,0,1,1,2,-1,0
Wales,1985,FIFA World Cup qualification,5,1,2,0,1,3,4,0
Wales,1985,Friendly,3,8,0,2,1,3,-5,0
Wales,1986,Friendly,6,3,3,1,1,5,3,0
Wales,1986,UEFA Euro qualification,1,1,0,0,1,1,0,0
Wales,1987,Friendly,0,0,0,0,1,1,0,0
Wales,1987,UEFA Euro qualification,6,4,2,2,1,5,2,0
Wales,1988,FIFA World Cup qualification,2,3,0,1,1,2,-1,0
Wales,1988,Friendly,6,8,2,2,0,4,-2,0
Wales,1989,FIFA World Cup qualification,2,5,0,3,1,4,-3,0
Wales,1989,Friendly,3,5,0,1,1,2,-2,0
Wales,1990,Friendly,3,6,1,3,0,4,-3,0
Wales,1990,UEFA Euro qualification,4,1,2,0,0,2,3,0
Wales,1991,Friendly,2,3,2,1,1,4,-1,0
Wales,1991,UEFA Euro qualification,4,5,2,1,1,4,-1,0
Wales,1992,FIFA World Cup qualification,8,7,2,2,0,4,1,0
Wales,1992,Friendly,2,5,1,1,1,3,-3,0
Wales,1992,Kirin Cup,1,1,1,1,0,2,0,1
Wales,1993,FIFA World Cup qualification,11,5,3,1,2,6,6,0
Wales,1993,Friendly,1,2,0,1,0,1,-1,0
Wales,1994,Friendly,3,6,1,2,0,3,-3,0
Wales,1994,UEFA Euro qualification,4,11,1,3,0,4,-7,0
Wales,1995,UEFA Euro qualification,5,8,1,3,2,6,-3,0
Wales,1996,FIFA World Cup qualification,13,10,2,2,1,5,3,0
Wales,1996,Friendly,0,2,0,1,0,1,-2,0
Wales,1997,FIFA World Cup qualification,7,11,0,3,0,3,-4,0
Wales,1997,Friendly,1,3,1,1,1,3,-2,0
Wales,1998,Friendly,3,4,1,1,1,3,-1,0
Wales,1998,UEFA Euro qualification,5,5,2,1,0,3,0,0
Wales,1999,UEFA Euro qualification,2,11,1,4,0,5,-9,0
Wales,2000,FIFA World Cup qualification,2,3,0,1,2,3,-1,0
Wales,2000,Friendly,2,8,1,3,0,4,-6,0
Wales,2001,FIFA World Cup qualification,8,9,1,2,4,7,-1,0
Wales,2002,Friendly,3,2,1,0,3,4,1,0
Wales,2002,UEFA Euro qualification,6,1,3,0,0,3,5,0
Wales,2003,Friendly,2,4,0,1,1,2,-2,0
Wales,2003,UEFA Euro qualification,7,10,1,4,2,7,-3,0
Wales,2004,FIFA World Cup qualification,5,8,0,2,2,4,-3,0
Wales,2004,Friendly,7,0,3,0,1,4,7,0
Wales,2005,FIFA World Cup qualification,5,7,2,4,0,6,-2,0
Wales,2005,Friendly,2,1,1,1,1,3,1,0
Wales,2006,Friendly,7,3,3,1,2,6,4,0
Wales,2006,UEFA Euro qualification,5,8,1,2,0,3,-3,0
Wales,2007,Friendly,3,2,1,0,2,3,1,0
Wales,2007,UEFA Euro qualification,13,11,3,3,3,9,2,0
Wales,2008,FIFA World Cup qualification,4,3,2,2,0,4,1,0
Wales,2008,Friendly,8,4,4,2,0,6,4,0
Wales,2009,FIFA World Cup qualification,5,9,2,4,0,6,-4,0
Wales,2009,Friendly,5,3,2,2,0,4,2,0
Wales,2010,Friendly,5,4,1,2,0,3,1,0
Wales,2010,UEFA Euro qualification,1,6,0,3,0,3,-5,0
Wales,2011,Friendly,5,3,1,1,0,2,2,0
Wales,2011,Nations Cup,3,6,1,2,0,3,-3,0
Wales,2011,UEFA Euro qualification,5,4,3,2,0,5,1,0
Wales,2012,FIFA World Cup qualification,3,11,1,3,0,4,-8,0
Wales,2012,Friendly,0,5,0,3,0,3,-5,0
Wales,2013,FIFA World Cup qualification,6,9,2,3,1,6,-3,0
Wales,2013,Friendly,3,2,1,0,2,3,1,0
Wales,2014,Friendly,3,3,1,1,0,2,0,0
Wales,2014,UEFA Euro qualification,4,2,2,0,2,4,2,0
Wales,2015,Friendly,2,3,0,1,0,1,-1,0
Wales,2015,UEFA Euro qualification,7,2,4,1,1,6,5,0
Wales,2016,FIFA World Cup qualification,8,4,1,0,3,4,4,0
Wales,2016,Friendly,1,5,0,2,1,3,-4,0
Wales,2016,UEFA Euro,10,6,4,2,0,6,4,0
Wales,2017,FIFA World Cup qualification,5,2,3,1,2,6,3,0
Wales,2017,Friendly,1,3,0,1,1,2,-2,0
Wales,2018,Friendly,7,6,1,3,1,5,1,0
Wales,2018,UEFA Nations League,6,5,2,2,0,4,1,0
Wales,2019,Friendly,2,0,2,0,0,2,2,0
Wales,2019,UEFA Euro qualification,10,6,4,2,2,8,4,0
Wales,2020,Friendly,0,3,0,1,1,2,-3,0
Wales,2020,UEFA Nations League,7,1,5,0,1,6,6,0
Wales,2021,FIFA World Cup qualification,14,9,4,1,3,8,5,0
Wales,2021,Friendly,1,3,1,1,2,4,-2,0
Wales,2021,UEFA Euro,3,6,1,2,1,4,-3,0
Wales,2022,FIFA World Cup,1,6,0,2,1,3,-5,0
Wales,2022,FIFA World Cup qualification,3,1,2,0,0,2,2,0
Wales,2022,Friendly,1,1,0,0,1,1,0,0
Wales,2022,UEFA Nations League,6,11,0,5,1,6,-5,0
Wales,2023,Friendly,4,0,1,0,1,2,4,0
Wales,2023,UEFA Euro qualification,10,10,3,2,3,8,0,0
Wales,2024,Friendly,0,4,0,1,1,2,-4,0
Wales,2024,UEFA Euro qualification,4,1,1,0,1,2,3,0
Wales,2024,UEFA Nations League,9,4,3,0,3,6,5,0
Wales,2025,FIFA World Cup qualification,4,2,1,0,1,2,2,0
Wallis Islands and Futuna,1966,South Pacific Games,1,14,0,2,0,2,-13,0
Wallis Islands and Futuna,1979,South Pacific Games,3,13,1,3,0,4,-10,0
Wallis Islands and Futuna,1983,South Pacific Games,5,8,2,2,0,4,-3,0
Wallis Islands and Futuna,1987,South Pacific Games,7,18,1,4,0,5,-11,0
Wallis Islands and Futuna,1991,South Pacific Games,5,19,1,4,0,5,-14,0
Wallis Islands and Futuna,1995,South Pacific Games,2,37,0,4,0,4,-35,0
West Papua,2022,Friendly,1,1,0,0,1,1,0,0
Western Armenia,2016,CONIFA World Football Cup,14,7,1,3,1,5,7,0
Western Armenia,2018,CONIFA World Football Cup,12,8,3,2,1,6,4,0
Western Armenia,2019,CONIFA European Football Cup,8,5,1,2,2,5,3,0
Western Australia,1967,Merdeka Tournament,13,16,2,4,0,6,-3,0
Western Australia,1968,Merdeka Tournament,21,15,4,1,1,6,6,0
Western Australia,1969,King's Cup,5,7,1,2,0,3,-2,0
Western Australia,1969,Merdeka Tournament,8,14,1,4,0,5,-6,0
Western Australia,1970,Indonesia Tournament,2,6,0,2,0,2,-4,0
Western Australia,1970,Merdeka Tournament,7,11,2,4,0,6,-4,0
Western Australia,1971,Indonesia Tournament,4,5,0,1,1,2,-1,0
Western Australia,1980,King's Cup,3,1,1,0,1,2,2,0
Western Isles,2005,Island Games,14,10,2,1,2,5,4,0
Western Isles,2007,Island Games,6,3,3,1,0,4,3,0
Western Isles,2009,Island Games,10,11,2,2,0,4,-1,0
Western Isles,2011,Island Games,0,5,0,3,0,3,-5,0
Western Isles,2015,Island Games,5,15,2,2,0,4,-10,0
Western Isles,2017,Island Games,5,14,1,2,1,4,-9,0
Western Isles,2019,Inter Games Football Tournament,4,12,1,3,0,4,-8,0
Western Isles,2023,Island Games,4,3,2,2,0,4,1,0
Western Sahara,2012,Viva World Cup,11,16,2,3,0,5,-5,0
Yemen,1966,Arab Cup,1,24,0,3,0,3,-23,0
Yemen,1966,GaNEFo,3,42,0,5,0,5,-39,0
Yemen,1973,Palestine Cup,2,28,0,3,1,4,-26,0
Yemen,1974,Kuneitra Cup,2,28,0,4,0,4,-26,0
Yemen,1984,AFC Asian Cup qualification,2,18,0,4,0,4,-16,0
Yemen,1985,FIFA World Cup qualification,1,12,0,4,0,4,-11,0
Yemen,1985,Friendly,0,2,0,1,0,1,-2,0
Yemen,1988,AFC Asian Cup qualification,5,5,1,1,3,5,0,0
Yemen,1989,FIFA World Cup qualification,0,5,0,4,0,4,-5,0
Yemen,1990,Asian Games,0,2,0,1,2,3,-2,0
Yemen,1990,Friendly,1,0,1,0,0,1,1,0
Yemen,1993,FIFA World Cup qualification,12,13,3,3,2,8,-1,0
Yemen,1994,Asian Games,0,14,0,4,0,4,-14,0
Yemen,1994,Friendly,3,2,2,1,0,3,1,0
Yemen,1996,AFC Asian Cup qualification,2,8,1,3,0,4,-6,0
Yemen,1997,FIFA World Cup qualification,10,7,2,2,2,6,3,0
Yemen,2000,AFC Asian Cup qualification,14,5,2,2,0,4,9,0
Yemen,2000,Friendly,0,8,0,2,0,2,-8,0
Yemen,2001,FIFA World Cup qualification,14,8,3,1,2,6,6,0
Yemen,2002,Arab Cup,5,13,0,3,1,4,-8,0
Yemen,2002,Friendly,1,1,0,0,1,1,0,0
Yemen,2003,AFC Asian Cup qualification,15,15,2,3,1,6,0,0
Yemen,2003,Friendly,6,12,1,2,0,3,-6,0
Yemen,2003,Gulf Cup,2,6,0,1,1,2,-4,0
Yemen,2004,FIFA World Cup qualification,6,11,1,3,2,6,-5,0
Yemen,2004,Friendly,7,13,1,4,1,6,-6,0
Yemen,2004,Gulf Cup,1,18,0,6,1,7,-17,0
Yemen,2006,AFC Asian Cup qualification,5,13,2,4,0,6,-8,0
Yemen,2006,Arab Cup qualification,6,1,2,0,0,2,5,0
Yemen,2006,Friendly,1,3,0,2,1,3,-2,0
Yemen,2007,FIFA World Cup qualification,4,4,1,2,1,4,0,0
Yemen,2007,Friendly,4,1,1,0,0,1,3,0
Yemen,2007,Gulf Cup,3,5,0,2,1,3,-2,0
Yemen,2008,Friendly,4,5,1,2,2,5,-1,0
Yemen,2009,AFC Asian Cup qualification,2,6,1,2,0,3,-4,0
Yemen,2009,Friendly,5,3,2,0,1,3,2,0
Yemen,2009,Gulf Cup,2,11,0,3,0,3,-9,0
Yemen,2010,AFC Asian Cup qualification,5,3,1,1,1,3,2,0
Yemen,2010,Friendly,15,12,4,4,2,10,3,0
Yemen,2010,Gulf Cup,1,9,0,3,0,3,-8,0
Yemen,2010,WAFF Championship,5,4,1,1,1,3,1,0
Yemen,2011,FIFA World Cup qualification,0,2,0,1,1,2,-2,0
Yemen,2011,Friendly,0,4,0,1,0,1,-4,0
Yemen,2012,Arab Cup,3,3,1,1,0,2,0,0
Yemen,2012,Friendly,4,11,0,5,0,5,-7,0
Yemen,2012,WAFF Championship,1,4,0,3,0,3,-3,0
Yemen,2013,AFC Asian Cup qualification,2,16,0,5,0,5,-14,0
Yemen,2013,Friendly,2,3,0,1,0,1,-1,0
Yemen,2013,Gulf Cup,0,6,0,3,0,3,-6,0
Yemen,2014,AFC Asian Cup qualification,1,2,0,1,0,1,-1,0
Yemen,2014,Friendly,4,4,1,1,4,6,0,0
Yemen,2014,Gulf Cup,0,1,0,1,2,3,-1,0
Yemen,2015,FIFA World Cup qualification,5,15,2,6,1,9,-10,0
Yemen,2015,Friendly,0,3,0,2,1,3,-3,0
Yemen,2016,AFC Asian Cup qualification,4,0,2,0,0,2,4,0
Yemen,2016,FIFA World Cup qualification,0,3,0,1,0,1,-3,0
Yemen,2017,AFC Asian Cup qualification,5,4,1,0,4,5,1,0
Yemen,2017,Friendly,0,1,0,1,0,1,-1,0
Yemen,2017,Gulf Cup,0,8,0,3,0,3,-8,0
Yemen,2018,AFC Asian Cup qualification,2,1,1,0,0,1,1,0
Yemen,2018,Friendly,0,4,0,3,0,3,-4,0
Yemen,2019,AFC Asian Cup,0,10,0,3,0,3,-10,0
Yemen,2019,FIFA World Cup qualification,6,11,1,2,2,5,-5,0
Yemen,2019,Gulf Cup,0,9,0,2,1,3,-9,0
Yemen,2019,WAFF Championship,4,5,1,2,1,4,-1,0
Yemen,2021,Arab Cup qualification,0,2,0,1,0,1,-2,0
Yemen,2021,FIFA World Cup qualification,0,7,0,3,0,3,-7,0
Yemen,2022,AFC Asian Cup qualification,0,7,0,2,1,3,-7,0
Yemen,2023,FIFA World Cup qualification,6,3,2,1,1,4,3,1
Yemen,2023,Gulf Cup,2,10,0,3,0,3,-8,0
Yemen,2024,FIFA World Cup qualification,3,7,0,2,2,4,-4,0
Yemen,2024,Friendly,2,1,1,1,0,2,1,0
Yemen,2024,Gulf Cup,4,5,1,2,0,3,-1,0
Yemen,2025,AFC Asian Cup qualification,0,0,0,0,1,1,0,0
Yemen DPR,1972,Palestine Cup,5,7,2,2,0,4,-2,0
Yemen DPR,1973,Palestine Cup,2,16,0,4,0,4,-14,0
Yemen DPR,1974,Friendly,7,6,1,1,0,2,1,0
Yemen DPR,1975,Palestine Cup,1,5,1,1,0,2,-4,0
Yemen DPR,1976,AFC Asian Cup,0,9,0,2,0,2,-9,0
Yemen DPR,1978,Friendly,0,2,0,1,0,1,-2,0
Yemen DPR,1981,Friendly,1,1,0,0,1,1,0,0
Yemen DPR,1985,FIFA World Cup qualification,4,7,0,1,1,2,-3,0
Yemen DPR,1988,AFC Asian Cup qualification,1,4,0,2,1,3,-3,0
Yemen DPR,1988,Friendly,1,4,0,1,0,1,-3,0
Yemen DPR,1989,Friendly,3,8,1,2,0,3,-5,0
Ynys Môn,1989,Island Games,9,10,3,1,0,4,-1,1
Ynys Môn,1991,Island Games,7,3,3,1,0,4,4,0
Ynys Môn,1993,Island Games,4,4,1,1,2,4,0,0
Ynys Môn,1995,Island Games,6,7,2,2,0,4,-1,0
Ynys Môn,1997,Island Games,13,2,2,1,1,4,11,0
Ynys Môn,1999,Island Games,6,3,2,0,2,4,3,0
Ynys Môn,2001,Island Games,7,4,1,0,3,4,3,0
Ynys Môn,2003,Island Games,5,2,2,1,0,3,3,0
Ynys Môn,2005,Island Games,5,5,2,1,2,5,0,0
Ynys Môn,2007,Island Games,3,9,1,2,0,3,-6,0
Ynys Môn,2009,Island Games,6,7,2,2,0,4,-1,0
Ynys Môn,2011,Island Games,10,11,2,2,0,4,-1,0
Ynys Môn,2015,Island Games,6,9,1,2,1,4,-3,0
Ynys Môn,2017,Island Games,8,7,2,2,0,4,1,0
Ynys Môn,2019,Friendly,7,2,1,0,0,1,5,0
Ynys Môn,2019,Inter Games Football Tournament,10,4,5,0,0,5,6,1
Ynys Môn,2023,Island Games,11,7,3,1,0,4,4,0
Yorkshire,2018,Friendly,20,9,3,1,1,5,11,0
Yorkshire,2019,Atlantic Heritage Cup,1,0,1,0,0,1,1,0
Yorkshire,2019,Friendly,6,2,1,0,0,1,4,0
Yoruba Nation,2022,CONIFA Africa Football Cup,1,2,0,1,1,2,-1,0
Yugoslavia,1920,Friendly,2,4,0,1,0,1,-2,0
Yugoslavia,1920,Olympic Games,0,7,0,1,0,1,-7,0
Yugoslavia,1921,Friendly,1,6,0,1,0,1,-5,0
Yugoslavia,1922,Friendly,6,8,1,2,0,3,-2,0
Yugoslavia,1923,Friendly,8,6,2,0,1,3,2,0
Yugoslavia,1924,Friendly,1,6,0,2,0,2,-5,0
Yugoslavia,1924,Olympic Games,0,7,0,1,0,1,-7,0
Yugoslavia,1925,Friendly,1,9,0,2,0,2,-8,0
Yugoslavia,1926,Friendly,8,14,1,3,0,4,-6,0
Yugoslavia,1927,Friendly,8,8,2,2,0,4,0,0
Yugoslavia,1928,Friendly,6,12,2,2,0,4,-6,0
Yugoslavia,1928,Olympic Games,1,2,0,1,0,1,-1,0
Yugoslavia,1929,Balkan Cup,1,2,0,1,0,1,-1,0
Yugoslavia,1929,Friendly,12,10,2,1,1,4,2,0
Yugoslavia,1930,Balkan Cup,4,2,1,1,0,2,2,0
Yugoslavia,1930,FIFA World Cup,7,7,2,1,0,3,0,0
Yugoslavia,1930,Friendly,12,11,2,2,1,5,1,0
Yugoslavia,1931,Balkan Cup,9,10,2,3,0,5,-1,0
Yugoslavia,1931,Friendly,8,9,2,1,0,3,-1,0
Yugoslavia,1932,Balkan Cup,12,5,2,1,0,3,7,1
Yugoslavia,1932,Friendly,6,11,1,4,0,5,-5,0
Yugoslavia,1933,Balkan Cup,9,8,2,1,0,3,1,0
Yugoslavia,1933,FIFA World Cup qualification,2,2,0,0,1,1,0,0
Yugoslavia,1933,Friendly,7,10,1,2,1,4,-3,0
Yugoslavia,1934,Balkan Cup,5,5,1,1,0,2,0,0
Yugoslavia,1934,FIFA World Cup qualification,1,2,0,1,0,1,-1,0
Yugoslavia,1934,Friendly,19,15,3,3,0,6,4,0
Yugoslavia,1935,Balkan Cup,15,4,3,0,1,4,11,0
Yugoslavia,1935,Friendly,3,2,1,0,1,2,1,0
Yugoslavia,1936,Friendly,14,10,1,2,1,4,4,0
Yugoslavia,1937,FIFA World Cup qualification,0,4,0,1,0,1,-4,0
Yugoslavia,1937,Friendly,9,8,1,1,2,4,1,0
Yugoslavia,1938,FIFA World Cup qualification,1,0,1,0,0,1,1,0
Yugoslavia,1938,Friendly,9,14,1,2,3,6,-5,0
Yugoslavia,1939,Friendly,9,21,1,6,0,7,-12,0
Yugoslavia,1940,Friendly,8,6,2,1,2,5,2,0
Yugoslavia,1941,Friendly,1,1,0,0,1,1,0,0
Yugoslavia,1946,Balkan Cup,4,4,1,1,0,2,0,0
Yugoslavia,1946,Friendly,2,0,1,0,0,1,2,0
Yugoslavia,1947,Balkan Cup,11,7,3,1,0,4,4,1
Yugoslavia,1947,Friendly,8,4,1,1,0,2,4,0
Yugoslavia,1948,Balkan Cup,4,1,2,0,1,3,3,0
Yugoslavia,1949,FIFA World Cup qualification,16,6,3,0,2,5,10,1
Yugoslavia,1949,Friendly,5,6,1,1,0,2,-1,0
Yugoslavia,1950,FIFA World Cup,7,3,2,1,0,3,4,0
Yugoslavia,1950,Friendly,25,15,5,2,1,8,10,0
Yugoslavia,1951,Friendly,14,8,3,1,1,5,6,0
Yugoslavia,1952,Friendly,15,6,3,1,0,4,9,0
Yugoslavia,1953,FIFA World Cup qualification,2,0,2,0,0,2,2,0
Yugoslavia,1953,Friendly,16,7,4,0,1,5,9,0
Yugoslavia,1954,FIFA World Cup,2,3,1,1,1,3,-1,0
Yugoslavia,1954,FIFA World Cup qualification,2,0,2,0,0,2,2,0
Yugoslavia,1954,Friendly,16,7,4,1,1,6,9,0
Yugoslavia,1955,Central European International Cup,5,2,1,1,1,3,3,0
Yugoslavia,1955,Friendly,10,5,2,0,2,4,5,0
Yugoslavia,1956,Central European International Cup,5,8,0,2,2,4,-3,0
Yugoslavia,1956,Friendly,16,9,4,3,0,7,7,1
Yugoslavia,1957,Central European International Cup,6,2,1,1,0,2,4,0
Yugoslavia,1957,FIFA World Cup qualification,7,2,2,0,2,4,5,0
Yugoslavia,1957,Friendly,3,3,0,0,1,1,0,0
Yugoslavia,1958,FIFA World Cup,7,7,1,1,2,4,0,0
Yugoslavia,1958,Friendly,13,9,2,1,1,4,4,0
Yugoslavia,1959,Central European International Cup,5,1,1,0,0,1,4,0
Yugoslavia,1959,Friendly,3,9,0,2,1,3,-6,0
Yugoslavia,1959,UEFA Euro qualification,3,1,1,0,1,2,2,0
Yugoslavia,1960,Friendly,22,5,4,0,2,6,17,0
Yugoslavia,1960,UEFA Euro,6,6,1,1,0,2,0,0
Yugoslavia,1960,UEFA Euro qualification,6,3,1,1,0,2,3,0
Yugoslavia,1961,FIFA World Cup qualification,11,4,3,0,1,4,7,0
Yugoslavia,1961,Friendly,16,9,5,1,0,6,7,0
Yugoslavia,1962,FIFA World Cup,10,7,3,3,0,6,3,0
Yugoslavia,1962,Friendly,13,8,3,1,1,5,5,0
Yugoslavia,1962,UEFA Euro qualification,3,2,1,0,0,1,1,0
Yugoslavia,1963,Friendly,5,2,2,1,0,3,3,0
Yugoslavia,1963,UEFA Euro qualification,3,3,1,1,1,3,0,0
Yugoslavia,1964,FIFA World Cup qualification,3,1,1,0,0,1,2,0
Yugoslavia,1964,Friendly,10,12,3,4,1,8,-2,0
Yugoslavia,1965,FIFA World Cup qualification,7,7,2,2,1,5,0,0
Yugoslavia,1965,Friendly,1,1,0,0,2,2,0,0
Yugoslavia,1966,Friendly,9,16,3,5,1,9,-7,0
Yugoslavia,1967,Friendly,2,2,1,1,0,2,0,0
Yugoslavia,1967,UEFA Euro qualification,8,3,3,1,0,4,5,0
Yugoslavia,1968,FIFA World Cup qualification,9,4,1,1,1,3,5,0
Yugoslavia,1968,Friendly,6,12,0,3,2,5,-6,0
Yugoslavia,1968,UEFA Euro,2,3,1,1,1,3,-1,0
Yugoslavia,1968,UEFA Euro qualification,6,2,1,0,1,2,4,0
Yugoslavia,1969,FIFA World Cup qualification,10,3,2,1,0,3,7,0
Yugoslavia,1969,Friendly,4,5,1,1,1,3,-1,0
Yugoslavia,1970,Friendly,6,8,2,2,3,7,-2,0
Yugoslavia,1970,UEFA Euro qualification,3,1,1,0,1,2,2,0
Yugoslavia,1971,Friendly,7,5,1,2,1,4,2,0
Yugoslavia,1971,UEFA Euro qualification,4,1,2,0,2,4,3,0
Yugoslavia,1972,Brazil Independence Cup,23,11,5,1,2,8,12,0
Yugoslavia,1972,FIFA World Cup qualification,3,2,1,0,1,2,1,0
Yugoslavia,1972,Friendly,2,4,0,1,1,2,-2,0
Yugoslavia,1972,UEFA Euro qualification,0,3,0,1,1,2,-3,0
Yugoslavia,1973,FIFA World Cup qualification,4,2,1,0,1,2,2,1
Yugoslavia,1973,Friendly,9,3,2,0,2,4,6,0
Yugoslavia,1974,FIFA World Cup,12,7,1,3,2,6,5,0
Yugoslavia,1974,FIFA World Cup qualification,1,0,1,0,0,1,1,1
Yugoslavia,1974,Friendly,5,6,1,2,1,4,-1,0
Yugoslavia,1974,UEFA Euro qualification,3,1,1,0,0,1,2,0
Yugoslavia,1975,UEFA Euro qualification,9,3,4,1,0,5,6,0
Yugoslavia,1976,FIFA World Cup qualification,0,1,0,1,0,1,-1,0
Yugoslavia,1976,Friendly,3,6,1,2,1,4,-3,0
Yugoslavia,1976,UEFA Euro,4,7,0,2,0,2,-3,0
Yugoslavia,1976,UEFA Euro qualification,3,1,1,0,1,2,2,0
Yugoslavia,1977,Balkan Cup,0,0,0,0,1,1,0,0
Yugoslavia,1977,FIFA World Cup qualification,6,7,1,2,0,3,-1,0
Yugoslavia,1977,Friendly,9,16,2,5,1,8,-7,0
Yugoslavia,1978,Balkan Cup,4,1,1,0,0,1,3,1
Yugoslavia,1978,Friendly,0,0,0,0,2,2,0,0
Yugoslavia,1978,UEFA Euro qualification,3,5,0,2,0,2,-2,0
Yugoslavia,1979,Friendly,8,3,2,0,0,2,5,0
Yugoslavia,1979,UEFA Euro qualification,11,1,4,0,0,4,10,0
Yugoslavia,1980,Balkan Cup,3,4,1,1,0,2,-1,0
Yugoslavia,1980,FIFA World Cup qualification,7,3,2,1,0,3,4,0
Yugoslavia,1980,Friendly,4,2,2,0,0,2,2,0
Yugoslavia,1981,FIFA World Cup qualification,15,4,4,0,1,5,11,0
Yugoslavia,1981,Friendly,2,1,1,0,0,1,1,0
Yugoslavia,1982,FIFA World Cup,2,2,1,1,1,3,0,0
Yugoslavia,1982,UEFA Euro qualification,6,7,1,1,1,3,-1,0
Yugoslavia,1983,Friendly,5,10,2,3,1,6,-5,0
Yugoslavia,1983,UEFA Euro qualification,6,4,2,0,1,3,2,0
Yugoslavia,1984,FIFA World Cup qualification,3,2,1,0,1,2,1,0
Yugoslavia,1984,Friendly,8,10,3,1,1,5,-2,0
Yugoslavia,1984,UEFA Euro,2,10,0,3,0,3,-8,0
Yugoslavia,1985,FIFA World Cup qualification,4,6,2,3,1,6,-2,0
Yugoslavia,1985,Friendly,3,0,1,0,0,1,3,0
Yugoslavia,1985,Nehru Cup,7,5,2,1,1,4,2,0
Yugoslavia,1986,Friendly,6,6,1,1,1,3,0,0
Yugoslavia,1986,UEFA Euro qualification,4,2,1,1,0,2,2,0
Yugoslavia,1987,Friendly,4,2,1,2,0,3,2,0
Yugoslavia,1987,UEFA Euro qualification,9,7,3,1,0,4,2,0
Yugoslavia,1988,FIFA World Cup qualification,8,3,2,0,1,3,5,0
Yugoslavia,1988,Friendly,8,6,3,1,2,6,2,0
Yugoslavia,1989,FIFA World Cup qualification,8,3,4,0,1,5,5,0
Yugoslavia,1989,Friendly,10,6,2,2,2,6,4,0
Yugoslavia,1990,FIFA World Cup,8,6,3,1,1,5,2,0
Yugoslavia,1990,Friendly,0,3,0,2,2,4,-3,0
Yugoslavia,1990,UEFA Euro qualification,8,1,3,0,0,3,7,0
Yugoslavia,1991,Friendly,5,8,0,2,2,4,-3,0
Yugoslavia,1991,UEFA Euro qualification,16,3,4,1,0,5,13,0
Yugoslavia,1992,Friendly,0,2,0,1,0,1,-2,0
Yugoslavia,1997,Friendly,1,3,0,1,0,1,-2,0
Yugoslavia,1999,Friendly,0,1,0,1,0,1,-1,0
Zambia,1946,Friendly,4,0,1,0,0,1,4,0
Zambia,1947,Friendly,2,2,0,0,1,1,0,0
Zambia,1948,Friendly,3,6,1,1,0,2,-3,0
Zambia,1950,Friendly,4,2,2,0,0,2,2,0
Zambia,1951,Friendly,1,2,0,1,0,1,-1,0
Zambia,1952,Friendly,4,6,1,1,0,2,-2,0
Zambia,1953,Friendly,1,0,1,0,0,1,1,0
Zambia,1954,Friendly,4,3,1,1,1,3,1,0
Zambia,1957,Friendly,5,0,1,0,0,1,5,0
Zambia,1958,Friendly,4,4,1,1,0,2,0,0
Zambia,1963,Friendly,5,2,1,1,0,2,3,0
Zambia,1964,Friendly,18,6,3,1,0,4,12,0
Zambia,1964,Zambian Independence Tournament,2,5,0,2,0,2,-3,0
Zambia,1965,Friendly,10,10,1,1,2,4,0,0
Zambia,1966,Friendly,28,8,7,1,0,8,20,0
Zambia,1967,Friendly,11,6,2,1,1,4,5,0
Zambia,1968,African Cup of Nations qualification,5,4,1,0,1,2,1,1
Zambia,1968,FIFA World Cup qualification,6,6,1,1,0,2,0,0
Zambia,1968,Friendly,21,12,5,1,3,9,9,0
Zambia,1969,African Cup of Nations qualification,3,4,0,1,1,2,-1,0
Zambia,1969,Friendly,17,10,3,1,0,4,7,0
Zambia,1970,African Cup of Nations qualification,6,2,1,0,1,2,4,0
Zambia,1971,African Cup of Nations qualification,2,4,1,1,0,2,-2,0
Zambia,1971,Friendly,38,23,10,6,0,16,15,0
Zambia,1972,FIFA World Cup qualification,6,1,1,0,1,2,5,0
Zambia,1972,Friendly,5,5,0,0,3,3,0,0
Zambia,1973,African Cup of Nations qualification,11,7,2,2,0,4,4,0
Zambia,1973,CECAFA Cup,8,4,1,1,1,3,4,0
Zambia,1973,FIFA World Cup qualification,13,10,3,3,2,8,3,0
Zambia,1973,Friendly,1,5,0,2,0,2,-4,0
Zambia,1974,African Cup of Nations,9,9,3,2,1,6,0,0
Zambia,1974,CECAFA Cup,3,2,1,0,0,1,1,0
Zambia,1974,Friendly,1,0,1,0,0,1,1,0
Zambia,1975,African Cup of Nations qualification,11,8,2,1,1,4,3,0
Zambia,1975,CECAFA Cup,1,3,0,2,0,2,-2,0
Zambia,1975,Friendly,5,3,1,1,1,3,2,0
Zambia,1976,CECAFA Cup,12,6,4,1,0,5,6,0
Zambia,1976,FIFA World Cup qualification,5,0,2,0,0,2,5,0
Zambia,1976,Friendly,7,7,2,1,0,3,0,0
Zambia,1977,African Cup of Nations qualification,2,2,1,1,0,2,0,0
Zambia,1977,CECAFA Cup,8,5,2,1,1,4,3,0
Zambia,1977,FIFA World Cup qualification,4,5,1,2,1,4,-1,0
Zambia,1977,Friendly,16,4,4,1,0,5,12,0
Zambia,1978,African Cup of Nations,3,2,1,1,1,3,1,0
Zambia,1978,CECAFA Cup,22,6,4,2,0,6,16,0
Zambia,1978,Friendly,35,10,6,1,1,8,25,0
Zambia,1979,African Cup of Nations qualification,5,2,2,1,1,4,3,0
Zambia,1979,CECAFA Cup,5,6,1,1,1,3,-1,0
Zambia,1979,Friendly,6,2,2,0,0,2,4,0
Zambia,1980,FIFA World Cup qualification,6,2,2,1,1,4,4,0
Zambia,1980,Friendly,18,17,4,5,5,14,1,0
Zambia,1981,African Cup of Nations qualification,6,2,3,1,0,4,4,0
Zambia,1981,CECAFA Cup,6,6,2,2,1,5,0,0
Zambia,1981,Friendly,13,7,2,1,2,5,6,0
Zambia,1982,African Cup of Nations,7,3,3,2,0,5,4,0
Zambia,1982,Friendly,7,3,2,0,1,3,4,0
Zambia,1983,African Cup of Nations qualification,1,2,0,1,1,2,-1,0
Zambia,1984,CECAFA Cup,7,2,3,0,2,5,5,0
Zambia,1984,FIFA World Cup qualification,3,1,1,1,0,2,2,0
Zambia,1984,Friendly,4,5,1,2,2,5,-1,0
Zambia,1985,African Cup of Nations qualification,1,0,1,0,1,2,1,0
Zambia,1985,CECAFA Cup,2,5,0,1,1,2,-3,0
Zambia,1985,FIFA World Cup qualification,5,5,1,2,1,4,0,0
Zambia,1985,Friendly,9,7,3,1,3,7,2,0
Zambia,1986,African Cup of Nations,2,4,0,2,1,3,-2,0
Zambia,1986,Friendly,15,3,5,1,1,7,12,0
Zambia,1987,CECAFA Cup,1,6,0,2,0,2,-5,0
Zambia,1987,Friendly,5,0,3,0,0,3,5,0
Zambia,1988,CECAFA Cup,6,4,2,1,2,5,2,0
Zambia,1988,Friendly,17,8,4,2,1,7,9,0
Zambia,1988,Korea Cup,0,4,0,1,0,1,-4,0
Zambia,1989,African Cup of Nations qualification,8,2,3,1,0,4,6,0
Zambia,1989,CECAFA Cup,2,4,1,2,1,4,-2,0
Zambia,1989,FIFA World Cup qualification,7,6,3,3,0,6,1,0
Zambia,1989,Friendly,4,4,1,1,2,4,0,0
Zambia,1990,African Cup of Nations,3,2,3,1,1,5,1,0
Zambia,1990,African Cup of Nations qualification,5,0,1,0,1,2,5,0
Zambia,1990,Friendly,5,1,2,0,1,3,4,0
Zambia,1991,African Cup of Nations qualification,6,4,3,1,0,4,2,0
Zambia,1991,CECAFA Cup,9,4,4,0,1,5,5,1
Zambia,1991,Friendly,2,0,1,0,0,1,2,1
Zambia,1991,Nehru Cup,1,9,0,3,0,3,-8,0
Zambia,1992,African Cup of Nations,1,2,1,2,0,3,-1,0
Zambia,1992,African Cup of Nations qualification,4,1,2,0,0,2,3,0
Zambia,1992,CECAFA Cup,17,4,4,1,0,5,13,1
Zambia,1992,FIFA World Cup qualification,6,2,2,1,0,3,4,0
Zambia,1992,Friendly,0,0,0,0,1,1,0,0
Zambia,1993,African Cup of Nations qualification,7,1,2,0,2,4,6,0
Zambia,1993,FIFA World Cup qualification,16,4,5,1,1,7,12,0
Zambia,1993,Friendly,5,5,1,2,1,4,0,0
Zambia,1994,African Cup of Nations,7,2,3,1,1,5,5,0
Zambia,1994,African Cup of Nations qualification,1,2,0,1,0,1,-1,0
Zambia,1994,Friendly,18,6,6,2,1,9,12,0
Zambia,1995,African Cup of Nations qualification,6,0,3,0,0,3,6,0
Zambia,1995,Friendly,8,6,2,1,1,4,2,0
Zambia,1995,Korea Cup,4,7,1,2,0,3,-3,0
Zambia,1995,Simba Tournament,4,6,0,1,2,3,-2,0
Zambia,1996,African Cup of Nations,15,6,4,1,1,6,9,1
Zambia,1996,African Cup of Nations qualification,1,0,1,0,0,1,1,0
Zambia,1996,FIFA World Cup qualification,3,3,1,2,0,3,0,0
Zambia,1996,Friendly,9,5,4,2,3,9,4,0
Zambia,1997,African Cup of Nations qualification,8,3,3,0,2,5,5,0
Zambia,1997,COSAFA Cup,9,4,2,0,2,4,5,0
Zambia,1997,COSAFA Cup qualification,2,0,1,0,0,1,2,0
Zambia,1997,FIFA World Cup qualification,7,5,2,1,2,5,2,0
Zambia,1997,Friendly,9,8,2,2,4,8,1,0
Zambia,1998,African Cup of Nations,4,6,1,1,1,3,-2,0
Zambia,1998,African Cup of Nations qualification,1,1,0,0,1,1,0,0
Zambia,1998,COSAFA Cup,4,2,2,0,2,4,2,1
Zambia,1998,COSAFA Cup qualification,1,0,1,0,0,1,1,0
Zambia,1998,Friendly,4,4,1,1,2,4,0,0
Zambia,1999,African Cup of Nations qualification,6,2,4,0,1,5,4,0
Zambia,1999,COSAFA Cup,1,2,0,1,1,2,-1,0
Zambia,1999,Friendly,6,12,2,3,3,8,-6,0
Zambia,2000,African Cup of Nations,3,5,0,1,2,3,-2,0
Zambia,2000,African Cup of Nations qualification,5,4,2,2,0,4,1,0
Zambia,2000,COSAFA Cup,3,0,1,0,1,2,3,0
Zambia,2000,FIFA World Cup qualification,5,2,3,1,0,4,3,0
Zambia,2000,Friendly,4,4,2,2,3,7,0,0
Zambia,2001,African Cup of Nations qualification,2,2,1,1,2,4,0,0
Zambia,2001,COSAFA Cup,3,2,1,0,2,3,1,0
Zambia,2001,FIFA World Cup qualification,11,9,2,2,2,6,2,0
Zambia,2001,Friendly,4,7,1,3,0,4,-3,0
Zambia,2002,African Cup of Nations,1,3,0,2,1,3,-2,0
Zambia,2002,African Cup of Nations qualification,2,1,1,0,1,2,1,0
Zambia,2002,COSAFA Cup,3,1,1,1,0,2,2,0
Zambia,2002,Friendly,3,4,0,1,3,4,-1,0
Zambia,2003,African Cup of Nations qualification,4,4,2,1,1,4,0,0
Zambia,2003,COSAFA Cup,5,3,1,0,1,2,2,0
Zambia,2003,FIFA World Cup qualification,5,1,1,0,1,2,4,0
Zambia,2003,Friendly,5,1,2,0,1,3,4,0
Zambia,2004,COSAFA Cup,3,1,1,0,2,3,2,0
Zambia,2004,FIFA World Cup qualification,6,4,3,1,1,5,2,0
Zambia,2004,Friendly,7,7,2,2,3,7,0,0
Zambia,2005,COSAFA Cup,7,4,2,1,1,4,3,0
Zambia,2005,FIFA World Cup qualification,10,6,3,2,0,5,4,0
Zambia,2005,Friendly,8,4,2,0,4,6,4,0
Zambia,2006,African Cup of Nations,3,6,1,2,0,3,-3,0
Zambia,2006,African Cup of Nations qualification,2,1,1,1,0,2,1,0
Zambia,2006,CECAFA Cup,8,3,3,1,1,5,5,0
Zambia,2006,COSAFA Cup,8,1,4,0,0,4,7,1
Zambia,2006,Friendly,0,0,0,0,2,2,0,0
Zambia,2007,African Cup of Nations qualification,7,2,2,0,2,4,5,0
Zambia,2007,COSAFA Cup,3,0,1,0,1,2,3,0
Zambia,2007,Friendly,5,10,1,3,2,6,-5,0
Zambia,2008,African Cup of Nations,5,6,1,1,1,3,-1,0
Zambia,2008,CECAFA Cup,3,0,1,0,0,1,3,1
Zambia,2008,COSAFA Cup,2,1,1,1,1,3,1,0
Zambia,2008,FIFA World Cup qualification,2,1,2,1,1,4,1,0
Zambia,2008,Friendly,6,12,1,4,1,6,-6,0
Zambia,2009,CECAFA Cup,10,3,3,1,3,7,7,0
Zambia,2009,COSAFA Cup,4,3,2,1,0,3,1,0
Zambia,2009,FIFA World Cup qualification,2,5,1,3,2,6,-3,0
Zambia,2009,Friendly,5,6,1,2,0,3,-1,0
Zambia,2010,African Cup of Nations,5,5,1,1,2,4,0,0
Zambia,2010,African Cup of Nations qualification,4,1,1,1,0,2,3,0
Zambia,2010,CECAFA Cup,8,2,2,1,1,4,6,0
Zambia,2010,Friendly,6,10,2,2,1,5,-4,0
Zambia,2011,African Cup of Nations qualification,7,1,3,0,1,4,6,0
Zambia,2011,Friendly,9,5,2,3,0,5,4,0
Zambia,2012,African Cup of Nations,9,3,4,0,2,6,6,0
Zambia,2012,African Cup of Nations qualification,1,1,1,1,0,2,0,0
Zambia,2012,FIFA World Cup qualification,4,0,2,0,0,2,4,0
Zambia,2012,Friendly,4,5,2,3,2,7,-1,0
Zambia,2013,African Cup of Nations,2,2,0,0,3,3,0,0
Zambia,2013,CECAFA Cup,12,7,3,1,2,6,5,0
Zambia,2013,COSAFA Cup,5,1,2,0,1,3,4,1
Zambia,2013,FIFA World Cup qualification,7,4,1,1,2,4,3,0
Zambia,2013,Friendly,3,8,1,4,4,9,-5,0
Zambia,2014,African Cup of Nations qualification,6,2,3,1,2,6,4,0
Zambia,2014,Friendly,9,7,2,1,1,4,2,0
Zambia,2015,African Cup of Nations,2,3,0,1,2,3,-1,0
Zambia,2015,African Cup of Nations qualification,2,1,1,0,1,2,1,0
Zambia,2015,COSAFA Cup,3,1,1,1,1,3,2,0
Zambia,2015,FIFA World Cup qualification,3,0,2,0,0,2,3,0
Zambia,2015,Friendly,6,8,3,3,2,8,-2,0
Zambia,2016,African Cup of Nations qualification,5,6,0,1,3,4,-1,0
Zambia,2016,COSAFA Cup,3,3,1,1,1,3,0,0
Zambia,2016,FIFA World Cup qualification,2,3,0,1,1,2,-1,0
Zambia,2016,Friendly,1,2,1,2,1,4,-1,0
Zambia,2017,African Cup of Nations qualification,0,1,0,1,0,1,-1,0
Zambia,2017,COSAFA Cup,7,6,2,1,0,3,1,0
Zambia,2017,FIFA World Cup qualification,6,4,2,1,1,4,2,0
Zambia,2017,Friendly,2,1,1,0,3,4,1,0
Zambia,2018,African Cup of Nations qualification,4,5,1,2,1,4,-1,0
Zambia,2018,COSAFA Cup,3,4,1,1,1,3,-1,0
Zambia,2018,Friendly,3,4,1,1,1,3,-1,0
Zambia,2019,African Cup of Nations qualification,5,8,1,2,0,3,-3,0
Zambia,2019,COSAFA Cup,3,2,1,0,2,3,1,1
Zambia,2019,Friendly,10,11,2,2,2,6,-1,0
Zambia,2020,African Cup of Nations qualification,2,2,1,1,0,2,0,0
Zambia,2020,Friendly,4,3,2,1,0,3,1,0
Zambia,2021,African Cup of Nations qualification,5,3,1,0,1,2,2,0
Zambia,2021,COSAFA Cup,3,4,1,2,1,4,-1,0
Zambia,2021,FIFA World Cup qualification,8,9,2,3,1,6,-1,0
Zambia,2021,Friendly,4,5,1,1,1,3,-1,0
Zambia,2022,African Cup of Nations qualification,3,4,1,1,0,2,-1,0
Zambia,2022,COSAFA Cup,6,4,2,0,1,3,2,1
Zambia,2022,Friendly,7,11,1,4,0,5,-4,0
Zambia,2023,African Cup of Nations qualification,9,2,3,0,1,4,7,0
Zambia,2023,COSAFA Cup,9,5,4,1,0,5,4,1
Zambia,2023,FIFA World Cup qualification,5,4,1,1,0,2,1,0
Zambia,2023,Friendly,3,1,1,1,0,2,2,0
Zambia,2024,African Cup of Nations,2,3,0,1,2,3,-1,0
Zambia,2024,African Cup of Nations qualification,4,4,2,1,1,4,0,0
Zambia,2024,FIFA World Cup qualification,1,3,0,2,0,2,-2,0
Zambia,2024,Friendly,1,1,0,0,1,1,0,0
Zambia,2025,Friendly,0,5,0,1,0,1,-5,0
Zanzibar,1947,Friendly,1,3,0,1,0,1,-2,0
Zanzibar,1948,Friendly,1,3,0,1,0,1,-2,0
Zanzibar,1949,Friendly,2,3,0,1,0,1,-1,0
Zanzibar,1950,Friendly,0,4,0,1,0,1,-4,0
Zanzibar,1951,Friendly,0,1,0,1,0,1,-1,0
Zanzibar,1952,Friendly,4,8,1,1,0,2,-4,0
Zanzibar,1953,Friendly,1,5,0,1,0,1,-4,0
Zanzibar,1954,Friendly,0,5,0,1,0,1,-5,0
Zanzibar,1955,Friendly,0,8,0,1,0,1,-8,0
Zanzibar,1956,Friendly,5,7,1,1,0,2,-2,0
Zanzibar,1957,Friendly,4,8,0,1,1,2,-4,0
Zanzibar,1958,Friendly,3,8,0,2,1,3,-5,0
Zanzibar,1959,Friendly,3,7,1,1,1,3,-4,0
Zanzibar,1960,Friendly,3,11,0,3,0,3,-8,0
Zanzibar,1961,Friendly,1,21,0,5,0,5,-20,0
Zanzibar,1962,Friendly,0,11,0,2,0,2,-11,0
Zanzibar,1963,Friendly,1,17,0,5,0,5,-16,0
Zanzibar,1964,Friendly,8,14,1,3,0,4,-6,0
Zanzibar,1965,Friendly,2,12,0,3,0,3,-10,0
Zanzibar,1966,Friendly,1,7,0,2,1,3,-6,0
Zanzibar,1967,Friendly,3,8,1,2,0,3,-5,0
Zanzibar,1968,Friendly,0,8,0,3,0,3,-8,0
Zanzibar,1969,Friendly,1,12,0,3,0,3,-11,0
Zanzibar,1970,Friendly,4,5,1,2,0,3,-1,0
Zanzibar,1971,Friendly,2,8,0,2,1,3,-6,0
Zanzibar,1972,Friendly,1,4,0,1,0,1,-3,0
Zanzibar,1973,CECAFA Cup,0,3,0,2,0,2,-3,0
Zanzibar,1974,CECAFA Cup,3,3,1,1,0,2,0,0
Zanzibar,1975,CECAFA Cup,2,8,0,2,0,2,-6,0
Zanzibar,1975,Friendly,2,7,0,1,0,1,-5,0
Zanzibar,1976,CECAFA Cup,1,4,1,2,0,3,-3,0
Zanzibar,1976,Friendly,1,1,0,0,1,1,0,0
Zanzibar,1977,CECAFA Cup,0,5,0,3,0,3,-5,0
Zanzibar,1978,Friendly,1,11,0,2,0,2,-10,0
Zanzibar,1979,CECAFA Cup,2,9,0,3,1,4,-7,0
Zanzibar,1980,CECAFA Cup,2,2,1,1,0,2,0,0
Zanzibar,1981,CECAFA Cup,3,9,0,3,0,3,-6,0
Zanzibar,1982,CECAFA Cup,3,8,1,2,1,4,-5,0
Zanzibar,1983,CECAFA Cup,3,6,0,2,1,3,-3,0
Zanzibar,1983,Friendly,0,1,0,1,0,1,-1,0
Zanzibar,1984,CECAFA Cup,1,4,0,3,0,3,-3,0
Zanzibar,1987,CECAFA Cup,2,3,1,2,2,5,-1,0
Zanzibar,1988,CECAFA Cup,1,3,1,2,0,3,-2,0
Zanzibar,1989,CECAFA Cup,0,1,0,1,1,2,-1,0
Zanzibar,1990,CECAFA Cup,3,5,1,3,1,5,-2,0
Zanzibar,1991,CECAFA Cup,4,7,0,3,0,3,-3,0
Zanzibar,1992,CECAFA Cup,2,14,1,3,0,4,-12,0
Zanzibar,1995,CECAFA Cup,4,4,2,1,1,4,0,0
Zanzibar,1996,CECAFA Cup,1,2,0,1,1,2,-1,0
Zanzibar,1999,CECAFA Cup,1,3,0,1,1,2,-2,0
Zanzibar,1999,Friendly,1,0,1,0,0,1,1,0
Zanzibar,2000,Friendly,0,1,0,1,0,1,-1,0
Zanzibar,2001,CECAFA Cup,0,5,0,1,0,1,-5,0
Zanzibar,2002,CECAFA Cup,1,3,1,2,1,4,-2,0
Zanzibar,2002,Friendly,1,1,0,0,1,1,0,0
Zanzibar,2003,CECAFA Cup,2,6,0,1,1,2,-4,0
Zanzibar,2004,CECAFA Cup,7,11,1,3,0,4,-4,0
Zanzibar,2005,CECAFA Cup,7,6,3,1,2,6,1,0
Zanzibar,2005,Friendly,0,2,0,2,0,2,-2,0
Zanzibar,2006,CECAFA Cup,0,4,0,1,1,2,-4,0
Zanzibar,2006,ELF Cup,5,9,1,1,3,5,-4,0
Zanzibar,2006,FIFI Wild Cup,7,6,2,1,1,4,1,0
Zanzibar,2006,Friendly,2,3,0,1,1,2,-1,0
Zanzibar,2007,CECAFA Cup,5,3,1,0,2,3,2,0
Zanzibar,2007,Friendly,2,1,1,0,0,1,1,0
Zanzibar,2009,CECAFA Cup,9,8,3,4,3,10,1,1
Zanzibar,2010,CECAFA Cup,4,2,1,0,2,3,2,0
Zanzibar,2011,CECAFA Cup,5,4,1,2,1,4,1,0
Zanzibar,2012,CECAFA Cup,5,6,1,1,4,6,-1,0
Zanzibar,2012,Viva World Cup,16,4,3,1,0,4,12,0
Zanzibar,2013,CECAFA Cup,3,6,1,2,0,3,-3,0
Zanzibar,2015,CECAFA Cup,3,6,1,2,0,3,-3,0
Zanzibar,2017,CECAFA Cup,9,6,3,1,2,6,3,0
Zanzibar,2025,Mapinduzi Cup,4,2,3,1,0,4,2,1
Zimbabwe,1946,Friendly,0,4,0,1,0,1,-4,0
Zimbabwe,1947,Friendly,2,2,0,0,1,1,0,0
Zimbabwe,1948,Friendly,4,0,1,0,0,1,4,0
Zimbabwe,1950,Friendly,3,12,0,3,0,3,-9,0
Zimbabwe,1951,Friendly,2,1,1,0,0,1,1,0
Zimbabwe,1952,Friendly,6,4,1,1,0,2,2,0
Zimbabwe,1953,Friendly,0,1,0,1,0,1,-1,0
Zimbabwe,1954,Friendly,6,7,2,2,0,4,-1,0
Zimbabwe,1958,Friendly,4,4,1,1,0,2,0,0
Zimbabwe,1967,Friendly,4,5,1,2,0,3,-1,0
Zimbabwe,1969,FIFA World Cup qualification,2,4,0,1,2,3,-2,0
Zimbabwe,1969,Friendly,9,5,1,0,3,4,4,0
Zimbabwe,1977,Friendly,1,8,0,1,1,2,-7,0
Zimbabwe,1979,Friendly,6,0,1,0,0,1,6,0
Zimbabwe,1980,African Cup of Nations qualification,2,1,1,0,1,2,1,0
Zimbabwe,1980,FIFA World Cup qualification,1,2,1,1,0,2,-1,0
Zimbabwe,1980,Friendly,16,8,4,2,2,8,8,0
Zimbabwe,1981,African Cup of Nations qualification,0,3,0,2,0,2,-3,0
Zimbabwe,1981,CECAFA Cup,1,1,0,0,2,2,0,0
Zimbabwe,1981,Friendly,21,8,7,1,1,9,13,0
Zimbabwe,1982,African Cup of Nations qualification,0,4,0,2,0,2,-4,0
Zimbabwe,1982,CECAFA Cup,9,4,2,1,2,5,5,0
Zimbabwe,1982,Friendly,7,8,2,2,2,6,-1,0
Zimbabwe,1983,CECAFA Cup,6,3,4,1,0,5,3,0
Zimbabwe,1983,Friendly,4,6,1,2,1,4,-2,0
Zimbabwe,1984,African Cup of Nations qualification,8,1,2,0,0,2,7,0
Zimbabwe,1984,CECAFA Cup,3,8,0,2,1,3,-5,0
Zimbabwe,1984,FIFA World Cup qualification,1,2,0,1,1,2,-1,0
Zimbabwe,1984,Friendly,7,9,3,3,1,7,-2,0
Zimbabwe,1985,African Cup of Nations qualification,7,5,3,1,0,4,2,0
Zimbabwe,1985,CECAFA Cup,5,1,3,0,1,4,4,1
Zimbabwe,1985,Friendly,9,10,2,2,1,5,-1,0
Zimbabwe,1987,African Cup of Nations qualification,3,2,1,0,3,4,1,0
Zimbabwe,1987,CECAFA Cup,3,2,1,0,3,4,1,0
Zimbabwe,1987,Friendly,5,4,1,2,0,3,1,0
Zimbabwe,1988,CECAFA Cup,3,2,1,0,3,4,1,0
Zimbabwe,1988,Friendly,2,3,0,1,0,1,-1,0
Zimbabwe,1989,African Cup of Nations qualification,6,5,2,1,1,4,1,0
Zimbabwe,1989,CECAFA Cup,5,3,1,1,1,3,2,0
Zimbabwe,1989,FIFA World Cup qualification,1,10,0,3,1,4,-9,0
Zimbabwe,1989,Friendly,0,0,0,0,1,1,0,0
Zimbabwe,1990,African Cup of Nations qualification,0,2,0,1,0,1,-2,0
Zimbabwe,1990,CECAFA Cup,1,2,1,1,1,3,-1,0
Zimbabwe,1990,Friendly,22,13,4,2,1,7,9,0
Zimbabwe,1991,African Cup of Nations qualification,8,4,1,0,2,3,4,0
Zimbabwe,1991,Friendly,6,10,2,3,0,5,-4,0
Zimbabwe,1992,African Cup of Nations qualification,5,1,2,0,0,2,4,0
Zimbabwe,1992,FIFA World Cup qualification,3,1,2,0,0,2,2,0
Zimbabwe,1992,Friendly,4,2,1,1,2,4,2,0
Zimbabwe,1993,African Cup of Nations qualification,4,2,1,0,3,4,2,0
Zimbabwe,1993,FIFA World Cup qualification,8,9,4,2,2,8,-1,0
Zimbabwe,1993,Friendly,5,0,3,0,0,3,5,0
Zimbabwe,1994,African Cup of Nations qualification,3,4,1,1,0,2,-1,0
Zimbabwe,1994,Friendly,3,5,0,2,1,3,-2,0
Zimbabwe,1995,African Cup of Nations qualification,5,8,1,2,1,4,-3,0
Zimbabwe,1995,Friendly,1,3,0,1,0,1,-2,0
Zimbabwe,1995,Simba Tournament,3,5,0,1,2,3,-2,0
Zimbabwe,1996,FIFA World Cup qualification,5,5,1,1,1,3,0,0
Zimbabwe,1996,Friendly,5,5,1,1,2,4,0,0
Zimbabwe,1997,African Cup of Nations qualification,3,4,1,2,1,4,-1,0
Zimbabwe,1997,COSAFA Cup qualification,1,2,0,1,0,1,-1,0
Zimbabwe,1997,Dunhill Cup,9,5,1,1,2,4,4,0
Zimbabwe,1997,FIFA World Cup qualification,5,5,1,3,1,5,0,0
Zimbabwe,1997,Friendly,2,1,1,0,0,1,1,0
Zimbabwe,1998,COSAFA Cup,8,5,2,2,0,4,3,0
Zimbabwe,1998,COSAFA Cup qualification,2,0,1,0,0,1,2,0
Zimbabwe,1998,Friendly,3,3,1,2,2,5,0,0
Zimbabwe,1999,African Cup of Nations qualification,4,2,1,1,0,2,2,1
Zimbabwe,1999,COSAFA Cup,1,1,0,0,1,1,0,0
Zimbabwe,1999,Friendly,9,3,4,0,2,6,6,0
Zimbabwe,2000,African Cup of Nations qualification,10,6,3,1,0,4,4,0
Zimbabwe,2000,COSAFA Cup,12,3,5,0,0,5,9,1
Zimbabwe,2000,FIFA World Cup qualification,4,3,2,1,0,3,1,0
Zimbabwe,2000,Friendly,1,3,0,2,0,2,-2,0
Zimbabwe,2001,African Cup of Nations qualification,4,6,1,3,0,4,-2,0
Zimbabwe,2001,COSAFA Cup,4,2,2,1,1,4,2,0
Zimbabwe,2001,FIFA World Cup qualification,7,3,4,1,0,5,4,0
Zimbabwe,2001,Friendly,2,0,1,0,0,1,2,0
Zimbabwe,2002,African Cup of Nations qualification,2,0,2,0,0,2,2,0
Zimbabwe,2002,COSAFA Cup,0,2,0,1,0,1,-2,0
Zimbabwe,2002,Friendly,8,8,2,2,2,6,0,0
Zimbabwe,2003,African Cup of Nations qualification,6,3,2,1,1,4,3,0
Zimbabwe,2003,Afro-Asian Games,9,8,1,1,1,3,1,0
Zimbabwe,2003,COSAFA Cup,8,1,5,0,0,5,7,1
Zimbabwe,2003,FIFA World Cup qualification,4,2,1,1,0,2,2,0
Zimbabwe,2003,Friendly,2,0,1,0,1,2,2,0
Zimbabwe,2004,African Cup of Nations,6,8,1,2,0,3,-2,0
Zimbabwe,2004,COSAFA Cup,5,0,1,0,1,2,5,0
Zimbabwe,2004,FIFA World Cup qualification,4,6,1,2,2,5,-2,0
Zimbabwe,2004,Friendly,5,3,2,1,2,5,2,0
Zimbabwe,2005,COSAFA Cup,8,1,4,0,0,4,7,1
Zimbabwe,2005,FIFA World Cup qualification,9,8,3,1,1,5,1,0
Zimbabwe,2005,Friendly,4,8,0,3,2,5,-4,0
Zimbabwe,2006,African Cup of Nations,2,5,1,2,0,3,-3,0
Zimbabwe,2006,African Cup of Nations qualification,0,1,0,1,0,1,-1,0
Zimbabwe,2006,COSAFA Cup,1,2,0,1,0,1,-1,0
Zimbabwe,2006,Friendly,6,7,2,2,2,6,-1,0
Zimbabwe,2007,African Cup of Nations qualification,4,4,1,1,1,3,0,0
Zimbabwe,2007,COSAFA Cup,1,0,1,0,1,2,1,0
Zimbabwe,2007,Friendly,2,2,0,0,3,3,0,0
Zimbabwe,2007,Merdeka Tournament,5,8,1,2,0,3,-3,0
Zimbabwe,2008,COSAFA Cup,0,0,0,0,1,1,0,0
Zimbabwe,2008,FIFA World Cup qualification,4,6,1,2,3,6,-2,0
Zimbabwe,2008,Friendly,5,5,2,2,0,4,0,0
Zimbabwe,2009,COSAFA Cup,10,4,3,0,2,5,6,1
Zimbabwe,2009,Friendly,3,11,0,3,2,5,-8,0
Zimbabwe,2010,African Cup of Nations qualification,1,1,0,0,2,2,0,0
Zimbabwe,2010,Friendly,5,16,2,4,0,6,-11,0
Zimbabwe,2011,African Cup of Nations qualification,6,4,2,2,0,4,2,0
Zimbabwe,2011,CECAFA Cup,4,4,2,2,0,4,0,0
Zimbabwe,2011,Friendly,4,1,2,0,0,2,3,0
Zimbabwe,2012,African Cup of Nations qualification,5,5,2,2,0,4,0,0
Zimbabwe,2012,FIFA World Cup qualification,0,1,0,1,1,2,-1,0
Zimbabwe,2012,Friendly,6,6,1,2,1,4,0,0
Zimbabwe,2013,COSAFA Cup,3,4,1,1,1,3,-1,0
Zimbabwe,2013,FIFA World Cup qualification,4,8,0,3,1,4,-4,0
Zimbabwe,2013,Friendly,5,5,2,1,2,5,0,0
Zimbabwe,2014,African Cup of Nations qualification,2,3,0,1,1,2,-1,0
Zimbabwe,2014,Friendly,9,4,3,2,0,5,5,0
Zimbabwe,2015,African Cup of Nations qualification,3,2,1,0,1,2,1,0
Zimbabwe,2015,COSAFA Cup,4,4,2,1,0,3,0,0
Zimbabwe,2016,African Cup of Nations qualification,8,2,2,1,1,4,6,0
Zimbabwe,2016,COSAFA Cup,7,2,1,0,2,3,5,0
Zimbabwe,2016,Friendly,6,0,3,0,1,4,6,0
Zimbabwe,2017,African Cup of Nations,4,8,0,2,1,3,-4,0
Zimbabwe,2017,African Cup of Nations qualification,3,0,1,0,0,1,3,0
Zimbabwe,2017,COSAFA Cup,19,5,5,0,1,6,14,1
Zimbabwe,2017,Friendly,2,4,0,1,2,3,-2,0
Zimbabwe,2018,African Cup of Nations qualification,4,4,1,1,2,4,0,0
Zimbabwe,2018,COSAFA Cup,5,3,1,0,2,3,2,1
Zimbabwe,2018,Friendly,4,5,0,1,2,3,-1,0
Zimbabwe,2019,African Cup of Nations,1,6,0,2,1,3,-5,0
Zimbabwe,2019,African Cup of Nations qualification,4,1,2,0,1,3,3,0
Zimbabwe,2019,COSAFA Cup,4,2,1,0,2,3,2,0
Zimbabwe,2019,FIFA World Cup qualification,3,2,1,1,0,2,1,0
Zimbabwe,2019,Friendly,1,1,0,0,2,2,0,0
Zimbabwe,2020,African Cup of Nations qualification,3,5,0,1,1,2,-2,0
Zimbabwe,2020,Friendly,0,0,0,0,1,1,0,0
Zimbabwe,2021,African Cup of Nations qualification,1,2,1,1,0,2,-1,0
Zimbabwe,2021,COSAFA Cup,3,6,0,2,2,4,-3,0
Zimbabwe,2021,FIFA World Cup qualification,2,7,0,4,2,6,-5,0
Zimbabwe,2022,African Cup of Nations,3,4,1,2,0,3,-1,0
Zimbabwe,2022,Friendly,0,0,0,0,1,1,0,0
Zimbabwe,2023,FIFA World Cup qualification,1,1,0,0,2,2,0,0
Zimbabwe,2024,African Cup of Nations qualification,4,1,2,0,1,3,3,0
Zimbabwe,2024,FIFA World Cup qualification,1,5,0,2,0,2,-4,0
Zimbabwe,2025,FIFA World Cup qualification,3,3,0,0,2,2,0,0
Åland Islands,1989,Island Games,10,12,2,2,0,4,-2,0
Åland Islands,1991,Island Games,3,3,2,2,0,4,0,0
Åland Islands,1993,Island Games,7,4,3,1,0,4,3,0
Åland Islands,1995,Island Games,7,11,1,2,1,4,-4,0
Åland Islands,1999,Island Games,8,6,2,2,0,4,2,0
Åland Islands,2004,Friendly,2,2,0,0,1,1,0,0
Åland Islands,2005,Island Games,7,9,2,3,0,5,-2,1
Åland Islands,2007,Island Games,5,4,2,2,0,4,1,0
Åland Islands,2009,Island Games,10,7,3,1,1,5,3,0
Åland Islands,2011,Island Games,8,11,1,2,1,4,-3,0
Åland Islands,2015,Island Games,3,6,1,2,1,4,-3,0
Åland Islands,2017,Island Games,5,2,2,0,2,4,3,0
Åland Islands,2023,Island Games,2,9,0,3,1,4,-7,0
